Softonic,63,0,0,0,0,0,0,0
University of Phoenix,480,10,0,6,16,0.625,0,0.375
San Diego Convention & Visitors Bureau,131,0,0,2,2,0,0,1
Seafight,344,0,0,0,0,0,0,0
Remax,133,0,0,0,0,0,0,0
Washington Online School Network,739,0,0,0,0,0,0,0
Bubble Boomers,182,0,0,0,0,0,0,0
Microsoft,26,55,4,41,100,0.55,0.04,0.41
PageRage,371,0,0,0,0,0,0,0
Acura,465,0,0,1,1,0,0,1
Vistaprint,114,45,4,5,54,0.833333333,0.074074074,0.092592593
Austrialian Government,28,0,0,0,0,0,0,0
Wizard101,348,1,0,0,1,1,0,0
"Suntech Power Holdings Co., Ltd.",871,0,0,0,0,0,0,0
HowLifeWorks,128,0,0,1,1,0,0,1
fncimag.com,246,0,0,0,0,0,0,0
Mutual Community Insurance,197,0,0,0,0,0,0,0
Stihl,116,2,0,0,2,1,0,0
SpeedTrader,455,0,0,0,0,0,0,0
MortgageLoan.com,1137,0,0,0,0,0,0,0
CosmosDirekt,7,0,0,0,0,0,0,0
Groupon,47,1,0,1,2,0.5,0,0.5
Equifax,199,95,10,8,113,0.840707965,0.088495575,0.07079646
Thor Movie,187,0,0,0,0,0,0,0
Emirates,403,5,3,8,16,0.3125,0.1875,0.5
ITT Technical Institute,21,11,0,0,11,1,0,0
AT&T,8,463,123,76,662,0.69939577,0.185800604,0.114803625
BumbleJax,735,0,0,0,0,0,0,0
Wonga.com,194,0,0,0,0,0,0,0
Sungevity,1139,0,0,0,0,0,0,0
Network Advertising Initiative,18,0,0,0,0,0,0,0
ModCloth,1,22,4,1,27,0.814814815,0.148148148,0.037037037
CCTV,43,0,0,0,0,0,0,0
Mott's,165,0,0,1,1,0,0,1
Providence Regional Medical Center,546,0,0,0,0,0,0,0
Fisher Investments,23,70,1,7,78,0.897435897,0.012820513,0.08974359
LifestyleJournal.com,74,0,0,0,0,0,0,0
Amazon.com,2,110,11,54,175,0.628571429,0.062857143,0.308571429
Kijiji,15,0,1,0,1,0,1,0
Pemco Insurance,32,10,0,1,11,0.909090909,0,0.090909091
Toyota,20,196,88,51,335,0.585074627,0.262686567,0.152238806
Rolling Stone LLC,51,0,0,0,0,0,0,0
Javari,12,0,0,0,0,0,0,0
"MapQuest, Inc.",30,38,0,3,41,0.926829268,0,0.073170732
Tipico.com,62,0,0,0,0,0,0,0
Ad Council,24,21,9,1,31,0.677419355,0.290322581,0.032258065
Orange Home Loans,11,0,0,0,0,0,0,0
mybet.com,58,0,0,0,0,0,0,0
image.pk,68,0,0,0,0,0,0,0
"Avis Budget Group, Inc.",55,127,20,13,160,0.79375,0.125,0.08125
Lenovo,88,36,18,16,70,0.514285714,0.257142857,0.228571429
Google,180,428,26,147,601,0.712146423,0.043261231,0.244592346
Michigan Lottery,35,0,0,1,1,0,0,1
Rackspace Hosting,412,46,1,5,52,0.884615385,0.019230769,0.096153846
Zwinky,36,38,1,6,45,0.844444444,0.022222222,0.133333333
Travelzoo,102,6,0,6,12,0.5,0,0.5
Fresno Grizzlies,113,0,0,0,0,0,0,0
Seattle International Film Festival,39,0,0,0,0,0,0,0
AWeber Communications,89,3,0,0,3,1,0,0
MyVacationExperts.com,85,0,0,0,0,0,0,0
Hewlett-Packard (HP),93,39,16,14,69,0.565217391,0.231884058,0.202898551
TransUnion,49,51,11,9,71,0.718309859,0.154929577,0.126760563
5th Avenue Theatre,120,0,0,0,0,0,0,0
Nokia,143,0,0,1,1,0,0,1
CNN,61,0,0,2,2,0,0,1
Samsung,44,14,10,21,45,0.311111111,0.222222222,0.466666667
Project Noah,728,0,0,0,0,0,0,0
Netaya,60,0,0,0,0,0,0,0
Sprint,25,215,32,29,276,0.778985507,0.115942029,0.105072464
Pima Medical Institute,119,19,0,14,33,0.575757576,0,0.424242424
Argosy University,484,0,0,0,0,0,0,0
RegClean Pro,27,0,0,0,0,0,0,0
Platoon Movie,190,0,0,0,0,0,0,0
pptv,76,0,0,0,0,0,0,0
State Farm,98,53,5,19,77,0.688311688,0.064935065,0.246753247
pnop.com,154,0,0,0,0,0,0,0
Cartoon Network,313,0,0,0,0,0,0,0
Mecox Lane,151,0,0,0,0,0,0,0
Under Armour,67,27,3,3,33,0.818181818,0.090909091,0.090909091
Skyrock,56,0,0,0,0,0,0,0
Xopenex,733,0,0,0,0,0,0,0
Vertical Response,123,2,0,1,3,0.666666667,0,0.333333333
"GAIN Capital Group, LLC",90,1,0,3,4,0.25,0,0.75
NextEra Energy,618,3,0,0,3,1,0,0
shoedazzle,149,0,0,1,1,0,0,1
Sorinter,490,0,0,0,0,0,0,0
Washington Lottery,183,0,0,0,0,0,0,0
Webspyapp.com,105,0,0,0,0,0,0,0
Disney,106,0,0,1,1,0,0,1
Bank of America,186,78,45,16,139,0.561151079,0.323741007,0.115107914
BCFerries,122,0,0,0,0,0,0,0
Mercy Health (Missouri),271,0,0,1,1,0,0,1
"Crowd Science, Inc.",164,0,0,0,0,0,0,0
officialqquiz.com,137,0,0,0,0,0,0,0
MocoSpace,487,0,0,0,0,0,0,0
Stanley Martin Homes,869,0,0,0,0,0,0,0
Catcha Group,460,0,0,0,0,0,0,0
Thomson Reuters,616,0,0,2,2,0,0,1
Progressive Casualty Insurance Company,50,143,18,25,186,0.768817204,0.096774194,0.134408602
Comfort Keepers,34,0,0,0,0,0,0,0
Target,126,138,62,22,222,0.621621622,0.279279279,0.099099099
TheLautnerLetter.com,125,0,0,0,0,0,0,0
Japan Airlines,329,1,0,0,1,1,0,0
NBA,358,6,0,1,7,0.857142857,0,0.142857143
Arbor Mist,144,0,0,0,0,0,0,0
fastshop,155,0,0,0,0,0,0,0
ARO 2011,172,0,0,0,0,0,0,0
Huffy,401,0,0,0,0,0,0,0
GeekChicDaily.com,453,0,0,0,0,0,0,0
Vimeo,622,1,0,1,2,0.5,0,0.5
ASPCA,814,70,2,7,79,0.886075949,0.025316456,0.088607595
Sears,389,57,15,8,80,0.7125,0.1875,0.1
"The Travelers Companies, Inc.",353,11,3,0,14,0.785714286,0.214285714,0
The Tourist Movie,479,0,0,0,0,0,0,0
NewspaperArchive.com,750,0,0,0,0,0,0,0
Chuo University,550,0,0,0,0,0,0,0
Blip Festival,176,0,0,0,0,0,0,0
Astoria Pointe,339,0,0,0,0,0,0,0
Brilliant Earth,141,14,1,2,17,0.823529412,0.058823529,0.117647059
FamilyFinds,598,0,0,0,0,0,0,0
Capital One Financial Corporation,325,65,6,48,119,0.546218487,0.050420168,0.403361345
Qwest,511,0,0,0,0,0,0,0
Power Rangers Samurai Defense,1171,0,0,0,0,0,0,0
BECU,452,1,0,0,1,1,0,0
IBM,604,5,0,25,30,0.166666667,0,0.833333333
HTC,221,0,0,1,1,0,0,1
The Ledge Movie,607,0,0,0,0,0,0,0
Priceline.com,449,14,4,2,20,0.7,0.2,0.1
Play.com,1144,40,2,12,54,0.740740741,0.037037037,0.222222222
Waseda Online,91,0,0,0,0,0,0,0
Sony Corporation,330,29,7,12,48,0.604166667,0.145833333,0.25
Advantage Rent a Car,327,0,0,0,0,0,0,0
Raimondi's Florist,636,0,0,0,0,0,0,0
AVS Video Convertor,416,1,0,0,1,1,0,0
Miranda Cosgrove,1152,0,0,0,0,0,0,0
Panera Bread Company,193,9,1,5,15,0.6,0.066666667,0.333333333
Burger King,458,1,0,1,2,0.5,0,0.5
GTM Sportswear,435,0,0,0,0,0,0,0
State of Idaho,737,0,0,0,0,0,0,0
Endless Pools,365,0,0,0,0,0,0,0
Capella University,222,39,2,0,41,0.951219512,0.048780488,0
Jenny Craig,315,0,0,0,0,0,0,0
Pinnacle Foods Group,71,1,0,3,4,0.25,0,0.75
ING Direct,95,0,0,1,1,0,0,1
Search Ignite,129,0,0,0,0,0,0,0
Shutterfly,189,120,8,3,131,0.916030534,0.061068702,0.022900763
LiveWell Network,481,0,0,0,0,0,0,0
HSBC,147,37,8,8,53,0.698113208,0.150943396,0.150943396
Papa John's,497,2,1,2,5,0.4,0.2,0.4
Petco,1182,14,1,2,17,0.823529412,0.058823529,0.117647059
Zoomumbo,52,0,0,0,0,0,0,0
Winamp,109,0,0,0,0,0,0,0
veoh,156,0,0,0,0,0,0,0
Vlasic,496,0,0,0,0,0,0,0
Project Imagin8ion,477,0,0,0,0,0,0,0
Folder Lock,757,0,0,0,0,0,0,0
BP,473,39,2,21,62,0.629032258,0.032258065,0.338709677
Bulgari,305,2,0,3,5,0.4,0,0.6
Wedding Dash 4 ever,676,0,0,0,0,0,0,0
Feeding America,456,5,0,0,5,1,0,0
SIGMA Corporation of AmericaRICA ,879,0,0,0,0,0,0,0
SistaSense,600,0,0,0,0,0,0,0
BattleDawn Galaxies,629,0,0,0,0,0,0,0
Gazo,210,0,0,0,0,0,0,0
MarketJuice,682,0,0,0,0,0,0,0
Bidz.com,755,1,0,0,1,1,0,0
Best Foods,349,0,0,0,0,0,0,0
Trove.com,225,0,0,0,0,0,0,0
Telegaleria,1212,0,0,0,0,0,0,0
Albertsons,191,2,0,0,2,1,0,0
Semsen Furniture,212,0,0,0,0,0,0,0
85Play,78,4,0,0,4,1,0,0
Fry's Food Stores,672,0,0,0,0,0,0,0
Occidental Hotels & Resorts,865,0,0,0,0,0,0,0
Twitter,170,0,0,0,0,0,0,0
Asics,973,3,0,6,9,0.333333333,0,0.666666667
BMW,522,34,11,14,59,0.576271186,0.186440678,0.237288136
Second Life,489,1,0,0,1,1,0,0
MetLife,376,83,22,2,107,0.775700935,0.205607477,0.018691589
Parc Waikiki Hotel,614,0,0,0,0,0,0,0
JetBlue,474,127,14,2,143,0.888111888,0.097902098,0.013986014
Canadian Blood Services,1158,1,0,0,1,1,0,0
"Everyday Health, Inc.",743,5,0,2,7,0.714285714,0,0.285714286
NTB,1132,0,0,0,0,0,0,0
Lord Of The Rings Online,567,0,0,0,0,0,0,0
Chartis,342,2,0,1,3,0.666666667,0,0.333333333
WorldOfTrade.com,328,0,0,0,0,0,0,0
Piperlime,230,0,0,0,0,0,0,0
MarketSmith,239,0,0,1,1,0,0,1
National Guard,351,1,0,2,3,0.333333333,0,0.666666667
"Whatifsports.com, Inc.",341,0,0,0,0,0,0,0
Commonwealth Bank,561,0,0,0,0,0,0,0
WinRAR,1161,0,0,0,0,0,0,0
Domino's Pizza,503,291,15,28,334,0.871257485,0.04491018,0.083832335
Searchmetrics,867,0,0,0,0,0,0,0
Aeroflex,352,0,0,0,0,0,0,0
Spiral Knights,136,0,0,0,0,0,0,0
Extreme Coupons,217,0,0,0,0,0,0,0
Orville Redenbacher's,555,0,0,0,0,0,0,0
USA Today,609,5,2,1,8,0.625,0.25,0.125
Lockerz,1307,0,0,0,0,0,0,0
RateMarketplace,1337,5,0,1,6,0.833333333,0,0.166666667
The Roommate Movie,386,0,0,0,0,0,0,0
Cobra Electronics Corporation,359,0,0,0,0,0,0,0
Dailymotion,615,0,0,1,1,0,0,1
RealFlex,693,0,0,0,0,0,0,0
American Home Shield,776,0,0,0,0,0,0,0
Aflac,606,8,2,5,15,0.533333333,0.133333333,0.333333333
The United Services Automobile Association (USAA),742,1,0,5,6,0.166666667,0,0.833333333
Michelin,268,1,0,2,3,0.333333333,0,0.666666667
Best Western,493,78,39,0,117,0.666666667,0.333333333,0
Swedish Edmonds,355,0,0,0,0,0,0,0
Ticketek Rewards,232,0,0,0,0,0,0,0
Operation Flashpoint,491,0,0,0,0,0,0,0
match.com,468,4,1,3,8,0.5,0.125,0.375
Dish Network,759,29,2,12,43,0.674418605,0.046511628,0.279069767
MB Trading,533,0,0,0,0,0,0,0
Virgin Mobile,874,54,6,6,66,0.818181818,0.090909091,0.090909091
APS,425,0,0,2,2,0,0,1
The Moscow News,1341,0,0,0,0,0,0,0
The Week,227,0,0,0,0,0,0,0
1Mobile Market,772,0,0,0,0,0,0,0
BidCactus.com,619,0,0,0,0,0,0,0
Bose Corporation,540,55,19,3,77,0.714285714,0.246753247,0.038961039
"Lowe's Home Centers, Inc.",373,97,10,20,127,0.763779528,0.078740157,0.157480315
American Apparel,488,3,1,18,22,0.136363636,0.045454545,0.818181818
Crate & Barrel,200,131,67,1,199,0.658291457,0.336683417,0.005025126
Busch Gardens,883,0,0,0,0,0,0,0
Reebok,627,1,0,3,4,0.25,0,0.75
VideoEzy,1157,0,0,0,0,0,0,0
Infiniti,1614,30,1,8,39,0.769230769,0.025641026,0.205128205
GirlsGoGames.com,621,0,0,0,0,0,0,0
SeamlessWeb,623,0,0,0,0,0,0,0
Jumping The Broom Movie,611,0,0,0,0,0,0,0
DHGate.com,254,1,0,0,1,1,0,0
The Coffee Club,258,0,0,0,0,0,0,0
McDonald's,534,27,4,22,53,0.509433962,0.075471698,0.41509434
Lemonade Day,572,0,0,0,0,0,0,0
Brinks Home Security,650,0,0,0,0,0,0,0
Zozi,687,0,0,0,0,0,0,0
RetroGamer,769,0,0,2,2,0,0,1
Cultural Tourism DC,280,0,0,0,0,0,0,0
Environmental Defense Fund,391,11,0,2,13,0.846153846,0,0.153846154
Stealth Stocks,1616,0,0,0,0,0,0,0
JBL,426,0,0,0,0,0,0,0
ArmedForcesEDU.com,617,0,0,0,0,0,0,0
Only Vegas,509,0,0,0,0,0,0,0
Beastie Boys,641,0,0,0,0,0,0,0
AccuQuote,1134,0,0,0,0,0,0,0
NovaSure,112,0,0,0,0,0,0,0
Colonial First State,774,0,0,0,0,0,0,0
The Fantasy Consultant,793,0,0,0,0,0,0,0
Kung Fu Panda 2 Movie,779,0,0,0,0,0,0,0
AllMetSports.com,224,0,0,0,0,0,0,0
The North Face,822,14,0,9,23,0.608695652,0,0.391304348
Snapfish,644,10,1,0,11,0.909090909,0.090909091,0
MarketWatch,753,0,0,0,0,0,0,0
Edward Jones,502,5,0,2,7,0.714285714,0,0.285714286
Air Optix,549,0,0,0,0,0,0,0
Bentley's Snacks,777,0,0,0,0,0,0,0
EmailVision,1648,0,0,0,0,0,0,0
NSHMBA,576,0,0,0,0,0,0,0
"Delta Air Lines, Inc.",558,2,0,7,9,0.222222222,0,0.777777778
CoolSavings,249,0,0,0,0,0,0,0
Kyocera,238,0,0,0,0,0,0,0
DirecTV,374,30,2,9,41,0.731707317,0.048780488,0.219512195
MetroLyrics,886,1,0,0,1,1,0,0
La Quinta,414,41,1,4,46,0.891304348,0.02173913,0.086956522
Playrix,579,0,0,0,0,0,0,0
SmugMug,880,0,0,0,0,0,0,0
InkJetSuperStore.com,312,0,0,0,0,0,0,0
deviantART,226,2,0,0,2,1,0,0
SciVerse,1169,0,0,0,0,0,0,0
Let's Make a Plan,645,0,0,0,0,0,0,0
Stylelist.com,1739,0,0,0,0,0,0,0
Blue Rhino,1311,0,0,0,0,0,0,0
Crossroads Trading Co.,398,0,0,0,0,0,0,0
California Raisins,907,0,0,0,0,0,0,0
"University of California, Los Angeles",542,0,0,0,0,0,0,0
Hattrick,261,0,0,0,0,0,0,0
MyFunCards,899,3,0,0,3,1,0,0
PNC Bank,711,15,5,3,23,0.652173913,0.217391304,0.130434783
Seattle City Light,228,0,0,0,0,0,0,0
"The Vanguard Group, Inc.",544,78,2,27,107,0.728971963,0.018691589,0.252336449
"NewsBank, Inc.",818,0,0,0,0,0,0,0
ICQ,835,0,0,0,0,0,0,0
Discount Tire,562,61,5,8,74,0.824324324,0.067567568,0.108108108
"Dex Media, Inc.",1848,0,0,1,1,0,0,1
Luna Flooring,885,0,0,0,0,0,0,0
Katherine York Psychic,864,0,0,0,0,0,0,0
Keystone Light,1344,0,0,0,0,0,0,0
Sacred Hair Growth,908,0,0,0,0,0,0,0
Lance Bakery,751,0,0,0,0,0,0,0
Providence Medical Group,660,0,0,0,0,0,0,0
CareFirst,418,2,0,0,2,1,0,0
Woolworths,625,0,0,0,0,0,0,0
SwimWays,764,0,0,0,0,0,0,0
Ailes Apprentice Program,245,0,0,0,0,0,0,0
Mighty Magoo,1184,5,0,1,6,0.833333333,0,0.166666667
Jose Cuervo,405,0,0,1,1,0,0,1
Lemonade Mouth Movie,1142,0,0,0,0,0,0,0
cambio,2107,0,0,0,0,0,0,0
dealfun,2141,0,0,0,0,0,0,0
Red Rooster,785,0,0,0,0,0,0,0
Devry University,624,43,3,4,50,0.86,0.06,0.08
OptionsHouse,1626,1,0,4,5,0.2,0,0.8
Zulily,290,220,5,16,241,0.912863071,0.020746888,0.066390041
New Zealand Tourism Board,891,25,0,7,32,0.78125,0,0.21875
Photobucket,763,0,0,0,0,0,0,0
smartgb.com,252,0,0,0,0,0,0,0
Los Angeles Times,586,0,0,1,1,0,0,1
FLV Player,421,0,0,0,0,0,0,0
BuySight,605,0,0,0,0,0,0,0
National Center for Missing & Exploited Children,671,0,0,0,0,0,0,0
LeKool,299,0,0,0,0,0,0,0
Reuters,791,0,0,0,0,0,0,0
The Jones Group Inc.,2709,0,0,0,0,0,0,0
ABC Entertainment Group (abc.com),802,2,1,9,12,0.166666667,0.083333333,0.75
TMZ,379,2,0,0,2,1,0,0
"RealAge, Inc.",870,0,0,0,0,0,0,0
Mattress Giant,1629,0,0,0,0,0,0,0
Adventure Quest,264,0,0,0,0,0,0,0
FatBurningFurnace.com,526,0,0,0,0,0,0,0
Phonebooth Mobile,804,0,0,0,0,0,0,0
"iLivid (Bandoo Media, Inc.)",1159,81,1,30,112,0.723214286,0.008928571,0.267857143
Ace Hardware,519,11,0,1,12,0.916666667,0,0.083333333
CLEAR,236,2,1,0,3,0.666666667,0.333333333,0
RegOnline,1162,0,0,0,0,0,0,0
Nikkei.com,380,0,0,0,0,0,0,0
Glued Gaming,803,0,0,0,0,0,0,0
SHOUTcast,240,0,0,0,0,0,0,0
Adidas,866,6,0,2,8,0.75,0,0.25
Mary Kay,440,1,0,2,3,0.333333333,0,0.666666667
The Looney Tunes Show,387,0,0,0,0,0,0,0
Let's Draw The Line,417,0,0,0,0,0,0,0
Cosmedic Skincare,1644,0,0,0,0,0,0,0
WeAreTennis.com,1160,0,0,0,0,0,0,0
King Kamehameha Hotel,436,0,0,0,0,0,0,0
Portrait Innovations,1179,0,0,0,0,0,0,0
HealthyCore,911,0,0,0,0,0,0,0
Land O Lakes,521,0,0,0,0,0,0,0
Johnsonville,829,0,0,0,0,0,0,0
Brink,273,0,0,0,0,0,0,0
VoIP Supply,901,0,0,0,0,0,0,0
Main Line Health,771,0,0,0,0,0,0,0
Parachute,903,0,0,0,0,0,0,0
McNeil Healthcare(UK) Ltd,517,0,0,0,0,0,0,0
U.S. Forest Service,647,65,45,3,113,0.575221239,0.398230088,0.026548673
Rift,145,1,0,1,2,0.5,0,0.5
Lufthansa,1131,0,0,3,3,0,0,1
Olay,850,0,0,0,0,0,0,0
FairPoint Communications,778,0,0,0,0,0,0,0
Rome Movie,1138,0,0,0,0,0,0,0
allrecipes.com,2211,1,0,0,1,1,0,0
Nike,278,15,0,9,24,0.625,0,0.375
LG,936,39,2,15,56,0.696428571,0.035714286,0.267857143
Mercedes-Benz,836,47,6,12,65,0.723076923,0.092307692,0.184615385
ESPN,443,4,0,7,11,0.363636364,0,0.636363636
Singles 365,924,0,0,0,0,0,0,0
Wedding Paper divas,669,4,0,6,10,0.4,0,0.6
TheApple,694,0,0,0,0,0,0,0
Alvesco,969,0,0,0,0,0,0,0
L'Oreal Paris,760,13,3,1,17,0.764705882,0.176470588,0.058823529
Payless,402,4,0,0,4,1,0,0
Tesco Plc,410,0,0,0,0,0,0,0
List Wizards,725,0,0,0,0,0,0,0
Intel Corporation,3343,1,0,1,2,0.5,0,0.5
Gaana.com,2212,0,0,0,0,0,0,0
DealSwarm,266,0,0,0,0,0,0,0
Threadless Tees,914,2,0,0,2,1,0,0
Shoppers Food,875,0,0,0,0,0,0,0
Hispanic Scholarship Fund,854,0,0,0,0,0,0,0
Capgemini,1190,0,0,2,2,0,0,1
iWon,954,0,0,0,0,0,0,0
Astrology.com,1177,0,0,0,0,0,0,0
"HOA Restaurant Group, LLC",1220,0,0,0,0,0,0,0
Massachusetts Lottery,1164,0,0,0,0,0,0,0
Mr. Clean,545,0,0,0,0,0,0,0
Barnes & Noble,1146,4,0,1,5,0.8,0,0.2
123inkjets,967,0,0,0,0,0,0,0
International Spy Museum,692,0,0,0,0,0,0,0
RA.com,307,0,0,0,0,0,0,0
Consumer Electronics Association,3352,0,0,0,0,0,0,0
The Nature Conservancy,2548,0,0,0,0,0,0,0
ZoneAlarm,566,25,4,1,30,0.833333333,0.133333333,0.033333333
Kenneth Cole,568,5,0,0,5,1,0,0
Planet Hollywood Las Vegas,698,0,0,0,0,0,0,0
Link TV,917,0,0,0,0,0,0,0
Newport Beach,281,0,0,0,0,0,0,0
Orlando Magic,571,0,0,0,0,0,0,0
interclick,685,0,0,0,0,0,0,0
ExtendedStay Hotels,1215,2,0,0,2,1,0,0
Evony,1229,2,0,1,3,0.666666667,0,0.333333333
Mt. Bachelor Ski Resort,292,0,0,0,0,0,0,0
Marie Claire,999,0,0,0,0,0,0,0
Left4Dead,287,0,0,0,0,0,0,0
Dyson,594,16,0,5,21,0.761904762,0,0.238095238
Blu Electronic Cigarettes,788,0,0,1,1,0,0,1
Skype,253,1,0,1,2,0.5,0,0.5
Acase,982,0,0,0,0,0,0,0
Magnum Ice Cream,536,0,0,0,0,0,0,0
Halstead Property,1211,0,0,0,0,0,0,0
"Allen Brothers, Inc.",2780,0,0,0,0,0,0,0
"Chipotle Mexican Grill, Inc.",434,0,0,0,0,0,0,0
TrialPay,1166,0,0,0,0,0,0,0
StackOverflow,596,0,0,0,0,0,0,0
myLot,703,0,0,0,0,0,0,0
"Barr Pharmaceuticals, Inc.",1322,0,0,0,0,0,0,0
Europcar,1252,0,0,0,0,0,0,0
hhgregg,990,10,0,1,11,0.909090909,0,0.090909091
PetSmart,841,19,7,0,26,0.730769231,0.269230769,0
Last Dynasty,419,0,0,0,0,0,0,0
Ask.com,1001,10,0,4,14,0.714285714,0,0.285714286
FEARnet,1225,0,0,1,1,0,0,1
SDI Technologies,2866,0,0,0,0,0,0,0
Burberry,876,3,4,5,12,0.25,0.333333333,0.416666667
Sexy Forever,1145,0,0,0,0,0,0,0
Unbridled Books,583,0,0,0,0,0,0,0
J. Crew,964,13,0,2,15,0.866666667,0,0.133333333
National Highway Traffic Safety Administration,578,2,0,0,2,1,0,0
Vizu,1329,0,0,0,0,0,0,0
Qatar Airways,1226,0,0,2,2,0,0,1
West Corporation,1335,0,0,0,0,0,0,0
Sylvania,1347,0,0,0,0,0,0,0
The Thread,960,0,0,0,0,0,0,0
DuPont,795,1,0,0,1,1,0,0
FrontRange Solutions,1318,0,0,0,0,0,0,0
Goldman Sachs,775,0,0,7,7,0,0,1
SniqueAway,1156,0,0,0,0,0,0,0
International Olympic Committee,3348,0,0,3,3,0,0,1
Champlain College,3354,0,0,0,0,0,0,0
Olympic National Park & Forest,951,0,0,0,0,0,0,0
IgoUgo,411,0,0,0,0,0,0,0
TD Garden,1340,0,0,0,0,0,0,0
Proton,809,0,0,0,0,0,0,0
xfinity,1350,0,0,0,0,0,0,0
Games.com,1733,0,0,0,0,0,0,0
Value Village,1295,0,0,0,0,0,0,0
ratiopharm,1352,0,0,0,0,0,0,0
Terminix,681,0,0,0,0,0,0,0
Project Exonaut,279,0,0,0,0,0,0,0
American Family Insurance,420,12,0,4,16,0.75,0,0.25
STOPzilla,381,0,0,0,0,0,0,0
Bob's Red Mill Natural Foods,3266,5,0,2,7,0.714285714,0,0.285714286
Xcel Energy Inc.,3411,3,0,1,4,0.75,0,0.25
Too Fab,810,0,0,0,0,0,0,0
Cosmopolitan Las Vegas,424,1,0,0,1,1,0,0
Huffington Post,1633,0,1,0,1,0,1,0
Audio Convertor,298,0,0,0,0,0,0,0
United States Postal Service (USPS),855,39,16,11,66,0.590909091,0.242424242,0.166666667
ManageEngine,837,15,0,0,15,1,0,0
GameNinja,1325,0,0,0,0,0,0,0
New York Institute of Photography,539,0,0,0,0,0,0,0
"Milgard Manufacturing, Inc.",1971,0,0,0,0,0,0,0
Fuel TV,915,0,0,0,0,0,0,0
Woodland Park Zoo,564,0,0,0,0,0,0,0
Fotolia,806,0,0,0,0,0,0,0
Atlanta Center for Comestic Dentistry,1327,0,0,0,0,0,0,0
Urban Dealight,710,0,0,0,0,0,0,0
Zwinktopia,530,0,0,0,0,0,0,0
TVG,1326,0,0,0,0,0,0,0
"CBR Systems, Inc.",3365,1,0,0,1,1,0,0
Blue Cross and Blue Shield of Minnesota.,3413,0,0,1,1,0,0,1
Gnomeo & Juliet Movie,658,0,0,0,0,0,0,0
GourmetGiftBaskets.com,1219,0,0,0,0,0,0,0
Carrabbas Italian Grill,1296,13,0,3,16,0.8125,0,0.1875
FleetCardsUSA,939,0,0,0,0,0,0,0
iContact,2139,0,0,0,0,0,0,0
St. Jude Children's Research Hospital,717,26,3,0,29,0.896551724,0.103448276,0
VAMortgageCenter.com,828,0,0,0,0,0,0,0
Alienware,1635,0,0,0,0,0,0,0
The Clorox Company,394,40,11,9,60,0.666666667,0.183333333,0.15
"Wix.com, Inc.",1958,11,0,1,12,0.916666667,0,0.083333333
Hackett,1328,0,0,0,0,0,0,0
AllPosters.com,429,3,1,1,5,0.6,0.2,0.2
VH1,1343,0,0,0,0,0,0,0
"Equinix, Inc.",3366,0,0,0,0,0,0,0
1800 Contacts,1640,0,0,0,0,0,0,0
University of Michigan,3486,0,0,0,0,0,0,0
Transportation Security Administration,1302,0,0,0,0,0,0,0
Comfort Inn,1185,0,0,0,0,0,0,0
SOAPnetic,946,0,0,0,0,0,0,0
LifeLock,285,20,1,1,22,0.909090909,0.045454545,0.045454545
Gazelle,396,0,0,0,0,0,0,0
SaveBig.com,704,0,0,0,0,0,0,0
Mini,906,31,4,8,43,0.720930233,0.093023256,0.186046512
Fujitsu,1852,0,0,0,0,0,0,0
Things Remembered,3498,7,5,1,13,0.538461538,0.384615385,0.076923077
Samsonite,1965,0,0,0,0,0,0,0
Jen and Barb,1628,0,0,0,0,0,0,0
TopStockAnalysts.com,1847,0,0,0,0,0,0,0
Autism Speaks Inc.,2711,7,0,2,9,0.777777778,0,0.222222222
LADeals,949,0,0,0,0,0,0,0
77 Hudson Homes,928,0,0,0,0,0,0,0
Pacific Northwest Ballet,1223,0,0,0,0,0,0,0
Union Bank,2539,2,1,1,4,0.5,0.25,0.25
"Esurance Insurance Services, Inc.",2707,1,0,1,2,0.5,0,0.5
Homerun,1969,0,0,0,0,0,0,0
Cleveland Cavaliers,922,0,0,0,0,0,0,0
Andalucia,653,0,0,0,0,0,0,0
dark orbit,2115,0,0,0,0,0,0,0
Filippo Berio,848,0,0,0,0,0,0,0
Kenwood,927,0,0,0,0,0,0,0
One Hour Translation,1961,0,0,0,0,0,0,0
Duck Brand,3501,0,0,0,0,0,0,0
ADL Soft,812,0,0,0,0,0,0,0
Coastal Contacts Inc.,2708,0,0,0,0,0,0,0
"LAMPS PLUS, Inc.",3377,6,1,0,7,0.857142857,0.142857143,0
Tower Heist Movie,3386,0,0,0,0,0,0,0
USAGC,563,0,0,1,1,0,0,1
HGTV,1736,0,0,1,1,0,0,1
Sky Games,392,0,0,0,0,0,0,0
XpressBet,1172,0,0,0,0,0,0,0
Volkswagen,291,38,2,9,49,0.775510204,0.040816327,0.183673469
Darling Homes,989,1,0,0,1,1,0,0
peter bregman,2103,0,0,0,0,0,0,0
Netgear,632,0,0,0,0,0,0,0
Smartsource,1962,14,1,14,29,0.482758621,0.034482759,0.482758621
Muscular Dystrophy Association,3565,1,0,0,1,1,0,0
Hampton Inn,1646,7,2,4,13,0.538461538,0.153846154,0.307692308
Presbyterian Retirement Communities Northwest,2626,0,0,0,0,0,0,0
Akron Institute,712,0,0,0,0,0,0,0
"Baymont Franchise Systems, Inc.",3518,2,0,2,4,0.5,0,0.5
Prostate Cancer Foundation,1738,0,0,0,0,0,0,0
Zagg,887,1,0,0,1,1,0,0
Kia Motors,868,66,6,26,98,0.673469388,0.06122449,0.265306122
Copa America,1623,0,0,0,0,0,0,0
Nine West,3275,0,0,0,0,0,0,0
travel oregon,2105,0,0,0,0,0,0,0
Courageous the Movie,2140,0,0,0,0,0,0,0
Webroot Inc.,2329,26,1,0,27,0.962962963,0.037037037,0
QualityHealth.com,2529,2,0,2,4,0.5,0,0.5
South University,1205,0,0,1,1,0,0,1
"The McGraw-Hill Companies, Inc.",3584,0,0,7,7,0,0,1
Hawaii International Film Festival,2110,0,0,0,0,0,0,0
iolo technologies,3176,1,0,0,1,1,0,0
TradeStation,688,1,0,9,10,0.1,0,0.9
downloadWeb,2009,0,0,0,0,0,0,0
Atmail,1970,0,0,0,0,0,0,0
OnStar,294,8,5,2,15,0.533333333,0.333333333,0.133333333
Focus Features,2322,0,0,0,0,0,0,0
The Columbus Dispatch,1292,0,0,0,0,0,0,0
Fresh Pair,1959,0,0,0,0,0,0,0
"Amgen, Inc.",3422,22,2,5,29,0.75862069,0.068965517,0.172413793
"Soda Stream Direct, LLC.",2547,2,1,1,4,0.5,0.25,0.25
Projector People,2879,0,0,0,0,0,0,0
Scottrade,257,6,3,9,18,0.333333333,0.166666667,0.5
Tempur-Pedic,2208,8,0,0,8,1,0,0
ClassWish,634,0,0,0,0,0,0,0
"Total Gym Fitness, LLC",2782,0,0,0,0,0,0,0
VoiceFive,913,3,0,2,5,0.6,0,0.4
China Travel Depot,1189,0,0,0,0,0,0,0
War2Glory,844,0,0,0,0,0,0,0
AirAsia,968,1,0,0,1,1,0,0
Horchow,2984,4,0,2,6,0.666666667,0,0.333333333
eliNext,1750,0,0,0,0,0,0,0
Global Alert Network,2102,0,0,0,0,0,0,0
Games 9 .com,3269,0,0,0,0,0,0,0
The Venetian Las Vegas,3487,31,3,8,42,0.738095238,0.071428571,0.19047619
"Huhtamaki, Inc",813,0,0,2,2,0,0,1
YouTube,890,23,5,29,57,0.403508772,0.087719298,0.50877193
Ohio Lottery,570,0,0,2,2,0,0,1
Peer1 Hosting,3583,1,0,0,1,1,0,0
Rio Salado College,3424,1,0,1,2,0.5,0,0.5
"GBTV, LLC",2533,0,0,0,0,0,0,0
Rockstar Games,444,0,0,0,0,0,0,0
Pantothen,3264,0,0,0,0,0,0,0
Athleta,877,0,0,0,0,0,0,0
Gates of Andaron,846,0,0,0,0,0,0,0
Yoostar,1682,0,0,0,0,0,0,0
reddit,2136,1,0,0,1,1,0,0
Nature Publishing Group,2323,0,0,1,1,0,0,1
Gucci,3569,28,0,1,29,0.965517241,0,0.034482759
Nickelodeon,1170,21,21,3,45,0.466666667,0.466666667,0.066666667
"Caring, Inc.",2622,16,1,0,17,0.941176471,0.058823529,0
iVillage Inc.,2715,2,0,1,3,0.666666667,0,0.333333333
Xerox,1245,0,0,0,0,0,0,0
Southern New Hampshire University,2325,8,0,0,8,1,0,0
Associated Bank,3573,3,0,0,3,1,0,0
Systematic Development Company,3419,0,0,0,0,0,0,0
Dole Food Co. Inc.,1214,0,0,0,0,0,0,0
Jostens,768,0,0,0,0,0,0,0
Sittercity Incorproated,3267,0,0,0,0,0,0,0
RetrooGames.com,971,0,0,0,0,0,0,0
Kwikset,893,3,0,0,3,1,0,0
WizIQ,1273,0,0,0,0,0,0,0
John Muir Health,3376,0,0,0,0,0,0,0
GameHouse,286,0,0,0,0,0,0,0
AEG Live,1342,0,0,0,0,0,0,0
Gym Junkies LLC,2627,0,0,0,0,0,0,0
KingsAge,898,0,0,0,0,0,0,0
FBI,3590,0,0,0,0,0,0,0
Seattle Sutton's Healthy Eating,1300,0,0,0,0,0,0,0
Victoria's Secret,1639,17,0,0,17,1,0,0
Roundabout Theatre Company,1248,0,0,0,0,0,0,0
The Witcher 2,255,0,0,0,0,0,0,0
Ericsson,3364,0,0,0,0,0,0,0
Reputation.com,1280,0,0,0,0,0,0,0
Dremel,1232,0,0,0,0,0,0,0
Diamond.com,3387,0,0,0,0,0,0,0
Thunderbird School of Global Management,2706,0,0,0,0,0,0,0
Simply Wheelz,2873,0,0,0,0,0,0,0
"Pinehurst, LLC.",3263,0,0,0,0,0,0,0
"Zumba Fitness, LLC.",3098,21,1,2,24,0.875,0.041666667,0.083333333
Albert Lee,3088,1,0,0,1,1,0,0
Casino Arizona,3380,4,0,1,5,0.8,0,0.2
Aricept,1850,0,0,0,0,0,0,0
Axia,1973,0,0,0,0,0,0,0
Downtown Portland,3500,0,0,0,0,0,0,0
Home Depot (Homer TLC),2986,103,18,51,172,0.598837209,0.104651163,0.296511628
Smiley Central,1323,0,0,0,0,0,0,0
The CW Network,2883,1,0,4,5,0.2,0,0.8
Alma Del Pacifico Hotel,1174,0,0,0,0,0,0,0
Welch Foods Inc.,2872,0,0,0,0,0,0,0
ResMor Trust Company,3173,0,0,0,0,0,0,0
Taco Cabana,983,0,0,0,0,0,0,0
Armored AutoGroup Inc.,696,0,0,0,0,0,0,0
Orchard Bank,406,0,0,0,0,0,0,0
Vichy Laboratoires,2726,0,0,0,0,0,0,0
twinspires,2109,0,0,2,2,0,0,1
CursorMania,727,0,0,0,0,0,0,0
CARFAX,1741,0,0,0,0,0,0,0
InvestingChannel,2148,0,0,0,0,0,0,0
"YouSendIt, Inc.",2712,0,0,0,0,0,0,0
Esprit,3519,0,0,0,0,0,0,0
Totem,1727,0,0,0,0,0,0,0
Canadian Tourism Commission,2874,0,0,0,0,0,0,0
Novartis AG,3175,35,3,6,44,0.795454545,0.068181818,0.136363636
The Wall Street Journal,830,18,8,3,29,0.620689655,0.275862069,0.103448276
PDFCreator,256,3,0,0,3,1,0,0
Che Che New York,1008,0,0,0,0,0,0,0
Charity Water,3090,1,0,0,1,1,0,0
Couples Resorts,2226,0,0,0,0,0,0,0
World Vision,2207,6,0,1,7,0.857142857,0,0.142857143
Pardee Homes,1213,0,0,1,1,0,0,1
Vice Media,2318,2,0,1,3,0.666666667,0,0.333333333
Kobo Inc.,3567,0,0,0,0,0,0,0
Lennar Corporation,2243,3,1,0,4,0.75,0.25,0
Black Box Network Services,1979,0,0,0,0,0,0,0
UBS AG,2797,0,0,2,2,0,0,1
CA Technologies,3112,1,0,0,1,1,0,0
"PGi (Premiere Global Services, Inc.)",2113,0,0,0,0,0,0,0
Susan G. Komen,3425,0,0,0,0,0,0,0
Direct2Drive,930,0,0,0,0,0,0,0
Competitor Group,3356,0,0,0,0,0,0,0
National Pork Board,1000,0,0,1,1,0,0,1
"Become, Inc.",2565,0,0,0,0,0,0,0
Deutsche Bank,1224,0,0,0,0,0,0,0
Americans For The Arts,1141,2,0,0,2,1,0,0
Palm Springs Bureau of Tourism,3370,0,0,0,0,0,0,0
GamesCampus,1016,0,0,0,0,0,0,0
Western Digital Corporation,2801,0,0,0,0,0,0,0
"This Life, Inc.",2450,7,2,4,13,0.538461538,0.153846154,0.307692308
United Retail Incorporated,2713,0,0,0,0,0,0,0
goalunited,807,0,0,0,0,0,0,0
Symfonee Corporation,3652,0,0,0,0,0,0,0
Cal Ripken Sr. Foundation,988,0,0,0,0,0,0,0
123StockAlerts,2011,0,0,0,0,0,0,0
Larry Crowne Movie,1632,0,0,0,0,0,0,0
Text Ad Class,2114,0,0,0,0,0,0,0
Iraq and Afghanistan Verterens of America,3591,0,0,0,0,0,0,0
EPA,719,0,0,0,0,0,0,0
Fossil,673,34,2,2,38,0.894736842,0.052631579,0.052631579
VectorVest,1994,3,2,5,10,0.3,0.2,0.5
World Golf Tour,3595,5,0,1,6,0.833333333,0,0.166666667
1800mattress.com,1018,0,0,0,0,0,0,0
"Eagle Publishing, Inc.",2458,0,0,0,0,0,0,0
St. Joseph’s Healthcare System,2543,1,0,0,1,1,0,0
lifewise,2116,0,0,0,0,0,0,0
Official Payments Corporation,3452,0,0,0,0,0,0,0
Converge Direct,1306,0,0,0,0,0,0,0
Golf Channel,2461,0,0,0,0,0,0,0
Umbro International,3426,0,0,0,0,0,0,0
National Alliance for Public Charter Schools,702,0,0,0,0,0,0,0
CarPoint.com.au,532,0,0,0,0,0,0,0
Totsy,2787,0,0,0,0,0,0,0
Orkin,674,0,0,0,0,0,0,0
"PaveLife, Inc.",3384,0,0,0,0,0,0,0
United Way,1251,44,6,21,71,0.61971831,0.084507042,0.295774648
Silversea Cruises LTD.,3095,0,0,0,0,0,0,0
Qantas Airways Limited,3373,15,3,2,20,0.75,0.15,0.1
"Crackle, Inc.",3437,0,0,0,0,0,0,0
"EMD Serono, Inc.",3277,1,0,1,2,0.5,0,0.5
the three musketeers,2118,0,0,0,0,0,0,0
Coremetrics,808,0,0,0,0,0,0,0
Saks Incorporated,2316,17,1,7,25,0.68,0.04,0.28
Big Brothers Big Sisters of America,3096,5,0,1,6,0.833333333,0,0.166666667
Air Tahiti Nui,3311,0,0,0,0,0,0,0
ASUSTeK COMPUTER INC.,2465,0,0,0,0,0,0,0
LVMH Moët Hennessy • Louis Vuitton S.A.,3490,0,0,0,0,0,0,0
"Starz Entertainment, LLC",1730,0,0,0,0,0,0,0
sportsviews,2127,0,0,0,0,0,0,0
fabricly,2128,0,0,0,0,0,0,0
Full Sail University,247,100,3,6,109,0.917431193,0.027522936,0.055045872
Educational Testing Service,3119,0,0,2,2,0,0,1
"1&1 Internet, Inc.",2789,0,0,0,0,0,0,0
Instaflex,1734,0,0,0,0,0,0,0
Bills.com,3433,3,0,1,4,0.75,0,0.25
Adobe Systems,3102,60,6,7,73,0.821917808,0.082191781,0.095890411
BillMyParents,3390,0,0,0,0,0,0,0
Kongregate,2722,12,0,4,16,0.75,0,0.25
NC Interactive,2826,0,0,0,0,0,0,0
The Broadmoor,2875,1,0,0,1,1,0,0
Abt Inc.,3586,3,0,0,3,1,0,0
Orange County Register Communications,3100,0,0,0,0,0,0,0
Digital River Education Services,3043,0,0,0,0,0,0,0
SLIMQUICK Laboratories,2812,0,0,0,0,0,0,0
Gdiapers,3575,0,0,0,0,0,0,0
1800Flowers.com,920,11,3,2,16,0.6875,0.1875,0.125
ShortForm,962,0,0,0,0,0,0,0
eToro,293,0,0,0,0,0,0,0
"Carhartt, Inc.",3091,10,0,4,14,0.714285714,0,0.285714286
"Post Foods, LLC",1855,7,0,0,7,1,0,0
Prophix Software,3516,0,0,0,0,0,0,0
"Connected Ventures, LLC.",2724,0,0,2,2,0,0,1
Life Technologies Corporation,3104,9,0,2,11,0.818181818,0,0.181818182
APTA,1658,0,0,0,0,0,0,0
Provident Bank of CA,2784,0,0,0,0,0,0,0
"Atom Entertainment, Inc.",2563,0,0,1,1,0,0,1
Swimoutlet.com,3045,0,0,0,0,0,0,0
UnitedHealth Group,2816,0,0,0,0,0,0,0
Pottery Barn,2213,111,89,11,211,0.526066351,0.421800948,0.052132701
Entertainment Promotions,2554,0,0,0,0,0,0,0
Neiman Marcus,1298,6,0,5,11,0.545454545,0,0.454545455
Rizilia Jewelry,1029,0,0,0,0,0,0,0
xiaflex,1683,0,0,0,0,0,0,0
Wealth Engine,1857,0,0,0,0,0,0,0
The Estee Lauder Company,2553,2,0,1,3,0.666666667,0,0.333333333
Vyvanse,1744,0,0,0,0,0,0,0
Hiscox,1991,11,0,2,13,0.846153846,0,0.153846154
Peter Sims,1752,0,0,0,0,0,0,0
Merit Financial,1865,0,0,0,0,0,0,0
Dollar General Literacy Foundation,707,1,0,0,1,1,0,0
WomanFreebies.com,2550,0,0,0,0,0,0,0
Arab Eye,588,0,0,0,0,0,0,0
ViaCord,3345,1,0,0,1,1,0,0
Headline Shirts,931,11,2,0,13,0.846153846,0.153846154,0
Service Credit Union,3382,0,0,0,0,0,0,0
WallQuotes.com,995,0,0,0,0,0,0,0
Standard Pacific Homes,2720,0,0,0,0,0,0,0
Foodbuzz,1966,0,0,0,0,0,0,0
REI,1257,63,13,3,79,0.797468354,0.164556962,0.037974684
victory stocks,2125,0,0,0,0,0,0,0
Regent University,2333,8,0,1,9,0.888888889,0,0.111111111
The Boppy Company,1025,0,0,1,1,0,0,1
The Partnership at Drugfree.org,3372,11,1,1,13,0.846153846,0.076923077,0.076923077
PCRx.com,2815,1,0,0,1,1,0,0
EyeWonder,2807,0,0,0,0,0,0,0
Farmers Insurance,590,26,16,2,44,0.590909091,0.363636364,0.045454545
Fairfax County Economic Development Authority,3418,0,0,0,0,0,0,0
Gameonia.com,2829,0,0,1,1,0,0,1
Diapers.com,947,3,0,0,3,1,0,0
Burgerville,1330,0,0,0,0,0,0,0
scooter depot,2134,0,0,0,0,0,0,0
The Tile Shop,957,1,0,0,1,1,0,0
Alaska Airlines,1968,4,1,1,6,0.666666667,0.166666667,0.166666667
PerkStreet Financial,1661,0,0,0,0,0,0,0
Club Penguin,847,0,0,0,0,0,0,0
Perfecto Mobile,1869,0,0,0,0,0,0,0
WhitePages,649,0,0,0,0,0,0,0
BJs,3507,0,0,0,0,0,0,0
Unilever,1985,59,6,19,84,0.702380952,0.071428571,0.226190476
Pong Research Corporation,3133,0,0,0,0,0,0,0
Norwegian Cruise Line,1279,1,0,1,2,0.5,0,0.5
Macy's,1006,106,16,49,171,0.619883041,0.093567251,0.286549708
Starbucks,259,15,1,4,20,0.75,0.05,0.2
The Rum Diary Movie,3388,0,0,0,0,0,0,0
Mrs. Prindables,3431,0,0,0,0,0,0,0
21st Century Insurance,1208,12,0,0,12,1,0,0
BlogTalkRadio.com,3126,0,0,0,0,0,0,0
SolarCity,1679,0,0,0,0,0,0,0
Million Dollar Earth,1871,0,0,0,0,0,0,0
SIMPLE Mobile,2727,0,0,0,0,0,0,0
XOJET,2721,0,0,0,0,0,0,0
TIAA CREF,2220,33,7,4,44,0.75,0.159090909,0.090909091
Bestform,1356,0,0,0,0,0,0,0
"Trend Micro, Inc.",2833,14,1,0,15,0.933333333,0.066666667,0
Cedar Grove Composting,1197,0,0,0,0,0,0,0
Aviva,1332,0,0,0,0,0,0,0
Lindt & Sprüngli,2716,50,5,4,59,0.847457627,0.084745763,0.06779661
BBVA,188,0,0,0,0,0,0,0
Promotion of Peru,2231,0,0,0,0,0,0,0
giffarine,2119,0,0,0,0,0,0,0
The Total Transformation Program,3577,0,0,0,0,0,0,0
Mog Inc,3137,0,0,0,0,0,0,0
United Way of the Columbia-Willamette,2830,0,0,0,0,0,0,0
Zillow,2841,88,23,0,111,0.792792793,0.207207207,0
Weber,666,0,0,0,0,0,0,0
SoftLayer Technologies,2223,1,0,0,1,1,0,0
Bright Horizons,3508,0,0,0,0,0,0,0
Condis,2219,2,3,3,8,0.25,0.375,0.375
Zazzle.com,2236,1,0,1,2,0.5,0,0.5
the weekly standard,2124,0,0,0,0,0,0,0
Cancer Treatment Centers Of America,2222,16,3,4,23,0.695652174,0.130434783,0.173913043
Million Moms Challenge,2147,0,0,0,0,0,0,0
Club Med,2454,0,0,0,0,0,0,0
Wargaming.net,2232,27,0,10,37,0.72972973,0,0.27027027
Wells Fargo,345,1,1,6,8,0.125,0.125,0.75
Mancini's Sleepworld,3513,0,0,1,1,0,0,1
"eQHealth Solutions, Inc.",3290,0,0,0,0,0,0,0
Lord & Taylor,2234,11,1,4,16,0.6875,0.0625,0.25
IXL Learning,2897,11,0,1,12,0.916666667,0,0.083333333
Obama for America,1669,0,0,0,0,0,0,0
Care.com,1043,8,0,1,9,0.888888889,0,0.111111111
U.S. General Services Administration,3292,0,0,0,0,0,0,0
"David A. Straz, Jr. Center for the Performing Arts",2844,0,0,0,0,0,0,0
Virtacore Systems,1753,0,0,0,0,0,0,0
Registry Booster,613,0,0,0,0,0,0,0
Boden,3109,2,0,0,2,1,0,0
Beget,220,0,0,0,0,0,0,0
VGameNetwork,1035,12,0,0,12,1,0,0
"Rue La La, Inc.",2800,4,0,0,4,1,0,0
Loews Hotels,3398,39,1,3,43,0.906976744,0.023255814,0.069767442
"Citrus World, Inc.",1268,0,0,0,0,0,0,0
"Crocs, Inc.",1040,1,0,0,1,1,0,0
SurveyMonkey,3007,7,1,1,9,0.777777778,0.111111111,0.111111111
Cleveland State University,3524,0,0,0,0,0,0,0
Chemistry.com,363,0,0,0,0,0,0,0
Cleveland Clinic,1270,0,0,2,2,0,0,1
Crucial,1686,0,0,0,0,0,0,0
UCLA Live,3114,0,0,0,0,0,0,0
Cavaliers Operating Company,3401,0,0,0,0,0,0,0
"Network Solutions, LLC",2629,20,12,0,32,0.625,0.375,0
"Verti Technology Group, Inc.",2802,6,0,0,6,1,0,0
RingCentral,2886,0,1,1,2,0,0.5,0.5
"TeamFanShop, Inc.",3283,0,0,0,0,0,0,0
The Metropolitan Museum of Art.,3654,0,0,0,0,0,0,0
GreatCall,2998,3,0,0,3,1,0,0
Crizal,377,0,0,0,0,0,0,0
"Bonobos, Inc.",2466,0,0,0,0,0,0,0
Twilio,1748,0,0,0,0,0,0,0
Virginia Beach Convention & Visitors Bureau,1685,2,0,0,2,1,0,0
Clipper Navigation,2987,0,0,0,0,0,0,0
The City of New York,2981,1,0,0,1,1,0,0
Chapman University,3177,0,0,0,0,0,0,0
Operation Smile,2851,0,0,0,0,0,0,0
Pelago,2468,0,0,0,0,0,0,0
JustHookUp.com,3022,0,0,0,0,0,0,0
The FRS Company,2809,0,0,1,1,0,0,1
Aston Hotels & Resorts LLC.,2463,0,0,0,0,0,0,0
MSG Holdings,2848,4,0,2,6,0.666666667,0,0.333333333
OneUpWeb,3033,0,0,0,0,0,0,0
Becker Professional Development Corporation,1655,0,0,0,0,0,0,0
Brocade Communication Systems,3024,0,0,0,0,0,0,0
Ray-Ban,1036,0,0,1,1,0,0,1
QuickHit Football,770,0,0,0,0,0,0,0
"Gilead Sciences, Inc.",3405,4,2,5,11,0.363636364,0.181818182,0.454545455
U.S. News University Connection L.L.C.,2452,0,0,2,2,0,0,1
Texas Instruments Incorporated,3287,0,0,2,2,0,0,1
Riot Games inc.,3447,1,0,0,1,1,0,0
Public Broadcasting Service (PBS),2347,5,0,3,8,0.625,0,0.375
"Convio, Inc.",2464,5,1,1,7,0.714285714,0.142857143,0.142857143
National Grid,1369,0,0,0,0,0,0,0
Bobby Jindal Campaign,3530,0,0,0,0,0,0,0
Kaiser Permanente,1650,40,3,3,46,0.869565217,0.065217391,0.065217391
Atom Books,781,0,0,0,0,0,0,0
Jetsetter,3201,1,0,0,1,1,0,0
Rosen Law Firm,1657,0,0,0,0,0,0,0
Cabot Creamery,2348,2,0,1,3,0.666666667,0,0.333333333
Avid Dating Life Inc,3197,0,0,1,1,0,0,1
"SolarWinds, Inc.",2354,3,0,0,3,1,0,0
Simply Orange,1027,0,0,0,0,0,0,0
bet-at-home,2019,0,0,0,0,0,0,0
SPDR ETFs,695,0,0,4,4,0,0,1
Cisco,1664,46,4,10,60,0.766666667,0.066666667,0.166666667
"Artix Entertainment, LLC.",2633,6,0,0,6,1,0,0
ComEd,1286,0,0,0,0,0,0,0
Smithsonian Institute,3315,2,0,1,3,0.666666667,0,0.333333333
Cable & Telecommunications Association for Marketing Co-op,2571,0,0,0,0,0,0,0
BYU Broadcasting,3198,0,0,0,0,0,0,0
Cheap Cycle Parts,3182,0,0,0,0,0,0,0
"Wavehunters Surf Travel, Inc.",3440,0,0,0,0,0,0,0
Emergency Essentials,3012,0,0,0,0,0,0,0
Plan International Canada,3026,4,2,1,7,0.571428571,0.285714286,0.142857143
Speakeasy,1866,0,0,0,0,0,0,0
Kodak,427,0,0,0,0,0,0,0
GFI Software,3139,6,0,0,6,1,0,0
Firestone Complete Auto Care,3334,14,0,0,14,1,0,0
YEXT,2639,11,0,2,13,0.846153846,0,0.153846154
"Consolidated Credit Counseling Services, Inc.",3537,0,0,0,0,0,0,0
WebMediaBrands,2244,1,0,1,2,0.5,0,0.5
Netboots,1677,0,0,0,0,0,0,0
Bel Red Energy Solutions,2989,0,0,0,0,0,0,0
Colorado Tourism Office,1365,3,0,0,3,1,0,0
China Realtime Report,713,0,0,0,0,0,0,0
Peapod,3127,1,0,0,1,1,0,0
CLAD,2834,0,0,0,0,0,0,0
Swarovski AG,3747,2,0,1,3,0.666666667,0,0.333333333
CTIA The Wireless Association,3598,0,0,0,0,0,0,0
Circa Desserts,3441,0,0,0,0,0,0,0
Room & Board,2654,0,0,0,0,0,0,0
"TrueCar, Inc.",3326,4,0,0,4,1,0,0
Brooks Brothers,1761,0,0,0,0,0,0,0
Motor Trend Auto Shows,3520,7,0,1,8,0.875,0,0.125
fubar,2732,0,0,0,0,0,0,0
National Aquarium,1687,0,0,0,0,0,0,0
DSW Inc.,2651,0,0,1,1,0,0,1
Metacafe,1181,0,0,0,0,0,0,0
Specialized Bicycle components,3754,5,0,0,5,1,0,0
Caesarstone US,3601,0,0,0,0,0,0,0
"Lifetime Entertainment Services, LLC",2337,1,0,0,1,1,0,0
"Brinker International, Inc.",2656,10,0,0,10,1,0,0
Design Within Reach,3044,0,0,0,0,0,0,0
Shows.com,3451,0,0,0,0,0,0,0
3Cx,2018,0,0,0,0,0,0,0
RCN Telecom Services,2831,1,1,1,3,0.333333333,0.333333333,0.333333333
Pennsylvania Treasury,1188,0,0,0,0,0,0,0
ShermansTravel Media,2338,1,0,0,1,1,0,0
Kellwood Company,3301,2,0,1,3,0.666666667,0,0.333333333
Webctor,3779,0,0,0,0,0,0,0
The Prudential Insurance Company of America,3395,1,0,3,4,0.25,0,0.75
Bailey Banks & Biddle,3048,0,0,0,0,0,0,0
U.S. Cellular,2839,1,1,1,3,0.333333333,0.333333333,0.333333333
Travelodge Hotel Inc.,3307,0,0,0,0,0,0,0
Cost Plus World Market,3605,1,0,0,1,1,0,0
Matco Tools,1876,0,0,0,0,0,0,0
Roku,2361,6,0,3,9,0.666666667,0,0.333333333
Showtime,1673,0,0,0,0,0,0,0
The University of Texas MD Anderson Cancer Center,2832,3,0,4,7,0.428571429,0,0.571428571
Heineken,1199,0,0,0,0,0,0,0
Helzberg Diamonds,2470,0,0,0,0,0,0,0
Everblue Energy Inc.,3319,1,0,0,1,1,0,0
Pellexa Research Labs,2900,0,0,0,0,0,0,0
Mixamo,3734,0,0,0,0,0,0,0
GolfNow.com,3188,0,0,0,0,0,0,0
Kasala,3339,0,0,0,0,0,0,0
ION-factory,3744,0,0,0,0,0,0,0
Egnyte,3015,1,0,0,1,1,0,0
Massage Envy Franchising,3186,10,9,1,20,0.5,0.45,0.05
Bare Escentuals,1041,0,0,0,0,0,0,0
ShelterBox,963,0,0,0,0,0,0,0
Limos.com,3008,0,0,0,0,0,0,0
juicypromo.com,3337,0,0,0,0,0,0,0
Vision Service Plan,2669,2,0,1,3,0.666666667,0,0.333333333
"Atlantis, Kerzner International Resorts Inc.",3193,9,0,0,9,1,0,0
In the Land of Blood and Money Movie,3402,0,0,0,0,0,0,0
Overstock.com,2254,1,0,1,2,0.5,0,0.5
TheLadders,3341,0,0,0,0,0,0,0
SilkRoad technologies,3169,0,0,0,0,0,0,0
Future Shop,3016,0,0,0,0,0,0,0
Holy Names University,3645,0,0,0,0,0,0,0
Laser Spine Institute,3131,23,1,1,25,0.92,0.04,0.04
Jive Software,981,0,0,0,0,0,0,0
Harbor Hounds Sponsors,3023,0,0,0,0,0,0,0
DoCircle,3051,0,0,0,0,0,0,0
Crouse Hospital,3062,0,0,1,1,0,0,1
Golf Galaxy,2995,0,0,0,0,0,0,0
L.A. Noire,1386,0,0,0,0,0,0,0
The Shelter Pet Project,1050,0,0,2,2,0,0,1
"Kelly Blue Book Co., Inc.",3762,17,9,15,41,0.414634146,0.219512195,0.365853659
Hill's Pet Nutrition,3030,0,0,1,1,0,0,1
Whole Foods Market IP,3443,33,11,2,46,0.717391304,0.239130435,0.043478261
Beyond the Rack,3132,0,0,0,0,0,0,0
truTV,1313,0,0,1,1,0,0,1
Road ID Inc.,3730,0,0,0,0,0,0,0
on24.com,1383,2,0,1,3,0.666666667,0,0.333333333
The Sacramento Bee,3002,1,0,1,2,0.5,0,0.5
Tampa Bay Times,2637,0,0,0,0,0,0,0
Media News Group,3773,0,0,0,0,0,0,0
Wizards of the Coast LLC,3533,0,1,0,1,0,1,0
NetApp,2143,1,0,0,1,1,0,0
Frito-Lay,2145,0,0,3,3,0,0,1
BlueMountain.com,1331,0,0,0,0,0,0,0
Library of America,1690,2,0,0,2,1,0,0
iWinnersAdvantage,3540,0,0,0,0,0,0,0
Eve's Addiction,3004,0,0,0,0,0,0,0
"Vivint, Inc.",3305,1,0,0,1,1,0,0
"Turbine, Inc.",3775,3,0,0,3,1,0,0
Shanghai Tang,3534,0,0,0,0,0,0,0
The Monroe County Tourist Development Council,2845,3,0,2,5,0.6,0,0.4
Friends With Benefits Movie,1624,0,0,0,0,0,0,0
American Girl,3151,28,4,0,32,0.875,0.125,0
Publix Super Markets,2353,5,0,8,13,0.384615385,0,0.615384615
Mill Stores,2570,0,0,0,0,0,0,0
Last.fm,2373,0,0,0,0,0,0,0
DirectBuy,1890,0,0,0,0,0,0,0
spigit,1882,0,0,0,0,0,0,0
MatureSinglesOnly.com,2161,0,0,0,0,0,0,0
PC Tools,3025,0,0,2,2,0,0,1
Outlook Amusements,3041,10,2,1,13,0.769230769,0.153846154,0.076923077
Education Connection,2344,0,0,0,0,0,0,0
Deadline Deals,2852,0,0,0,0,0,0,0
Wirefly,1631,19,1,1,21,0.904761905,0.047619048,0.047619048
Apple Vacations,2146,2,0,0,2,1,0,0
Windstar Cruises,2572,0,0,0,0,0,0,0
The Ester C Company,3755,0,0,1,1,0,0,1
CheapStuff.com,2376,0,0,1,1,0,0,1
"Irollie Marketing, LLC",3027,0,0,0,0,0,0,0
Duffy's Drug & Alcohol Rehab,3741,0,0,0,0,0,0,0
Moen Incorporated,3298,1,0,1,2,0.5,0,0.5
Office Depot,1649,4,0,0,4,1,0,0
Platinum Guild International,3282,0,0,1,1,0,0,1
"Starwood Hotels & Resorts Worldwide, Inc.",2638,199,55,13,267,0.745318352,0.205992509,0.048689139
Dunhill Travel Deals,3769,0,0,0,0,0,0,0
MrPorter,3743,0,0,0,0,0,0,0
U.S. Department of Veterans Affairs,3330,1,0,0,1,1,0,0
linkedin corporation,2117,5,1,0,6,0.833333333,0.166666667,0
Adoption Exchange Association,3286,100,21,32,153,0.653594771,0.137254902,0.209150327
Eaton Corporation,2246,2,0,1,3,0.666666667,0,0.333333333
glispa,2657,7,0,1,8,0.875,0,0.125
workamajig,1883,0,0,0,0,0,0,0
Harrison College,3073,0,0,0,0,0,0,0
The Times Group,2266,0,0,0,0,0,0,0
Softango.com,3065,0,0,0,0,0,0,0
dealfind,2135,0,0,0,0,0,0,0
ChristianEducation.com,3454,0,0,2,2,0,0,1
BD,3649,0,0,1,1,0,0,1
Canadian Tire Corporation,3306,8,0,3,11,0.727272727,0,0.272727273
Amsterdam Printing,3075,0,0,0,0,0,0,0
Real Girls Media Network,3158,1,0,0,1,1,0,0
USC Rossier School of Education,3877,0,0,0,0,0,0,0
Emmanuel College,3536,0,0,0,0,0,0,0
Fabulous Fox Theatre,3733,0,0,0,0,0,0,0
South African Tourism,2324,0,0,0,0,0,0,0
Eggland's Best,3018,4,1,3,8,0.5,0.125,0.375
DrJays.com,2631,0,0,0,0,0,0,0
Cleveland Browns,3308,0,0,1,1,0,0,1
Care2.com,2854,0,0,1,1,0,0,1
Bottega Veneta,2362,0,0,0,0,0,0,0
MoneyGram International,2549,5,2,0,7,0.714285714,0.285714286,0
foxtab.com,1380,1,0,0,1,1,0,0
CSX Corporation,2632,11,0,6,17,0.647058824,0,0.352941176
"Recycle Rewards, Inc.",1763,0,0,0,0,0,0,0
The Shade Store,3325,0,0,0,0,0,0,0
T.M.Lewin & Sons Limited,3758,0,0,0,0,0,0,0
Bloomberg L.P.,3147,0,0,2,2,0,0,1
"Hasbro, Inc.",3538,7,6,7,20,0.35,0.3,0.35
Waterfront Media,2867,0,0,0,0,0,0,0
Cincinnati Bell Inc.,2643,0,0,1,1,0,0,1
KoyoteSoft,2999,9,0,6,15,0.6,0,0.4
Moozy,2672,3,0,0,3,1,0,0
O'Reilly Auto Parts,3760,0,0,0,0,0,0,0
Pigeon Forge Department of Tourism,3148,0,0,0,0,0,0,0
Finnair,2268,0,0,0,0,0,0,0
Snaptracs,2878,0,0,0,0,0,0,0
"American Cancer Society, Inc.",2650,3,0,2,5,0.6,0,0.4
Tervis,3031,0,0,0,0,0,0,0
"CenturyLink, Inc.",3157,38,2,2,42,0.904761905,0.047619048,0.047619048
"Martha Stewart Living Omnimedia, Inc.",3777,6,1,6,13,0.461538462,0.076923077,0.461538462
Mozilla Corp.,3166,0,0,0,0,0,0,0
"Volusions, Inc.",3336,15,0,0,15,1,0,0
Ubisoft Entertainment,3353,36,1,6,43,0.837209302,0.023255814,0.139534884
Cunard Line,2652,0,0,1,1,0,0,1
Abbott Laboratories,2263,12,4,15,31,0.387096774,0.129032258,0.483870968
Musician's Friend Inc.,3759,0,0,0,0,0,0,0
Focusfactor,2154,0,0,0,0,0,0,0
"Tagged, Inc.",3083,0,0,0,0,0,0,0
"Newgy Industries, Inc.",3729,1,0,0,1,1,0,0
Sears Canada Inc.,3360,2,2,0,4,0.5,0.5,0
Dillards,3320,3,0,2,5,0.6,0,0.4
The Goddard School,3531,5,0,1,6,0.833333333,0,0.166666667
"Bensussen Deutsch and Associates, Inc.",3774,0,0,0,0,0,0,0
Walts Food Center,3776,0,0,0,0,0,0,0
Seventh Generation,2170,0,0,0,0,0,0,0
Right to Work Committee,1888,0,0,0,0,0,0,0
"Delta Media, LLC",3748,3,0,0,3,1,0,0
Navy Federal Credit Union,1689,34,2,4,40,0.85,0.05,0.1
netQuote,3571,0,0,0,0,0,0,0
Campos,3077,0,0,0,0,0,0,0
The Berkeley MBA,3532,0,0,0,0,0,0,0
Meredith Corporation,2371,2,0,2,4,0.5,0,0.5
Pier 1 Imports,2162,9,0,4,13,0.692307692,0,0.307692308
Value City Furniture,2785,12,0,0,12,1,0,0
Electronic Arts Inc.,3879,274,53,27,354,0.774011299,0.149717514,0.076271186
Broadway in Chicago,1894,0,0,0,0,0,0,0
Walden University,2792,0,0,0,0,0,0,0
4imprint Inc.,3752,0,0,0,0,0,0,0
"Blue Star Jets, LLC",2646,0,0,0,0,0,0,0
Optum,3103,0,0,0,0,0,0,0
AMERICAN COALITION FOR CLEAN COAL ELECTRICITY,3378,0,0,0,0,0,0,0
"Astellas Pharma US, Inc.",3317,0,0,0,0,0,0,0
"Trulia, Inc.",3756,1,1,1,3,0.333333333,0.333333333,0.333333333
The NPD Group,2817,0,0,0,0,0,0,0
Coldwater Creek,3331,0,0,0,0,0,0,0
Datebook,2150,0,0,0,0,0,0,0
Fontainebleau Resorts,2892,0,0,5,5,0,0,1
JustAnswer LLC,2364,1,0,1,2,0.5,0,0.5
Fitness Anywhere LLC,2375,0,0,0,0,0,0,0
"RealNetworks, Inc.",3168,0,0,0,0,0,0,0
Gordon's Jewelers,1663,2,0,0,2,1,0,0
dotcomforsmallbiz.com,1357,0,0,0,0,0,0,0
Flixster Inc,2377,0,0,1,1,0,0,1
Tourism Division of the Pensacola Bay Area Chamber of Commerce,3772,0,0,0,0,0,0,0
Jackson Hole Mountain Resort,3128,0,0,0,0,0,0,0
Big Miracle Movie,3135,0,0,0,0,0,0,0
Oncor,559,0,0,0,0,0,0,0
Jones Soda Co.,551,0,0,0,0,0,0,0
Real Outdoor Living,1695,0,0,0,0,0,0,0
CafePress Inc.,2528,2,2,2,6,0.333333333,0.333333333,0.333333333
Hobsons College Recruiting,2382,3,0,1,4,0.75,0,0.25
firstBargain,1889,0,0,0,0,0,0,0
Roadside Attractions,3396,0,0,0,0,0,0,0
WinHost,3149,0,0,0,0,0,0,0
Empire State Building,1891,0,0,0,0,0,0,0
Fright Night Movie,1767,0,0,0,0,0,0,0
megalive,2121,0,0,0,0,0,0,0
Bright Future GmbH,3453,0,0,1,1,0,0,1
Kmart,423,11,0,2,13,0.846153846,0,0.153846154
UniversityDecisions.com,415,0,0,0,0,0,0,0
Mormon.org,1874,40,4,4,48,0.833333333,0.083333333,0.083333333
Jersey Boys,1398,0,0,0,0,0,0,0
Newegg,2164,13,8,11,32,0.40625,0.25,0.34375
Pinball Corporation,2321,1,0,0,1,1,0,0
Valve Corporation,2642,0,0,0,0,0,0,0
Colorado Technical University,573,0,0,0,0,0,0,0
Global Custom Commerce,3310,0,0,0,0,0,0,0
FOX Broadcasting Company(fox.com),2378,0,0,2,2,0,0,1
Themusclemaximizer.com,2532,6,0,0,6,1,0,0
"Keurig, Inc",2381,10,2,5,17,0.588235294,0.117647059,0.294117647
Cotton Incorporated,1688,0,0,0,0,0,0,0
Quepasa.com,438,0,0,0,0,0,0,0
Preview Magazine,720,0,0,0,0,0,0,0
Priceseekers.net,3146,0,0,0,0,0,0,0
IKEA,295,12,0,8,20,0.6,0,0.4
Free Ride Games,1045,0,0,0,0,0,0,0
"Stiefel Laboratories, Inc.",2781,0,0,0,0,0,0,0
"Gaiam, Inc.",3653,0,0,1,1,0,0,1
Avaak Inc.,3160,0,0,0,0,0,0,0
American Express Publishing,3078,10,0,4,14,0.714285714,0,0.285714286
Everyday Lifestyles,1915,2,0,0,2,1,0,0
Blockbuster,1909,0,0,0,0,0,0,0
Oregon Live LLC,2534,2,0,1,3,0.666666667,0,0.333333333
iShares,1901,2,0,3,5,0.4,0,0.6
Nestle,3801,20,4,23,47,0.425531915,0.085106383,0.489361702
Rickshawbags.com,3799,0,0,0,0,0,0,0
George Fox University,2853,0,0,0,0,0,0,0
EZ Trader,1914,0,0,0,0,0,0,0
Shen Yun Performing Arts,3579,0,0,0,0,0,0,0
Kitchen Society,900,0,0,0,0,0,0,0
Watson Pharma,2868,0,0,0,0,0,0,0
Deez Teez,1910,0,0,0,0,0,0,0
The Hollywood Reporter,3878,1,0,0,1,1,0,0
Versa Products Inc.,3798,2,2,0,4,0.5,0.5,0
Paychex,1913,0,0,0,0,0,0,0
"Harry Winston, Inc.",3746,1,0,1,2,0.5,0,0.5
"Carter's, Inc.",3802,0,0,0,0,0,0,0
GroovyDo,3753,0,0,0,0,0,0,0
GREENWOOD CONVENTION AND VISITOR’S BUREAU,2538,0,0,0,0,0,0,0
Mexico City,3588,0,0,0,0,0,0,0
Watch Station International.,3771,0,0,0,0,0,0,0
State Street Global Advisors,1911,0,0,1,1,0,0,1
Ides of March Movie,2142,0,0,0,0,0,0,0
Alactro LLC,2317,2,0,0,2,1,0,0
The Fuller CV Ltd.,845,0,0,0,0,0,0,0
Sierra Trading Post,1912,0,0,0,0,0,0,0
EveryFreeGame.net,2149,0,0,0,0,0,0,0
Eye-Fi,1881,0,0,0,0,0,0,0
BrandSigma,2367,0,0,0,0,0,0,0
theEssentials.com,1388,0,0,0,0,0,0,0
FuzeBox,3350,0,0,0,0,0,0,0
"News Communications, Inc.",3499,1,0,0,1,1,0,0
"NetSuite, Inc.",3581,0,0,0,0,0,0,0
Giant Eagle,3582,0,0,0,0,0,0,0
Aveda,2714,7,3,3,13,0.538461538,0.230769231,0.230769231
USInsuranceOnline.com,1725,0,0,0,0,0,0,0
MiMedia,1009,0,0,0,0,0,0,0
FedEx,1010,1,0,8,9,0.111111111,0,0.888888889
Talkswitch,1964,0,0,0,0,0,0,0
British Columbia,723,0,0,0,0,0,0,0
Carnival Corporation,432,48,7,6,61,0.786885246,0.114754098,0.098360656
New England Eye Center,834,0,0,0,0,0,0,0
Lauralton Hall,1183,0,0,0,0,0,0,0
YP Intellectual Property LLC (Yellow Pages),851,7,6,7,20,0.35,0.3,0.35
My Morning Jacket,1353,0,0,0,0,0,0,0
NPD Online Research,1634,0,0,0,0,0,0,0
"Dick's Sporting Goods, Inc.",2206,21,0,10,31,0.677419355,0,0.322580645
"Box, Inc.",2319,0,0,1,1,0,0,1
Cumulus Media and Mediaspan,3174,1,0,0,1,1,0,0
"DealerTrack, Inc.",3357,0,0,0,0,0,0,0
KPRC - Houston,3272,0,0,1,1,0,0,1
"Nautilus, Inc.",3274,0,0,0,0,0,0,0
NewEraCap.com,3491,1,0,0,1,1,0,0
Harry and David,3374,14,1,1,16,0.875,0.0625,0.0625
Summit Entertainment,3108,0,0,0,0,0,0,0
Cartier,2004,1,0,3,4,0.25,0,0.75
Pimsleur Approach,3506,3,1,0,4,0.75,0.25,0
VisualDNA,3391,0,0,0,0,0,0,0
We Give Books,1751,0,0,0,0,0,0,0
Victory Motorcycles,2806,0,0,0,0,0,0,0
"LifeScript, Inc.",2455,3,0,2,5,0.6,0,0.4
San Diego County Credit Union,2821,6,0,0,6,1,0,0
"Splunk, Inc.",2823,0,0,0,0,0,0,0
Largo Town Center,1653,0,0,0,0,0,0,0
Redcat,3525,0,0,0,0,0,0,0
2nd Story Software,3123,0,0,0,0,0,0,0
L.L.Bean,1285,150,88,1,239,0.627615063,0.368200837,0.0041841
Key Club,3442,0,0,0,0,0,0,0
Global Association of Risk Professionals,2991,0,0,0,0,0,0,0
Consumer Programs Incorporated,2840,0,0,0,0,0,0,0
ThirdAge,3189,0,0,0,0,0,0,0
The Dow Chemical Company,3021,0,0,0,0,0,0,0
The House of Blue Leaves,1368,0,0,0,0,0,0,0
AMSOIL,2904,0,0,0,0,0,0,0
The Boston Globe,2355,0,0,0,0,0,0,0
Snorgtees,2270,21,0,0,21,1,0,0
Nars Cosmetics,3038,0,0,0,0,0,0,0
WSDOT,3072,0,0,0,0,0,0,0
AstraZeneca,3172,1,0,3,4,0.25,0,0.75
Elite Island Resorts Inc.,3757,0,0,0,0,0,0,0
Rare Earth Exporters,1887,0,0,0,0,0,0,0
Mavericks,1902,0,0,0,0,0,0,0
"Pleasant Holidays, LLC",2535,1,1,2,4,0.25,0.25,0.5
Shea Homes,2542,0,0,2,2,0,0,1
"John Wiley & Sons, Inc.",2624,1,0,0,1,1,0,0
Deckers Outdoor Corporation,3346,3,3,7,13,0.230769231,0.230769231,0.538461538
Bel Brands,1925,0,0,0,0,0,0,0
Antec,1927,0,0,0,0,0,0,0
Ctrip.com,1929,0,0,0,0,0,0,0
CheapOAir,1930,6,0,0,6,1,0,0
"Garden City Group, Inc. (GCG)",1933,0,0,0,0,0,0,0
the McShane Letter,1995,0,0,0,0,0,0,0
Delivery.com,3432,0,0,0,0,0,0,0
Frederick’s of Hollywood,3359,13,1,0,14,0.928571429,0.071428571,0
"Zecco Holdings, Inc.",3489,0,0,0,0,0,0,0
Realtor.com,3576,2,0,1,3,0.666666667,0,0.333333333
Saint Mary's College of California,3089,0,0,0,0,0,0,0
KLM,2557,2,0,0,2,1,0,0
Tulalip Tribes,3106,0,0,0,0,0,0,0
Northeastern University,3389,1,0,0,1,1,0,0
"Merck & Co., Inc.",2723,72,1,15,88,0.818181818,0.011363636,0.170454545
GoodReads,2221,1,0,0,1,1,0,0
freeflys.com,2804,1,0,2,3,0.333333333,0,0.666666667
Net-a-Porter LLC,2453,0,0,2,2,0,0,1
RightNow,1868,0,0,0,0,0,0,0
Virtoso Software,1870,0,0,0,0,0,0,0
Texas University,3523,0,0,0,0,0,0,0
International Rescue Committee,3138,0,0,0,0,0,0,0
U.S. Department of Energy,3406,11,0,0,11,1,0,0
"ESET, spol. s r. o.",2640,8,0,0,8,1,0,0
"Applebee's International, Inc.",2655,6,2,2,10,0.6,0.2,0.2
AutoTraderClassics.com,3323,0,0,0,0,0,0,0
PulseTV.com,2670,0,0,1,1,0,0,1
Cedars-Sinai,3055,19,1,0,20,0.95,0.05,0
Leonisa Inc.,3608,0,0,0,0,0,0,0
Hershey Entertainment & Resorts Company,3740,0,0,1,1,0,0,1
"Project Management Institute, Inc.",3742,0,0,0,0,0,0,0
Bastards of Hell,1049,0,0,0,0,0,0,0
Sarasota Convention & Visitors Bureau,3876,0,0,0,0,0,0,0
palace resorts,2855,1,0,1,2,0.5,0,0.5
SEGA Corporation,2370,0,0,0,0,0,0,0
Spike Digital Entertainment,2372,15,1,3,19,0.789473684,0.052631579,0.157894737
Safe Auto,1921,1,0,1,2,0.5,0,0.5
General Motors,2786,11,4,7,22,0.5,0.181818182,0.318181818
Timberland,2552,2,2,1,5,0.4,0.4,0.2
"Memory Lane, Inc.",1982,5,0,0,5,1,0,0
LensCrafters,3379,3,0,1,4,0.75,0,0.25
Xvid,2718,23,0,1,24,0.958333333,0,0.041666667
Great Sports Inc. & Efficient Future Inc.,3111,1,0,0,1,1,0,0
3M,2007,8,2,0,10,0.8,0.2,0
Tacori,2818,0,0,0,0,0,0,0
More-Thing Company,3184,0,0,0,0,0,0,0
Sun Mountain Lodge,1680,0,0,0,0,0,0,0
Craftstar Homes,1039,0,0,0,0,0,0,0
LetsMove.gov,3143,1,0,1,2,0.5,0,0.5
State of New Jersey,3284,1,0,1,2,0.5,0,0.5
"Numera Software, Inc.",3647,0,0,0,0,0,0,0
REAL Watersports,2850,0,0,0,0,0,0,0
TrueSwords.com,3145,0,0,0,0,0,0,0
De Beers Diamond Jewellers,3288,38,14,8,60,0.633333333,0.233333333,0.133333333
Bell Canada,2250,6,0,2,8,0.75,0,0.25
Nexon America,2252,0,0,0,0,0,0,0
"eVenues, Inc.",2341,0,0,0,0,0,0,0
New Relic,2350,3,0,2,5,0.6,0,0.4
"GrubHub, Inc.",3318,42,3,2,47,0.893617021,0.063829787,0.042553191
"GateHouse Media, Inc.",3745,0,0,1,1,0,0,1
AEO Management,3152,0,0,0,0,0,0,0
Porsche,1046,17,0,18,35,0.485714286,0,0.514285714
zt Systems,1884,0,0,0,0,0,0,0
King's Hawaiian,1907,2,0,0,2,1,0,0
uDraw Game Tablet,442,0,0,0,0,0,0,0
MyPaydayLoanCash.com,1209,0,0,0,0,0,0,0
PersonalizationMall.com,1210,0,0,0,0,0,0,0
Gunshine.net,859,0,0,0,0,0,0,0
Avon,974,8,3,3,14,0.571428571,0.214285714,0.214285714
EAT! Vancouver,304,0,0,0,0,0,0,0
NOS Energy Drink,991,0,0,0,0,0,0,0
River & Trail Outfitters,965,0,0,0,0,0,0,0
Barilla,1846,1,0,2,3,0.333333333,0,0.666666667
Primedia,1977,0,0,2,2,0,0,1
Wacom,861,5,0,3,8,0.625,0,0.375
Refinery29,2328,1,0,0,1,1,0,0
Plummers,3417,0,0,0,0,0,0,0
"Greyhound Lines, Inc",3568,13,2,0,15,0.866666667,0.133333333,0
FamilyRadio.com,311,0,0,0,0,0,0,0
"Beau-coup Favors, Inc",3613,0,0,0,0,0,0,0
EarthShare,997,21,0,0,21,1,0,0
California Energy Commission,3881,0,0,0,0,0,0,0
Virgin Atlantic Airways,3886,0,0,0,0,0,0,0
Preen,1254,0,0,0,0,0,0,0
Pennsylvania Lottery,3884,4,0,2,6,0.666666667,0,0.333333333
Talbots,1858,2,2,0,4,0.5,0.5,0
HitFix.com,3271,1,0,1,2,0.5,0,0.5
AfroRomance,1976,0,0,0,0,0,0,0
Lincoln College of New England,3887,0,0,0,0,0,0,0
Frost Bank,2215,0,0,2,2,0,0,1
SAAB AB,3806,0,0,0,0,0,0,0
Golden Rule Insurance Company,3888,0,0,0,0,0,0,0
Scholastic Inc.,2326,1,0,1,2,0.5,0,0.5
"AdReady, Inc.",3620,0,0,0,0,0,0,0
TuneUp Media,2451,0,0,0,0,0,0,0
New York Public Radio,3890,0,0,0,0,0,0,0
Gifting Grace,2783,0,0,0,0,0,0,0
Quantum Jumping,3622,0,0,0,0,0,0,0
National Federation of Independent Business,3497,0,0,0,0,0,0,0
"Good Life, LLC",3809,0,0,0,0,0,0,0
Sit n Sleep,3811,0,0,0,0,0,0,0
Disc Makers,3412,0,0,0,0,0,0,0
Compagnie Financière Richemont S.A.,3892,0,0,0,0,0,0,0
XCommerce Innovate Conference,3812,0,0,0,0,0,0,0
Blue Shield of California,3362,3,1,1,5,0.6,0.2,0.2
VersaTables,3276,0,0,0,0,0,0,0
LifeStation Inc.,3627,0,0,0,0,0,0,0
Sun Life Financial,856,0,0,0,0,0,0,0
"Entertainment Cruises, Inc.",3897,1,1,1,3,0.333333333,0.333333333,0.333333333
Shire US Inc.,3369,7,0,9,16,0.4375,0,0.5625
BikeBandit.com,3505,0,0,0,0,0,0,0
Company C,3517,4,0,0,4,1,0,0
Detroit Medical Center,3496,1,0,1,2,0.5,0,0.5
ConnectWise,3817,0,0,0,0,0,0,0
Military Sealift Command,3818,0,0,0,0,0,0,0
Lucky Supermarkets,3580,0,0,0,0,0,0,0
Arizona Lottery,3815,0,0,0,0,0,0,0
Iredale Mineral Cosmetics,3113,0,0,0,0,0,0,0
Tire Kingdom,3891,0,0,0,0,0,0,0
AmeriSave Mortgage,3634,1,0,1,2,0.5,0,0.5
chico's,308,3,1,4,8,0.375,0.125,0.5
GoGrid LLC,3810,3,0,0,3,1,0,0
Waubonsee Community College,3823,0,0,0,0,0,0,0
Fonality Inc.,3814,13,1,0,14,0.928571429,0.071428571,0
Riviana Foods Inc.,1231,0,0,0,0,0,0,0
"Jos. A. Bank Clothiers, Inc.",2391,1,0,0,1,1,0,0
Napster,1249,0,0,0,0,0,0,0
Spiceworks,3504,0,0,0,0,0,0,0
Holland America,857,64,3,5,72,0.888888889,0.041666667,0.069444444
Smashbox Cosmetics,3820,0,0,0,0,0,0,0
Chegg Inc.,2392,1,1,0,2,0.5,0.5,0
Qualcomm Incorporated,2388,2,0,3,5,0.4,0,0.6
Cystic Fibrosis Foundation,3633,0,0,0,0,0,0,0
Price Point Mail Order LTD,3788,1,0,0,1,1,0,0
XING Ag,3624,0,0,0,0,0,0,0
"Fanpop, Inc",2389,0,0,0,0,0,0,0
"Medtronic, Inc.",3623,0,0,0,0,0,0,0
UL LLC,3784,3,0,2,5,0.6,0,0.4
TurtlePress.com,1349,0,0,0,0,0,0,0
GlobalSpec,2393,1,0,0,1,1,0,0
Ghost Rider Spirit of Vengeance Movie,3894,0,0,0,0,0,0,0
Providence Health & Services,1067,0,0,0,0,0,0,0
Atlassian,3824,0,0,0,0,0,0,0
INetU Inc,3898,0,0,0,0,0,0,0
California State Lottery,3900,3,0,0,3,1,0,0
"Genuine Hotrod Hardware, Inc.",3829,0,0,0,0,0,0,0
"Country Music Television, Inc.",2386,1,0,0,1,1,0,0
"Principal Financial Services, Inc.",3785,0,0,0,0,0,0,0
eMusic.com Inc.,2394,0,0,0,0,0,0,0
"Go RVing, Inc.",3949,0,0,0,0,0,0,0
Vision Electronics,3790,0,0,0,0,0,0,0
"Gorjana & Griffin, Inc.",3640,3,0,1,4,0.75,0,0.25
"illy caffè North America, Inc.",3794,0,0,0,0,0,0,0
Caesary.net,3832,0,0,0,0,0,0,0
Suba Games,1069,0,0,0,0,0,0,0
SanDisk Corporation,3787,7,1,1,9,0.777777778,0.111111111,0.111111111
Brown-Forman Corporation,3792,0,0,1,1,0,0,1
Wooz World Inc.,3830,0,0,0,0,0,0,0
Lexington Law,3791,0,0,0,0,0,0,0
Tmart.com,1724,0,0,0,0,0,0,0
Gay.com,1956,0,0,0,0,0,0,0
MasterCard,1856,80,21,12,113,0.707964602,0.185840708,0.10619469
Time Wasterz,1967,0,0,0,0,0,0,0
Playdom,1974,9,0,0,9,1,0,0
air canada,2106,1,0,3,4,0.25,0,0.75
Fry's Electronics,2210,13,0,0,13,1,0,0
Bathroom-Glass-Vanities.com,3410,0,0,0,0,0,0,0
"Audyssey Laboratories, Inc.",3578,0,0,0,0,0,0,0
Ouidad,2710,0,0,0,0,0,0,0
Unum Group,3092,0,0,2,2,0,0,1
Personal Liberty Digest,2560,0,0,1,1,0,0,1
"tastytrade, Inc.",3428,0,0,0,0,0,0,0
Julianna Rae,3510,0,0,0,0,0,0,0
Major League Baseball,2217,1,0,1,2,0.5,0,0.5
COMPLEX MEDIA NETWORK,2803,0,0,0,0,0,0,0
Barceló Hotels & Resorts,2467,2,0,0,2,1,0,0
CIBC,2810,1,0,2,3,0.333333333,0,0.666666667
South Park Digital Studios,3435,0,0,1,1,0,0,1
Princess Cruises,1656,9,0,7,16,0.5625,0,0.4375
The Kingsford Products Company ,1031,0,0,0,0,0,0,0
Illinois Department of Transportation,1281,0,0,0,0,0,0,0
"American Heart Association, Inc.",2735,6,0,1,7,0.857142857,0,0.142857143
Untrue.com,2835,0,0,0,0,0,0,0
"HSN, Inc.",3446,21,0,5,26,0.807692308,0,0.192307692
SelectTech,1363,0,0,0,0,0,0,0
Summit Racing,2242,0,0,0,0,0,0,0
Kensignton Publishing Corp.,3528,0,0,0,0,0,0,0
Future US,3010,0,0,0,0,0,0,0
Live Smart Solutions,3017,0,0,0,0,0,0,0
"Aeria Games & Entertainment, Inc.",3296,2,0,0,2,1,0,0
"The Weather Channel, LLC",2342,0,0,0,0,0,0,0
Art Van Furniture,3035,0,0,2,2,0,0,1
MOTHER NATURE NETWORK,2649,1,0,1,2,0.5,0,0.5
Dream World MMORPG,1072,0,0,0,0,0,0,0
U.S. Army,2267,2,0,3,5,0.4,0,0.6
Senior Annuity Alert,3596,0,0,0,0,0,0,0
"Sonos, Inc.",3728,5,0,6,11,0.454545455,0,0.545454545
The New School,2360,33,3,1,37,0.891891892,0.081081081,0.027027027
Boston Reed College,3603,0,0,0,0,0,0,0
"MetroPCS Wireless, Inc.",3610,4,1,1,6,0.666666667,0.166666667,0.166666667
"New Balance Athletic Shoe, Inc.",3796,0,0,0,0,0,0,0
1800 Tequila,1081,0,0,0,0,0,0,0
Seattle Cancer Care Alliance,3803,0,0,0,0,0,0,0
Cigna,1906,0,0,0,0,0,0,0
National Cable Satellite Corporation,1917,0,0,0,0,0,0,0
Michael Foods Company,3821,0,0,1,1,0,0,1
WeFeedback,1071,0,0,0,0,0,0,0
"RadiumOne, Inc.",3635,0,0,0,0,0,0,0
Sports Illustrated,1411,1,0,1,2,0.5,0,0.5
Xoom,1073,3,0,0,3,1,0,0
Visit Orlando,1097,0,0,0,0,0,0,0
Craftmark Homes,1089,0,0,0,0,0,0,0
"Square, Inc.",1074,7,1,1,9,0.777777778,0.111111111,0.111111111
Riftforge RPG,1084,0,0,0,0,0,0,0
Bosch,1096,0,0,0,0,0,0,0
City University of Seattle,1080,0,0,0,0,0,0,0
Lacoste,1407,1,0,0,1,1,0,0
Chevron,1078,10,1,17,28,0.357142857,0.035714286,0.607142857
Providence Regional Cancer Partnership,1082,0,0,0,0,0,0,0
Fandango,1405,1,0,1,2,0.5,0,0.5
Weather.com,1414,0,0,0,0,0,0,0
US Bank,1416,0,0,0,0,0,0,0
Kreations By Karen,1400,0,0,0,0,0,0,0
AwesomePennyStocks,1412,0,0,0,0,0,0,0
"Entrepreneur Media, Inc.",2625,2,0,1,3,0.666666667,0,0.333333333
"ADT Security Services, Inc.",3268,206,11,3,220,0.936363636,0.05,0.013636364
"Blue Cross and Blue Shield of Massachusetts, Inc.",3270,0,0,1,1,0,0,1
Oregon Health & Science University,3361,0,0,0,0,0,0,0
WNBA Enterprises,3363,0,0,0,0,0,0,0
"ConsumerSearch, Inc.",3368,0,0,0,0,0,0,0
Alberta Canada,3493,0,0,0,0,0,0,0
Ford Motor Company,3502,104,22,52,178,0.584269663,0.123595506,0.292134831
Rolex,2561,0,0,2,2,0,0,1
"Micron Technology, Inc.",2793,12,2,1,15,0.8,0.133333333,0.066666667
Kizuna Cranes,1989,0,0,0,0,0,0,0
"Taylor Made Golf Company, Inc.",3429,0,0,0,0,0,0,0
Hansons,2725,0,0,0,0,0,0,0
Kudzu.com,2225,1,0,1,2,0.5,0,0.5
P.C. Richard & Son,2566,5,2,3,10,0.5,0.2,0.3
Strikeforce Challengers,1264,0,0,0,0,0,0,0
"TripAdvisor, Inc.",2459,26,6,6,38,0.684210526,0.157894737,0.157894737
DealCent,3436,0,0,0,0,0,0,0
Princess Margaret Hospital Foundation,3438,0,0,0,0,0,0,0
Travian Games GmbH,2827,2,0,1,3,0.666666667,0,0.333333333
Biltmore,2895,5,1,0,6,0.833333333,0.166666667,0
Alldaymall.com,3129,0,0,0,0,0,0,0
Tourism Ireland,2736,1,0,1,2,0.5,0,0.5
Canoe,2993,0,0,0,0,0,0,0
Townhall Magazine,3527,0,0,0,0,0,0,0
NCH Software,2259,3,0,0,3,1,0,0
GoodAccountants.com,1364,0,0,0,0,0,0,0
Swanson Health Products,3529,4,0,0,4,1,0,0
Karmaloop,2357,28,1,1,30,0.933333333,0.033333333,0.033333333
"Llama Productions, LLC.",2634,0,0,0,0,0,0,0
"Coach, Inc.",2636,2,0,3,5,0.4,0,0.6
"Commerce Bancshares, Inc.",3327,0,0,0,0,0,0,0
"Embarcadero Technologies, Inc.",3338,0,0,0,0,0,0,0
Baylor Health Care System,2668,0,0,0,0,0,0,0
Avnet,3059,0,0,0,0,0,0,0
The Economist Group,2366,45,2,1,48,0.9375,0.041666667,0.020833333
"Evite, Inc.",3161,0,0,0,0,0,0,0
Allianz,3795,2,1,2,5,0.4,0.2,0.4
Immortals Movie,3761,0,0,0,0,0,0,0
Dreamstime,2166,0,0,0,0,0,0,0
Van Eck Securities Corporation,3804,0,0,2,2,0,0,1
Handyman Club of America,1934,0,0,0,0,0,0,0
The Regents of the University of California,3638,1,0,1,2,0.5,0,0.5
HealthiNation,1057,1,0,0,1,1,0,0
FX Solutions,1064,0,0,0,0,0,0,0
Amway,3831,16,0,1,17,0.941176471,0,0.058823529
Western Governors University,1421,0,0,0,0,0,0,0
Transformers Movie,1056,0,0,0,0,0,0,0
MyWedding LLC,3828,0,0,0,0,0,0,0
Wen Haircare,1426,6,0,0,6,1,0,0
Mobil,1507,0,0,0,0,0,0,0
Buy.com,1484,0,0,4,4,0,0,1
PlanB One-Step,1447,0,0,0,0,0,0,0
Bank of the West,1445,1,0,0,1,1,0,0
KeyBank,1424,7,2,1,10,0.7,0.2,0.1
Milanoo,1514,0,0,0,0,0,0,0
Chiquita Brands,1460,0,0,0,0,0,0,0
PayPal,1486,0,0,0,0,0,0,0
American Society of Plastic Surgeons,1431,0,0,0,0,0,0,0
IMAX Corporation,1478,0,0,0,0,0,0,0
Korean Free Economic Zones,1456,0,0,0,0,0,0,0
Tiny Prints,1443,28,3,2,33,0.848484848,0.090909091,0.060606061
PDF Reader,1494,0,0,0,0,0,0,0
EastWestBank,1488,0,0,0,0,0,0,0
TD Canada,1423,1,0,2,3,0.333333333,0,0.666666667
Business English Pod,1432,0,0,0,0,0,0,0
Finger Lakes Wine Country,1496,0,0,0,0,0,0,0
Schneider Electric,1498,1,0,3,4,0.25,0,0.75
IntegraMed,3903,0,0,0,0,0,0,0
Kingston Technology,1070,0,0,0,0,0,0,0
Save the Children,1095,4,0,0,4,1,0,0
clk4.com,1399,0,0,0,0,0,0,0
Biztree,1449,0,0,0,0,0,0,0
ArcadeBliss,1506,0,0,0,0,0,0,0
eFax,1978,0,0,0,0,0,0,0
Friends of Sherrod Brown,3099,0,0,0,0,0,0,0
CarSoup,3381,1,0,1,2,0.5,0,0.5
Agoda Company,2882,0,0,0,0,0,0,0
Canada.com,3514,0,0,1,1,0,0,1
Macmillan Publishers,2227,5,0,2,7,0.714285714,0,0.285714286
Avery Dennison Corporation,2799,0,0,0,0,0,0,0
ClipnGoCoupons,1745,0,0,0,0,0,0,0
Globoforce,1024,0,0,0,0,0,0,0
Cinemax,1863,0,0,0,0,0,0,0
MailChimp,1678,2,0,1,3,0.666666667,0,0.333333333
Cooking.com,2331,1,0,2,3,0.333333333,0,0.666666667
"Konami Digital Entertainment, Inc.",2731,0,0,0,0,0,0,0
"OM Securities, LLC",3281,0,0,0,0,0,0,0
DailyBurn,2899,0,0,0,0,0,0,0
Arthritis Foundation,3199,0,0,0,0,0,0,0
The Bank of New York Mellon Corporation,3650,0,0,0,0,0,0,0
U.S. News & World Report,3449,0,0,0,0,0,0,0
Fifth Third Bank,3013,0,0,0,0,0,0,0
Mercury Insurance Group,2264,12,0,1,13,0.923076923,0,0.076923077
Orbit,1378,0,0,0,0,0,0,0
Eastbay,2345,32,17,1,50,0.64,0.34,0.02
"novel labs, inc.",3314,39,2,2,43,0.906976744,0.046511628,0.046511628
David's Bridal,3046,0,0,0,0,0,0,0
BedBugs911.net,3732,0,0,0,0,0,0,0
Penn State University,2363,1,0,0,1,1,0,0
Dun & Bradstreet,3081,0,0,0,0,0,0,0
"Hearst Television, Inc.",3749,2,0,6,8,0.25,0,0.75
Barton Club Drive,3750,0,0,0,0,0,0,0
Scotia Capital Inc.,3768,0,0,0,0,0,0,0
Zappos,1895,291,94,6,391,0.744245524,0.240409207,0.015345269
"Capitol Broadcasting Company, Inc.",3800,0,0,0,0,0,0,0
Colgate-Palmolive,3617,0,0,5,5,0,0,1
"South Carolina Department of Parks, Recreation & Tourism",3631,0,0,0,0,0,0,0
Teavana Corp.,3782,0,0,0,0,0,0,0
"Second Rotation, Inc.",2395,0,0,0,0,0,0,0
New World Pasta Company,1077,0,0,0,0,0,0,0
Greater Oklahoma City Chamber,1409,0,0,0,0,0,0,0
Feldco,1427,0,0,0,0,0,0,0
Cayman Islands Department of Tourism,3585,0,0,5,5,0,0,1
Tourism Australia,3085,0,0,0,0,0,0,0
GE (General Electric Company),3371,0,0,1,1,0,0,1
Cashcall,1981,0,0,0,0,0,0,0
Pinnacle Gold Group,2224,0,0,0,0,0,0,0
Just My Size,2006,0,0,0,0,0,0,0
GroupLogic,1749,0,0,0,0,0,0,0
"Tyson Foods, Inc.",2460,11,1,8,20,0.55,0.05,0.4
"MFS Fund Distributors, Inc.",2728,0,0,5,5,0,0,1
Lawyers.com,1667,0,0,0,0,0,0,0
Columbia University,2017,0,0,0,0,0,0,0
Outskirts Press,1867,0,0,0,0,0,0,0
Raley's,2567,7,0,3,10,0.7,0,0.3
Jewelry Exchange,3121,1,0,0,1,1,0,0
Lend RIGHT,1756,0,0,0,0,0,0,0
HarperCollins Publishers,2985,0,0,1,1,0,0,1
Getaround,3278,0,0,0,0,0,0,0
National Appraisal Guides Inc.,2335,0,0,1,1,0,0,1
Cincinnati Symphony & Pops Orchestras,3646,0,0,0,0,0,0,0
ZoCo1,2992,1,0,1,2,0.5,0,0.5
Visual Apex,3285,0,0,1,1,0,0,1
KSL Broadcasting,2628,1,0,0,1,1,0,0
pcgames.com,1381,0,0,0,0,0,0,0
TOMS Shoes,2903,2,0,3,5,0.4,0,0.6
Engine,3535,0,0,0,0,0,0,0
"AMS Holding, LLC",2349,0,0,0,0,0,0,0
Forest County Potawatomi Community,2635,0,0,1,1,0,0,1
Rebtel,2660,0,0,0,0,0,0,0
ReplayPhotos.com,3321,2,0,0,2,1,0,0
Fantage,3042,2,0,0,2,1,0,0
New York Life Insurance Company,2667,1,0,2,3,0.333333333,0,0.666666667
Live Oak Bank,3067,0,0,0,0,0,0,0
Ashford.com,3739,0,0,0,0,0,0,0
"Hi-Rez Studios, Inc.",3153,0,0,0,0,0,0,0
"My Damn Channel, Inc.",3171,0,0,0,0,0,0,0
Auto Insurance Hints Tips and News,2160,0,0,0,0,0,0,0
US Airways,2167,16,2,1,19,0.842105263,0.105263158,0.052631579
Oreck Corporation,2374,5,1,1,7,0.714285714,0.142857143,0.142857143
Save the Internet,1924,0,0,0,0,0,0,0
"ZipRealty, Inc.",3614,0,0,0,0,0,0,0
"Speed Channel, Inc.",3621,0,0,0,0,0,0,0
"Take-Two Interactive Software, Inc.",3628,13,0,1,14,0.928571429,0,0.071428571
Onion Inc,2385,0,0,2,2,0,0,1
Pepperdine University,3789,0,0,1,1,0,0,1
Skirt.com,1088,0,0,0,0,0,0,0
Lancome,1438,1,0,1,2,0.5,0,0.5
"Bed Bath & Beyond, Inc.",3893,22,1,0,23,0.956521739,0.043478261,0
Altec Lansing,1066,0,0,0,0,0,0,0
Go Jane,3572,0,0,0,0,0,0,0
"Mead Johnson & Company, LLC.",2791,0,0,4,4,0,0,1
Marketplacedetroit.com,3093,0,0,0,0,0,0,0
TGI Friday's Inc.,2559,9,0,0,9,1,0,0
Zerone Watches,1021,0,0,0,0,0,0,0
Power2Wait,1998,0,0,0,0,0,0,0
"BUCA, Inc.",3393,9,1,0,10,0.9,0.1,0
Levi Strauss & Co.,2457,43,11,11,65,0.661538462,0.169230769,0.169230769
Western International University,1030,0,0,0,0,0,0,0
Chamberlain College of Nursing,2334,4,0,1,5,0.8,0,0.2
eLearners.com,3202,0,0,0,0,0,0,0
American Furniture Warehouse,3293,3,0,1,4,0.75,0,0.25
"doggyloot, LLC",1766,0,0,0,0,0,0,0
WildTangent,3000,0,0,0,0,0,0,0
Audubon Nature Institute,3302,0,0,0,0,0,0,0
Michael Kors,3329,0,0,0,0,0,0,0
PG Store,3597,0,0,1,1,0,0,1
InterActiveCorp,3736,0,0,0,0,0,0,0
Helen of Troy Limited Company,3604,0,0,0,0,0,0,0
PetFlow.com,3738,0,0,0,0,0,0,0
Smile Train,3070,1,0,0,1,1,0,0
Rainier Industries,1691,0,0,0,0,0,0,0
Times Internet Limited,3770,0,0,1,1,0,0,1
esri,1391,0,0,0,0,0,0,0
Neopost USA Inc.,3797,3,0,0,3,1,0,0
Party City,3895,0,0,0,0,0,0,0
"BookRenter.com, Inc.",3629,0,0,0,0,0,0,0
Flex-Belt Company Inc.,3904,1,0,0,1,1,0,0
Server Fault,1087,0,0,0,0,0,0,0
Fashion Fantasy Game,1098,0,0,0,0,0,0,0
Comerica Bank,1489,1,0,0,1,1,0,0
"Punchbowl, Inc.",3808,0,1,0,1,0,1,0
AirWair Intl. Ltd.,3625,0,0,2,2,0,0,1
The Denver Center for the Performing Arts,3825,1,0,0,1,1,0,0
Meijer Inc.,2387,2,0,3,5,0.4,0,0.6
Pacific Office Automation,1083,0,0,0,0,0,0,0
Better Coupons,1085,0,0,0,0,0,0,0
Eziba,1453,0,0,0,0,0,0,0
VacationsToGo.com,1504,3,0,0,3,1,0,0
Intelius,2551,1,0,0,1,1,0,0
Brown Mackie College,1983,0,0,0,0,0,0,0
SeniorPeopleMeet,1990,0,0,0,0,0,0,0
The Ryland Group,2719,1,0,3,4,0.25,0,0.75
The Uniformed Services Benefit Association (USBA),3430,0,0,0,0,0,0,0
"Bon-Ton Stores, Inc.",3512,0,0,0,0,0,0,0
TechCrunch,1747,0,0,0,0,0,0,0
Daimler Vans,2887,6,0,0,6,1,0,0
University of Washington,1665,1,0,1,2,0.5,0,0.5
Keller Graduate School of Management,1272,10,0,3,13,0.769230769,0,0.230769231
North American Membership Group,2240,0,0,0,0,0,0,0
U.S. Marine Corps,3394,31,1,1,33,0.939393939,0.03030303,0.03030303
GlobalGiving Foundation,2469,0,0,0,0,0,0,0
PwC,3187,0,0,1,1,0,0,1
Family Credit Counseling Service,3144,0,0,0,0,0,0,0
Off the Grid News,1758,0,0,0,0,0,0,0
Sharethrough,1872,0,0,0,0,0,0,0
Indiana Wesleyan University,2994,0,0,0,0,0,0,0
Ventumar S.A.,3455,0,0,0,0,0,0,0
Cabela's,1372,1,0,0,1,1,0,0
Dollar Bank,2901,0,0,2,2,0,0,1
New York Film Academy,3294,2,0,0,2,1,0,0
The Weinstein Company,2340,0,0,0,0,0,0,0
Dotblu Inc.,2569,0,0,0,0,0,0,0
GE Capital Retail Bank,2658,55,20,8,83,0.662650602,0.240963855,0.096385542
Frontpoint Security Solutions,3037,0,0,0,0,0,0,0
Commerce Lexington Inc,2358,1,0,1,2,0.5,0,0.5
The Hershey Company,3737,11,0,0,11,1,0,0
"Move, Inc.",2365,6,0,1,7,0.857142857,0,0.142857143
Salon Media Group,3069,1,0,0,1,1,0,0
Infusionsoft,2151,17,2,1,20,0.85,0.1,0.05
Westwood College,3612,3,0,0,3,1,0,0
War Horse Movie,3880,0,0,0,0,0,0,0
Wavecrest Computing,1054,0,0,0,0,0,0,0
TV Guide,3805,1,0,0,1,1,0,0
Airpush,3619,0,0,0,0,0,0,0
"BCBG MAX AZRIA GROUP, INC.",3630,10,0,2,12,0.833333333,0,0.166666667
"Steve Madden, Ltd.",3780,0,0,0,0,0,0,0
FXCM Inc.,2383,0,0,0,0,0,0,0
Tourism Whistler,2390,0,0,0,0,0,0,0
DebtReliefCenter.org,3905,0,0,0,0,0,0,0
NeighborWorks,1090,0,0,0,0,0,0,0
Thrillist,1415,0,0,0,0,0,0,0
Cognizant,1454,0,0,0,0,0,0,0
Lot18,1508,0,0,0,0,0,0,0
Webfetti,1515,0,0,0,0,0,0,0
Jeep,975,126,20,59,205,0.614634146,0.097560976,0.287804878
Miss Utility of Virginia,1308,0,0,0,0,0,0,0
MakeMyDomainFast.com,1726,0,0,0,0,0,0,0
AARP,1862,134,15,7,156,0.858974359,0.096153846,0.044871795
"Serve Virtual Enterprises, Inc.",2330,25,1,1,27,0.925925926,0.037037037,0.037037037
Yamaha Motor,3265,0,0,3,3,0,0,1
John Moore LP,3415,0,0,0,0,0,0,0
Almond Board of CA,3566,0,0,2,2,0,0,1
Goodway Group,1007,0,0,0,0,0,0,0
Inspirato LLC,1980,2,0,4,6,0.333333333,0,0.666666667
"Citrix Systems, Inc.",2798,62,3,5,70,0.885714286,0.042857143,0.071428571
SuperJeweler.com,3383,0,0,0,0,0,0,0
Cache,3515,0,0,0,0,0,0,0
TheLaw.tv,2230,0,0,3,3,0,0,1
The News & Observer Publishing Company,2979,0,0,2,2,0,0,1
Heal the Bay,1743,0,0,0,0,0,0,0
The Hangover Part II Movie,1258,0,0,0,0,0,0,0
Pacific Medical Centers,3115,0,0,0,0,0,0,0
MidwayUSA,3116,0,0,0,0,0,0,0
"MapMyFITNESS, Inc.",3434,0,0,1,1,0,0,1
iCrystal New York,1026,0,0,0,0,0,0,0
Keiser University,1662,4,0,0,4,1,0,0
Bradenton Area Convention and Visitor's Bureau,3835,1,0,0,1,1,0,0
Oakland University,3180,2,0,0,2,1,0,0
Fiat,1361,93,11,25,129,0.720930233,0.085271318,0.19379845
Luxemont LLC,2729,1,0,1,2,0.5,0,0.5
Persol,1362,0,0,0,0,0,0,0
PhotoJoy,1044,0,0,0,0,0,0,0
Internet Broadcasting Systems,2898,0,0,1,1,0,0,1
Film Society of Lincoln Center,3838,0,0,0,0,0,0,0
Blue Baldur,3648,0,0,0,0,0,0,0
Rotterdam School of Management Erasmus University,3448,0,0,0,0,0,0,0
"Age of Learning, Inc.",2247,0,0,0,0,0,0,0
Belly Fat Free LLC,2261,0,0,1,1,0,0,1
U.S. Air Force,2262,2,0,7,9,0.222222222,0,0.777777778
Get Motivated,3847,0,0,0,0,0,0,0
NYSE Euronext,3851,0,0,0,0,0,0,0
Kashi Company,3852,0,0,0,0,0,0,0
Medica,3857,0,0,0,0,0,0,0
StimulusGrantApproval.com,3855,0,0,0,0,0,0,0
"Living Direct, Inc.",3841,0,0,0,0,0,0,0
CarMD.com Corp,3845,0,0,0,0,0,0,0
Foot Locker Inc. ,3854,17,21,5,43,0.395348837,0.488372093,0.11627907
"InvestorPlace Media, LLC.",3955,2,0,0,2,1,0,0
"Lemieux Group, LP",3961,0,0,0,0,0,0,0
Research in Motion Limited,3957,21,6,10,37,0.567567568,0.162162162,0.27027027
Oregon Humane Society,3965,0,0,1,1,0,0,1
Southern Company,3973,0,0,3,3,0,0,1
"Plantronics, Inc.",4000,5,1,0,6,0.833333333,0.166666667,0
Stayz Pty Ltd.,3969,0,0,0,0,0,0,0
Yepi.com,3980,2,1,1,4,0.5,0.25,0.25
Infragistics,3970,1,0,0,1,1,0,0
MGM Resorts International,4004,16,0,7,23,0.695652174,0,0.304347826
"American City Business Journals, Inc.",3964,0,0,0,0,0,0,0
US Search.com,4062,0,0,0,0,0,0,0
"Jack in the Box, Inc.",3960,0,0,2,2,0,0,1
Bally Total Fitness,4011,2,0,0,2,1,0,0
SkeinGlobe,4098,0,0,0,0,0,0,0
Roseville Automall,3966,1,0,0,1,1,0,0
Dominion Enterprises,3958,0,0,3,3,0,0,1
AXA Equitable Life Insurance Company,4006,1,0,1,2,0.5,0,0.5
The First Marblehead Corporation.,3974,0,0,0,0,0,0,0
Check 'n Go,4003,7,6,0,13,0.538461538,0.461538462,0
Marketwire,4005,0,0,0,0,0,0,0
Reimage,2408,3,0,1,4,0.75,0,0.25
"Mint Software, Inc.",3984,0,0,0,0,0,0,0
Notre Dame de Namur University,3979,0,0,0,0,0,0,0
"K&N Engineering, Inc.",3992,0,0,1,1,0,0,1
TDT Media Inc.,4001,0,0,0,0,0,0,0
"Green Mountain Coffee Roasters, Inc.",3975,0,0,0,0,0,0,0
Auction.com,4090,17,0,2,19,0.894736842,0,0.105263158
Chronicity Inc.,4031,0,0,0,0,0,0,0
YuMe,4038,0,0,0,0,0,0,0
"Literary Classics of the United States, Inc.",3991,1,0,0,1,1,0,0
The University of Chicago,4018,0,0,0,0,0,0,0
Sunglass Hut,4071,44,3,2,49,0.897959184,0.06122449,0.040816327
U.S. Department of Health & Human Services,4037,14,0,1,15,0.933333333,0,0.066666667
"Juniper Networks, Inc.",2419,3,0,0,3,1,0,0
George Brown College,4002,0,0,0,0,0,0,0
Departments of the Treasury & Housing and Urban Development,3981,1,0,0,1,1,0,0
"ZVOX Audio, LLC",3994,0,0,0,0,0,0,0
Brooks Institute,4019,0,0,0,0,0,0,0
The Nancy Lee and Perry R. Bass Performance Hall,3977,0,0,0,0,0,0,0
Sky Angel,4040,0,0,0,0,0,0,0
"Sub-Zero, Inc.",2407,2,0,0,2,1,0,0
Eat24Hours.com,3993,0,0,0,0,0,0,0
"SunRun, Inc.",4099,0,0,1,1,0,0,1
Krohn and Moss,4048,0,0,0,0,0,0,0
Digital Storm,4101,1,0,0,1,1,0,0
"TD Ameritrade, Inc.",3988,26,7,27,60,0.433333333,0.116666667,0.45
Vote4Energy,4009,0,0,0,0,0,0,0
Accellion,4083,0,0,0,0,0,0,0
Foxwoods Resort Casino,4007,0,0,0,0,0,0,0
Assistly Inc.,4070,0,0,0,0,0,0,0
"LendingTree, LLC.",2416,9,2,9,20,0.45,0.1,0.45
The Hotel Hanford,4008,0,0,0,0,0,0,0
Provo Craft & Novelty,2413,0,0,0,0,0,0,0
Health Alliance Plan of Michigan,4055,0,0,1,1,0,0,1
"Buffalo Wild Wings, Inc.",2412,2,1,3,6,0.333333333,0.166666667,0.5
Vitrue,3990,0,0,0,0,0,0,0
ShoreTel Inc.,4041,0,0,0,0,0,0,0
KB Home,2398,4,0,6,10,0.4,0,0.6
Syncplicity Inc.,4026,0,0,0,0,0,0,0
California Milk Processor Board,4106,0,0,0,0,0,0,0
"NTVB Media, Inc.",4044,3,0,1,4,0.75,0,0.25
Wyndham Worldwide Corporation,4020,2,1,1,4,0.5,0.25,0.25
Indianapolis Super Bowl Host Committee,4043,0,0,0,0,0,0,0
"Allergan, Inc.",4060,37,1,11,49,0.755102041,0.020408163,0.224489796
SheKnows LLC,2411,7,0,5,12,0.583333333,0,0.416666667
Outdoor Channel,2405,2,0,0,2,1,0,0
"Gunilla Of Sweden, inc.",4057,0,0,0,0,0,0,0
KettleWorx,4088,0,0,0,0,0,0,0
TravelCLICK.,4075,0,0,0,0,0,0,0
Burst Media Corporation,4073,1,0,1,2,0.5,0,0.5
Lincoln Hall,4061,0,0,0,0,0,0,0
Cole Haan,2409,0,0,2,2,0,0,1
"Greenlight Financial Services, Inc.",4092,0,0,0,0,0,0,0
"Seamless North America, LLC.",2401,111,5,1,117,0.948717949,0.042735043,0.008547009
Bermuda Department of Tourism,4074,9,1,3,13,0.692307692,0.076923077,0.230769231
"Manilla, LLC",4094,0,0,0,0,0,0,0
Mindvalley,4076,4,1,0,5,0.8,0.2,0
"Business Insider, Inc.",2404,0,0,1,1,0,0,1
The Globe and Mail Inc.,2406,0,0,1,1,0,0,1
Johnson Controls,2421,0,0,0,0,0,0,0
Think Ice Movie,3953,0,0,0,0,0,0,0
Road Kill T Shirts,3978,14,0,0,14,1,0,0
Uline,4021,0,0,0,0,0,0,0
BoostUp,4046,5,0,0,5,1,0,0
iHigh.com Inc.,4053,0,0,0,0,0,0,0
Bernie & Phyl's Furniture,4082,0,0,0,0,0,0,0
Planet49,2399,2,0,0,2,1,0,0
Benjamin Moore & Co.,3972,6,1,5,12,0.5,0.083333333,0.416666667
Allstate Corporation,3995,190,12,23,225,0.844444444,0.053333333,0.102222222
"TracFone Wireless, Inc.",4072,181,13,31,225,0.804444444,0.057777778,0.137777778
Golden Gate University,4095,1,0,0,1,1,0,0
"NYP Holdings, Inc.",4097,1,0,0,1,1,0,0
"Cramster, Inc.",4104,0,0,0,0,0,0,0
Daytona International Speedway,3859,0,0,0,0,0,0,0
"The Pep Boys — Manny, Moe & Jack",3959,16,2,0,18,0.888888889,0.111111111,0
"California Closet Company, Inc.",4027,0,0,0,0,0,0,0
Aperion Audio,3849,1,0,0,1,1,0,0
Bahama Out Islands Promotion Board,3850,0,0,0,0,0,0,0
Daptiv Inc.,3985,0,0,0,0,0,0,0
InnoGames GmbH,3999,20,0,7,27,0.740740741,0,0.259259259
The Vermont Country Store,4017,0,0,0,0,0,0,0
CA Dept. of Food and Ag,4049,0,0,0,0,0,0,0
GovMint.com,4100,1,0,0,1,1,0,0
BaronsMedia,2648,0,0,0,0,0,0,0
"NYC & Company, Inc.",3297,0,0,0,0,0,0,0
"RichRelevance, Inc.",3316,0,0,0,0,0,0,0
MTV,2665,1,0,1,2,0.5,0,0.5
Boston University,3047,0,0,0,0,0,0,0
ShoeBuy.com,1693,0,0,0,0,0,0,0
LivingResearchInstitute.com,3765,1,0,0,1,1,0,0
Malouf Auto Group,3766,0,0,0,0,0,0,0
Novo Nordisk Inc.,2380,4,0,7,11,0.363636364,0,0.636363636
Blue Man Productions,3615,1,0,0,1,1,0,0
DrNatura.com,3901,0,0,0,0,0,0,0
FootSmart.com,3902,0,0,0,0,0,0,0
"ResCare, Inc.",3783,0,0,0,0,0,0,0
Trane,3833,0,0,0,0,0,0,0
aldaniti international network limited,3951,0,0,0,0,0,0,0
Star Companies,4016,1,0,0,1,1,0,0
Mutuko.net,4052,0,0,0,0,0,0,0
ConsumerDaily.org,4084,0,0,0,0,0,0,0
WinStar World Casino,4102,0,0,0,0,0,0,0
DinoDirect Corporation,2397,0,0,0,0,0,0,0
All Hands Volunteers,1746,0,0,0,0,0,0,0
TicketCity,2813,0,0,0,0,0,0,0
Indiana University Health,2814,0,1,0,1,0,1,0
DialMyCalls.com,1660,0,0,0,0,0,0,0
Guitar Center,1278,0,0,0,0,0,0,0
STLtoday.com,2846,0,0,0,0,0,0,0
Rent the Runway,3399,11,3,0,14,0.785714286,0.214285714,0
Phiaton Inc.,3400,0,0,0,0,0,0,0
Dice INC.,1760,4,0,1,5,0.8,0,0.2
Mitsubishi Motors,1878,18,12,3,33,0.545454545,0.363636364,0.090909091
The Girl with the Dragon Tattoo Movie,2996,0,0,0,0,0,0,0
Kaboodle,3014,0,0,0,0,0,0,0
GigaOM,3032,0,0,0,0,0,0,0
Singapore Airlines,2645,0,0,0,0,0,0,0
Tahiti Tourism,2663,2,0,1,3,0.666666667,0,0.333333333
Nationwide Mutual Insurance Company,2664,2,0,0,2,1,0,0
"Intermarkets, Inc.",3300,0,0,0,0,0,0,0
CBS (cbs.com),3599,4,0,1,5,0.8,0,0.2
Avaya Inc.,3600,0,0,0,0,0,0,0
The Christian Broadcasting Network,3063,0,0,1,1,0,0,1
Optimal Hearing Systems,3064,0,0,0,0,0,0,0
Nutritionist Pro,3735,0,0,0,0,0,0,0
J. Jill Group,3164,0,0,1,1,0,0,1
Santander Consumer USA Inc.,3767,2,0,0,2,1,0,0
Women's Entertainment,3882,0,0,0,0,0,0,0
Zeo Inc.,3618,0,0,0,0,0,0,0
Downlopedia,3899,0,0,0,0,0,0,0
Huntington Bancshares Incorporated,3632,0,0,0,0,0,0,0
Advance Auto Parts,1060,3,1,1,5,0.6,0.2,0.2
Electrolux,1410,2,0,2,4,0.5,0,0.5
Ralphs,1442,0,0,1,1,0,0,1
United Technologies Corporation,4032,0,1,0,1,0,1,0
Polk Audio,3836,0,0,0,0,0,0,0
"Computerworld, Inc.",4063,0,0,0,0,0,0,0
Daiichi Sankyo Inc.,4065,0,0,0,0,0,0,0
"MyLife.com, Inc",2402,0,0,0,0,0,0,0
Invesco PowerShares Capital Management LLC,3839,0,0,1,1,0,0,1
GRM LLC,3989,0,0,0,0,0,0,0
BizFilings,3996,0,0,0,0,0,0,0
"ProBoards, Inc.",4028,0,0,0,0,0,0,0
Bi-Mart Corporation,4064,0,0,0,0,0,0,0
Houzz Inc.,4089,0,0,1,1,0,0,1
Tribeca Enterprises LLC,4103,0,0,0,0,0,0,0
Vantage West Credit Union,4107,0,0,0,0,0,0,0
"Cannery Casino Resorts, LLC.",2417,0,0,0,0,0,0,0
Tableau Software,3842,0,0,0,0,0,0,0
"GCREST America, Inc.",3976,0,0,0,0,0,0,0
Ongo Inc.,4010,0,0,0,0,0,0,0
Bentley University,4025,0,0,0,0,0,0,0
Chanel S.A.,4093,9,0,11,20,0.45,0,0.55
BTGuard,82,0,0,1,1,0,0,1
Travelocity,97,4,0,2,6,0.666666667,0,0.333333333
"ServiceMagic, Inc.",2744,0,0,0,0,0,0,0
TaxSlayer,2739,0,0,0,0,0,0,0
Denihan Hospitality Group,2746,5,0,0,5,1,0,0
FreeScore.com,99,0,0,0,0,0,0,0
Jurlique,2748,0,0,0,0,0,0,0
Sutter Health,2751,0,0,0,0,0,0,0
"GoDaddy.com, LLC",2752,20,1,0,21,0.952380952,0.047619048,0
Freedom ENC Communications Interactive,2754,0,0,0,0,0,0,0
AutoZone,148,27,9,1,37,0.72972973,0.243243243,0.027027027
Yahoo! Inc.,3909,8,0,4,12,0.666666667,0,0.333333333
The Law Offices of Larry H. Parker,3912,0,0,0,0,0,0,0
"APMEX, Inc.",2762,0,0,0,0,0,0,0
Maryland Office of Tourism,3915,0,0,0,0,0,0,0
MeetLocals.com,3409,0,0,1,1,0,0,1
Los Angeles Philharmonic Association,4114,1,0,0,1,1,0,0
"Stack Exchange, Inc.",3919,1,0,1,2,0.5,0,0.5
Yellowbook Inc.,3913,0,0,0,0,0,0,0
JPMorgan Chase & Co.,4116,107,8,51,166,0.644578313,0.048192771,0.307228916
Guthy-Renker,2767,4,0,0,4,1,0,0
Christopher & Banks,4120,0,0,0,0,0,0,0
Next Network,163,0,0,0,0,0,0,0
New Jersey On-Line LLC.,4119,0,0,1,1,0,0,1
"Delivery Agent, Inc.",2755,0,0,1,1,0,0,1
"Nutrisystem, Inc.",2756,0,0,0,0,0,0,0
Stephens Media,2906,0,0,0,0,0,0,0
CyberLink Corp.,4117,0,0,0,0,0,0,0
"Mercury Digital Labs, LLC.",2769,0,0,1,1,0,0,1
Gawker Media,4036,1,0,1,2,0.5,0,0.5
"Ideal Image Development, Inc.",4122,1,0,0,1,1,0,0
TradeSmart University,2766,0,0,0,0,0,0,0
Skinit.com,3642,0,0,0,0,0,0,0
Spot LLC.,4124,0,0,2,2,0,0,1
"L18 Holdings, Inc.",2768,0,0,0,0,0,0,0
Unitek Information Systems,4126,0,0,0,0,0,0,0
Rhino Entertainment,4123,0,0,0,0,0,0,0
Mediaplanet International,4137,0,0,0,0,0,0,0
Young Adult Movie,4133,0,0,0,0,0,0,0
"IGotIt.com, Inc.",4135,0,0,0,0,0,0,0
The Rising Leo inc,4130,0,0,1,1,0,0,1
People Media,2741,11,7,1,19,0.578947368,0.368421053,0.052631579
World Wildlife Fund,2745,0,0,1,1,0,0,1
Johnny English Movie,3911,0,0,0,0,0,0,0
Oak Creek Distribution LLC,4140,0,0,0,0,0,0,0
"eteamz.com, Inc",4115,0,0,1,1,0,0,1
Glee,314,0,0,0,0,0,0,0
Comwave,3862,0,0,0,0,0,0,0
Ancestry.com,333,199,90,4,293,0.679180887,0.307167235,0.013651877
PPG Industries,3863,0,0,0,0,0,0,0
Jesses Project,3864,0,0,0,0,0,0,0
MSC Cruises (USA),3865,0,0,0,0,0,0,0
ePrize,3870,6,5,1,12,0.5,0.416666667,0.083333333
Choctaw Casino Resorts,3871,2,0,0,2,1,0,0
"Aquasana, Inc.",3867,2,0,0,2,1,0,0
New York Media Holdings LLC,3874,1,0,0,1,1,0,0
"Causes (Philotic, Inc.)",601,0,0,1,1,0,0,1
Colorado Lottery,3875,0,0,0,0,0,0,0
The Dessy Group,3658,5,0,3,8,0.625,0,0.375
West Penn Allegheny Health System,3866,0,0,0,0,0,0,0
Gorilla Gaming,482,0,0,0,0,0,0,0
vancouver international film festival,2022,0,0,0,0,0,0,0
Tremor Video,2026,0,0,0,0,0,0,0
zetia,2031,0,0,0,0,0,0,0
ysc tour de pink,2049,0,0,0,0,0,0,0
UN Aids,2037,0,0,0,0,0,0,0
World Bank,2044,0,0,0,0,0,0,0
FaceMoods,350,0,0,0,0,0,0,0
eztarget,2040,0,0,0,0,0,0,0
lifestore,2052,0,0,0,0,0,0,0
best food secrets,2054,0,0,0,0,0,0,0
RAM,2060,94,14,32,140,0.671428571,0.1,0.228571429
MobileMoneyMachines,2069,0,0,0,0,0,0,0
BeKnown,2066,0,0,0,0,0,0,0
wetpaint,2068,0,0,0,0,0,0,0
"Friendster, Inc.",3644,0,0,0,0,0,0,0
Viking River Cruises,2084,0,0,0,0,0,0,0
American Family Voices,516,0,0,0,0,0,0,0
massmutual financial group,2089,0,0,2,2,0,0,1
united we serve,2094,0,0,0,0,0,0,0
Bonhams,4298,0,0,0,0,0,0,0
5.11 Inc,4308,0,0,0,0,0,0,0
Hawaiian Airlines,4312,1,1,3,5,0.2,0.2,0.6
TakeLessons,4304,0,0,0,0,0,0,0
One Kings Lane,384,3,0,0,3,1,0,0
Archives.com,4309,1,0,0,1,1,0,0
LeatherUp.com,4311,1,0,0,1,1,0,0
"Turner Sports Interactive, Inc",4143,0,0,0,0,0,0,0
Independent Women's Voice,4377,0,0,0,0,0,0,0
U.S. Farmers & Ranchers Alliance,4378,0,0,0,0,0,0,0
ScratchTHIS,4328,0,0,0,0,0,0,0
Garnet Hill,4152,0,0,0,0,0,0,0
Northern Tool + Equipment Catalog Co.,4148,0,0,0,0,0,0,0
Austin360.com,4320,1,0,0,1,1,0,0
Hugo Boss,4327,0,0,0,0,0,0,0
Orion Telescopes & Binoculars,4337,0,0,0,0,0,0,0
C Spire,4341,1,0,1,2,0.5,0,0.5
Tire Rack,2082,0,0,3,3,0,0,1
Kentico Software,4172,0,0,0,0,0,0,0
Rogers Communications,4343,25,8,0,33,0.757575758,0.242424242,0
Webtrends Inc.,4387,0,0,0,0,0,0,0
Fort McDowell Casino,4334,1,0,1,2,0.5,0,0.5
Chicago Convention & Tourism Bureau,4162,2,0,0,2,1,0,0
"Museum of Science and Industry, Florida",4388,0,0,0,0,0,0,0
Kitchen and Cabinets,4380,1,0,0,1,1,0,0
OC Music Awards,4153,0,0,0,0,0,0,0
Six pack Shortcuts,4358,0,0,0,0,0,0,0
PopularLifestyleJournal.com,4393,0,0,0,0,0,0,0
Fender Musical Instruments Corporation,4158,0,0,0,0,0,0,0
Newton-Wellesley Hospital,4391,0,0,0,0,0,0,0
Teachers Insurance and Annuity Association,4363,0,0,0,0,0,0,0
UBM Techweb,4335,0,0,0,0,0,0,0
Seabourn Cruise Line,4354,0,0,2,2,0,0,1
McMenamins,4324,0,0,0,0,0,0,0
"United Air Lines, Inc.",4330,9,15,8,32,0.28125,0.46875,0.25
Natural Health Network,2092,0,0,0,0,0,0,0
"St. Vincent Charity Medical Center, Ohio",4395,0,0,0,0,0,0,0
Playa Games GmbH,4174,0,0,0,0,0,0,0
Haywire Movie,4352,0,0,0,0,0,0,0
CME Group,4355,3,0,2,5,0.6,0,0.4
Mortgage Loan Directory and Information Inc.,4392,0,0,0,0,0,0,0
Central Intelligence Agency,4175,1,0,0,1,1,0,0
Eloqua,4374,0,0,0,0,0,0,0
"World Wrestling Entertainment, Inc.",4336,0,0,0,0,0,0,0
The University of North Carolina,4401,1,0,0,1,1,0,0
Seattle Repertory Theatre,4179,0,0,0,0,0,0,0
MF Global Holdings,4488,0,0,0,0,0,0,0
Privacy Protection Plus.,4155,0,0,0,0,0,0,0
Ethen Allen Global,4321,0,0,0,0,0,0,0
Philippine Airlines,4408,0,0,0,0,0,0,0
TRUE,4166,0,0,0,0,0,0,0
JJsHouse.com,4373,7,0,0,7,1,0,0
Ally Financial,4394,55,2,17,74,0.743243243,0.027027027,0.22972973
eFoodsDirect,4375,0,1,0,1,0,1,0
Vegas.com,4472,0,0,0,0,0,0,0
"Biofilm, Inc.",4386,1,0,0,1,1,0,0
The Seattle Times Company,4369,0,0,1,1,0,0,1
Rosewood Hotels & Resorts,4456,0,0,1,1,0,0,1
Israel Bonds,4348,0,0,3,3,0,0,1
Virginia Department of Transportation,4357,1,0,0,1,1,0,0
"Farnam Companies, Inc.",4529,0,0,0,0,0,0,0
"Rdio, Inc.",4402,0,0,2,2,0,0,1
Turismo de Lisboa,4455,0,0,0,0,0,0,0
"W3i, LLC.",4177,0,0,0,0,0,0,0
The Leading Hotels of the World,4528,0,0,0,0,0,0,0
Sperry Top-Sider,4474,0,0,2,2,0,0,1
Job.com,4368,0,0,0,0,0,0,0
Fiskars,4483,0,0,0,0,0,0,0
"Closets By Design, Inc.",4398,0,0,0,0,0,0,0
Walters Golf,4189,0,0,0,0,0,0,0
Associa,4495,0,0,0,0,0,0,0
Montreal Canadiens,4370,0,0,0,0,0,0,0
YourFreeMovieTickets,4473,0,0,0,0,0,0,0
Stone Mountain Park,4409,2,0,0,2,1,0,0
U.S. Department of Homeland Security,4477,3,0,0,3,1,0,0
"Bob Evans Farms, Inc.",4185,3,3,2,8,0.375,0.375,0.25
"Harriet Carter Gifts, Inc.",4362,0,0,0,0,0,0,0
Autonet.ca,4464,0,0,1,1,0,0,1
"GUESS, Inc.",4184,1,0,5,6,0.166666667,0,0.833333333
Pfizer Inc.,4480,91,6,31,128,0.7109375,0.046875,0.2421875
"Digital Chocolate, Inc.",4462,0,0,0,0,0,0,0
Iowa Beef Industry Council,4509,0,0,0,0,0,0,0
Tough Mudder,4485,0,0,0,0,0,0,0
CC Services Inc.,4187,1,0,0,1,1,0,0
LodgeNet Interactive Corp.,4532,0,0,0,0,0,0,0
The Home Security Store,4487,0,0,0,0,0,0,0
Good Deeds Movie,4498,0,0,0,0,0,0,0
Ideal-case.com,4475,0,0,0,0,0,0,0
Right at Home,4486,0,0,0,0,0,0,0
"City of Glendale, Arizona",4491,1,0,0,1,1,0,0
42nd Street Photo,4539,0,0,0,0,0,0,0
Phoenix Zoo,4502,0,0,0,0,0,0,0
Dolphin Tale Movie,4543,0,0,0,0,0,0,0
Maine Office of Tourism,4494,0,0,0,0,0,0,0
Tiffany & Co.,648,0,0,5,5,0,0,1
Catalina Marketing,2859,0,0,0,0,0,0,0
VISIT FLORIDA,2863,24,1,1,26,0.923076923,0.038461538,0.038461538
Jawbone,2861,20,13,1,34,0.588235294,0.382352941,0.029411765
Survival-Guide.com Ultimate Results,2862,0,0,0,0,0,0,0
Lake Erie Monsters,1135,0,0,0,0,0,0,0
Ingrid & Isabel,4608,0,0,0,0,0,0,0
Duke Realty Corporation,4611,0,0,1,1,0,0,1
Joyful Noise Movie,4612,0,0,0,0,0,0,0
El Dorado Furniture,4615,0,0,1,1,0,0,1
Marketplace from AMERICAN PUBLIC MEDIA,4619,0,0,0,0,0,0,0
WN Network,4622,0,0,0,0,0,0,0
KOG-LU USA,2858,1,0,1,2,0.5,0,0.5
Tuna Council,548,0,0,0,0,0,0,0
Localphone,4605,0,0,0,0,0,0,0
SUNY Upstate Medical University,4623,0,0,1,1,0,0,1
The American National Red Cross,4513,32,0,21,53,0.603773585,0,0.396226415
Stauffers of Kissel Hill,4515,0,0,0,0,0,0,0
Boy Scouts of America,4522,0,0,0,0,0,0,0
FreedomWorks,4520,0,0,0,0,0,0,0
Harry Potter and the Deathly Hallows Movie,4524,0,0,0,0,0,0,0
Illinois Department of Commerce and Economic Opportunity,4517,0,0,0,0,0,0,0
Visa,433,3,0,5,8,0.375,0,0.625
"SugarSync, Inc.",4525,0,0,0,0,0,0,0
North Texas Tollway Authority,4526,0,0,0,0,0,0,0
"Jen Bekman Projects, Inc.",4412,0,0,0,0,0,0,0
Driver's Way,4680,0,0,0,0,0,0,0
Dynamic Funds,4687,0,0,0,0,0,0,0
PFGBEST,4419,0,0,0,0,0,0,0
SunGard,718,0,0,0,0,0,0,0
Changing Hands Bookstore,4688,0,0,0,0,0,0,0
Memorial Sloan-Kettering Cancer Center,4416,0,0,2,2,0,0,1
American Society of Clinical Oncology (ASCO),4691,3,1,0,4,0.75,0.25,0
SimpleHeartTest.com,4418,1,0,0,1,1,0,0
Baer's Furniture,4694,0,0,1,1,0,0,1
GirlsWebGames.com,4423,1,0,0,1,1,0,0
"Commission Junction, Inc.",4696,0,0,1,1,0,0,1
British Midland Airways,4695,0,0,0,0,0,0,0
War Horse on Broadway,4428,0,0,0,0,0,0,0
Alert One Services,3458,0,0,0,0,0,0,0
"CharityUSA.com, LLC.",4704,2,1,0,3,0.666666667,0.333333333,0
Casa Manana,4430,0,0,0,0,0,0,0
ideeli,950,0,0,0,0,0,0,0
C.R. England Trucking,4435,1,0,1,2,0.5,0,0.5
Precor Incorporated,4521,0,0,0,0,0,0,0
Kidville Inc.,4705,0,0,0,0,0,0,0
SOURCE INTERLINK MEDIA,4682,0,0,1,1,0,0,1
KIKKOMAN SALES USA,4438,1,0,3,4,0.25,0,0.75
Online Gaming Network,3462,0,0,0,0,0,0,0
Revolution Golf,4700,0,0,0,0,0,0,0
Regence Blue Cross Blue Shield,4413,1,0,0,1,1,0,0
NSM Research,4701,0,0,0,0,0,0,0
CMDistro.com,4441,0,0,0,0,0,0,0
"Sunlighten, Inc.",4668,0,0,0,0,0,0,0
Anastasia International Inc.,4449,1,0,0,1,1,0,0
netTALK.COM,4641,0,0,0,0,0,0,0
Kellyco Metal Detector,4634,1,0,0,1,1,0,0
Aston Martin,4444,0,0,0,0,0,0,0
"BidClerk, Inc.",3475,0,0,0,0,0,0,0
Happy Feet Two Movie,3473,0,0,0,0,0,0,0
Greater Phoenix Convention & Visitors Bureau,4439,0,0,1,1,0,0,1
"inKline Global, Inc.",3472,0,0,0,0,0,0,0
Direct Entertainment Media Group,4681,0,0,0,0,0,0,0
United States Potato Board,4702,0,0,1,1,0,0,1
U.S. Citizenship and Immigration Services,3480,0,0,0,0,0,0,0
The Metropolitan Opera,4871,0,0,0,0,0,0,0
Here-4-You Consulting,4658,0,0,0,0,0,0,0
Udi's Gluten Free Foods,4648,0,0,0,0,0,0,0
"Morningstar, Inc.",4669,0,0,1,1,0,0,1
TV One,4910,0,0,0,0,0,0,0
TurtleShack.com,4846,0,0,0,0,0,0,0
Zinio LLC,4795,1,1,0,2,0.5,0.5,0
"The Interdisciplinary Center, Herzliya",4443,0,0,1,1,0,0,1
Stephen M. Ross School of Business at the University of Michigan,4446,0,0,0,0,0,0,0
Rose Quarter,4663,0,0,0,0,0,0,0
Minnesota Opera,4683,0,0,0,0,0,0,0
ACWholesalers.com,4437,0,0,0,0,0,0,0
"Serta, Inc.",3837,0,1,0,1,0,1,0
Acronis Inc,5003,0,0,0,0,0,0,0
Gametrailers.com,2738,1,0,0,1,1,0,0
MD & DC Credit Union Association,4766,0,0,0,0,0,0,0
"Kumon North America, Inc.",4670,1,0,2,3,0.333333333,0,0.666666667
DiscountASP.NET,4876,0,0,0,0,0,0,0
BodyGuardz,4760,0,0,0,0,0,0,0
Dendreon Corporation,4445,0,0,0,0,0,0,0
CU Difference Campaign,4842,0,0,0,0,0,0,0
"G4 Media, LLC.",2759,0,0,0,0,0,0,0
Westminster Teak,4692,2,0,0,2,1,0,0
Saint Joseph Health System,4652,1,0,0,1,1,0,0
Santa Barbara Conference & Visitors Bureau,2740,0,0,0,0,0,0,0
"Fred Meyers, Inc.",3914,0,0,0,0,0,0,0
Owlient,4856,0,0,0,0,0,0,0
Whistler Blackcomb,4791,0,0,0,0,0,0,0
Bachmann for Congress,4838,0,0,0,0,0,0,0
Cvent Inc.,4762,4,1,0,5,0.8,0.2,0
Big O Tires,4628,0,0,0,0,0,0,0
Firstpost,4632,0,0,0,0,0,0,0
"Smart Furniture, Inc.",2749,2,0,0,2,1,0,0
Lee County Visitor & Convention Bureau,4872,0,0,0,0,0,0,0
"lynda.com, Inc.",5004,1,0,0,1,1,0,0
"J2 Global Communications, Inc.",3477,21,3,2,26,0.807692308,0.115384615,0.076923077
LOT Polish Airlines,4837,0,0,0,0,0,0,0
Morris Motor Company,4673,0,0,0,0,0,0,0
Midasplayer.com,4858,0,0,0,0,0,0,0
Blue Jeans Network Inc.,4866,0,0,0,0,0,0,0
SSR Holdings LLC,2761,1,0,0,1,1,0,0
"Federated Investors, Inc.",4677,0,0,1,1,0,0,1
University of South Dakota,4810,1,0,0,1,1,0,0
John Edward,4662,0,0,0,0,0,0,0
Faces in the Crowd Movie,4650,0,0,0,0,0,0,0
"Media General Communications Holdings, LLC.",4799,0,0,1,1,0,0,1
Doctors Without Borders/Médecins Sans Frontières (MSF),2747,1,1,2,4,0.25,0.25,0.5
"Beatport, LLC",4852,0,0,0,0,0,0,0
HostGator.com,3822,24,2,1,27,0.888888889,0.074074074,0.037037037
Safeco Insurance Company of America,2757,7,0,0,7,1,0,0
WaveJet,4873,0,0,0,0,0,0,0
OUC Inc.,4905,0,0,0,0,0,0,0
Hubdub Ltd.,4845,2,0,0,2,1,0,0
Yes Bridal,4995,0,0,0,0,0,0,0
Boston Market Corporation,4997,0,0,0,0,0,0,0
Troy University,4121,0,0,0,0,0,0,0
Digital Advertising Alliance,4757,0,0,0,0,0,0,0
HIGH Museum of Art,4068,0,0,0,0,0,0,0
New York Lottery,3479,0,0,2,2,0,0,1
Rick Santorum for President,3408,0,0,0,0,0,0,0
Sleep Train Mattress Center,3916,1,0,0,1,1,0,0
Marco Polo Hotels,4792,0,0,0,0,0,0,0
LeadFreeKids.org,3918,1,0,0,1,1,0,0
Transamerica Corporation,2024,0,0,0,0,0,0,0
Aer Lingus,2763,2,0,0,2,1,0,0
The Jerusalem Post,5010,0,0,0,0,0,0,0
"Ministry of Tourism, Government of Israel",3910,0,0,0,0,0,0,0
Broadway Center for the Performing Arts,4679,0,0,0,0,0,0,0
Post News Ads,4874,1,0,0,1,1,0,0
Montana Office of Tourism,4784,0,0,0,0,0,0,0
Salvatore Ferragamo S.P.A,4830,0,0,1,1,0,0,1
Ybor City Development Corporation,4817,0,0,0,0,0,0,0
Brookfield Homes,4823,0,0,0,0,0,0,0
Berkeley Repertory Theatre,4777,0,0,0,0,0,0,0
California Academy of Sciences,4675,3,0,0,3,1,0,0
PrimeTravels.com,4843,0,0,0,0,0,0,0
American Conservatory Theater,4808,0,0,0,0,0,0,0
"Belle Tire, Inc.",4649,0,0,0,0,0,0,0
iFreedom Direct,4127,0,0,1,1,0,0,1
The Condominiums at Walker Square,4822,0,0,0,0,0,0,0
VentureBeat,5009,1,0,0,1,1,0,0
Les Schwab Tires,4779,1,0,1,2,0.5,0,0.5
Solo Cup Operating Corporation,4125,0,0,0,0,0,0,0
Minnesota Children's Museum,4860,0,0,0,0,0,0,0
"SonoSite, Inc.",5001,0,0,0,0,0,0,0
Florida Department of Agriculture,4756,0,0,0,0,0,0,0
Infoblox Inc.,4819,2,0,0,2,1,0,0
"HowStuffWorks, Inc.",4834,0,0,0,0,0,0,0
Next Day Blinds,4862,0,0,0,0,0,0,0
ReviverSoft,4769,0,0,0,0,0,0,0
"SparkPeople, Inc.",3917,0,0,2,2,0,0,1
United States Gold Bureau,4907,1,0,0,1,1,0,0
"Vistage International, Inc.",4296,3,0,0,3,1,0,0
State of Oklahoma,4987,0,0,0,0,0,0,0
Institute of Business & Medical Careers (IBMC),4841,0,0,0,0,0,0,0
"MagicCute Software Co., Ltd",4811,0,0,0,0,0,0,0
Newsmax Media Inc.,4775,17,0,1,18,0.944444444,0,0.055555556
Fnac,4847,0,0,0,0,0,0,0
"Yankee Publishing, Inc.",4988,0,0,0,0,0,0,0
Bergeron Auto,4826,0,0,0,0,0,0,0
National Arts Film Production Limited,4770,0,0,0,0,0,0,0
Alarm.com,5005,2,0,0,2,1,0,0
Get Satisfaction Inc.,4909,0,0,0,0,0,0,0
Mahindra Holidays and Resorts India Ltd,4782,0,0,0,0,0,0,0
The Warmington Group,5006,0,0,0,0,0,0,0
Cuisinart,4979,1,1,12,14,0.071428571,0.071428571,0.857142857
eeye,4788,0,0,0,0,0,0,0
"Dickey's Barbecue Restaurants, Inc.",4848,0,0,0,0,0,0,0
New York Botanical Garden,4857,0,0,0,0,0,0,0
Cincinnati Playhouse in the Park,4994,0,0,0,0,0,0,0
DraftStreet.com,4820,0,0,0,0,0,0,0
"Local TV, LLC",4855,0,0,0,0,0,0,0
"Good Works Group, LLC.",4984,0,0,0,0,0,0,0
Fernbank Museum of Natural History,4996,1,0,0,1,1,0,0
Cyclechex,4864,0,0,0,0,0,0,0
Mandarin Oriental Hotel Group,4998,0,0,0,0,0,0,0
Netshoppers.com,4875,0,0,0,0,0,0,0
Sun Peaks Resorts,5007,0,0,0,0,0,0,0
Edgerton Center for the Performing Arts,4382,0,0,0,0,0,0,0
le château inc.,4157,0,0,0,0,0,0,0
President and Trustees of Norwich University,4164,1,0,0,1,1,0,0
Trump Hotel Collection,4364,5,0,0,5,1,0,0
Pompeian,4407,0,0,0,0,0,0,0
Abe's of Maine,4182,0,0,0,0,0,0,0
Europa Corp.,2023,0,0,0,0,0,0,0
Oral Health Watch,4489,0,0,0,0,0,0,0
South Walton,2860,7,0,1,8,0.875,0,0.125
Rush-Copley Medical Center,4329,0,0,0,0,0,0,0
Kissimmee,4607,0,0,0,0,0,0,0
Beazer Homes,4614,1,0,0,1,1,0,0
Oregon State University,4625,0,0,0,0,0,0,0
Omada Nutrition,4138,0,0,0,0,0,0,0
asian beauties,2062,4,0,0,4,1,0,0
ANZ,2080,0,0,1,1,0,0,1
"Elvis Presley Enterprises, Inc.",4301,0,0,0,0,0,0,0
Garmin Ltd,4319,40,5,1,46,0.869565217,0.108695652,0.02173913
enVie Interactive,4333,0,0,0,0,0,0,0
"The Savvy Source for Parents, LLC",4169,0,0,0,0,0,0,0
Hult International Business School,4452,0,0,0,0,0,0,0
New Jersey City University,4534,0,0,0,0,0,0,0
Curry College,4484,2,0,0,2,1,0,0
Bealls,2865,0,0,0,0,0,0,0
Gamerbug,4602,0,0,0,0,0,0,0
Great Wolf Resorts,4684,13,13,2,28,0.464285714,0.464285714,0.071428571
The Lorax Movie,4420,0,0,0,0,0,0,0
NetSpend Corporation,4433,0,0,0,0,0,0,0
The Wine House,4434,0,0,0,0,0,0,0
McKesson Specialty Health,3465,0,0,1,1,0,0,1
eUnity Corp,3466,16,0,0,16,1,0,0
Moe's Restaurant,3483,0,0,0,0,0,0,0
Options Industry Council,3484,0,0,5,5,0,0,1
"Eon Clinics / Your Implant Solutions, Inc",4651,0,0,0,0,0,0,0
"Cold Brew Labs, Inc.",4751,1,0,0,1,1,0,0
"Serena & Lily, Inc.",4851,0,0,0,0,0,0,0
Scan Design,4801,0,0,0,0,0,0,0
John Hardy,5002,0,0,0,0,0,0,0
Petitti Garden Center,3659,1,0,0,1,1,0,0
Sulake Corporation Oy,4191,0,0,0,0,0,0,0
United Nations Office on Drugs and Crime,2038,0,0,0,0,0,0,0
"The Global Fund to Fight AIDS, Tuberculosis and Malaria",4128,0,0,0,0,0,0,0
Pebble Beach Company,4307,0,0,1,1,0,0,1
Health Net,4314,0,0,0,0,0,0,0
JOE'S Jeans,4332,1,0,0,1,1,0,0
Hotels Combined,4339,0,0,0,0,0,0,0
Blitware Technology Inc.,4346,0,0,0,0,0,0,0
Elanco,4389,0,0,0,0,0,0,0
Murad Inc,4171,3,0,0,3,1,0,0
Georg Jensen,4471,0,0,0,0,0,0,0
National Pro-Life Alliance,4482,0,0,1,1,0,0,1
University of Arizona,4621,0,0,0,0,0,0,0
Jerry's Auto Group,4414,0,0,0,0,0,0,0
Citgo,4421,0,1,3,4,0,0.25,0.75
California Community Colleges,4432,0,0,0,0,0,0,0
Leisure Lifestyle,4707,1,0,0,1,1,0,0
92nd Street Young Men's and Young Women's Hebrew Association,4657,0,0,0,0,0,0,0
Institute for Integrative Nutrition,3485,0,0,0,0,0,0,0
social-press.us,4764,0,0,0,0,0,0,0
"Survival Products, LLC",4850,0,0,0,0,0,0,0
American Express Company,3781,290,80,72,442,0.656108597,0.180995475,0.162895928
Uniblue Systems Limited,2384,1,0,1,2,0.5,0,0.5
My Estate Manager,3786,0,0,0,0,0,0,0
Send The Trend,1448,0,0,0,0,0,0,0
NHN Corp,3856,0,0,0,0,0,0,0
"SquareSpace, Inc.",3954,0,0,0,0,0,0,0
The Leukemia & Lymphoma Society,3956,3,0,0,3,1,0,0
Toronto-Dominion Bank,4013,1,1,1,3,0.333333333,0.333333333,0.333333333
Georgia Natural Gas,4015,0,0,0,0,0,0,0
SteelSeries,4022,0,0,0,0,0,0,0
"Puritan's Pride, Inc.",4047,10,0,0,10,1,0,0
Richmond American Homes,4054,0,0,0,0,0,0,0
Xylem Inc.,4081,0,0,0,0,0,0,0
MidFirst Bank,2743,0,0,0,0,0,0,0
"HW, LLC",2750,1,0,0,1,1,0,0
korean air,2039,3,0,1,4,0.75,0,0.25
Virgin Group Ltd.,2050,27,1,6,34,0.794117647,0.029411765,0.176470588
DealYo,4322,0,0,0,0,0,0,0
SUPERVALU Inc.,4379,0,0,0,0,0,0,0
The George Washington University,4156,0,0,0,0,0,0,0
Native Remedies,4347,1,0,0,1,1,0,0
Associated British Foods,4349,0,0,0,0,0,0,0
CouponScratch.com,4356,0,0,0,0,0,0,0
San Francisco Symphony,4181,1,0,0,1,1,0,0
THQ Inc.,4188,0,0,0,0,0,0,0
Ship Smart Inc.,4454,0,0,0,0,0,0,0
ZBiddy,4190,1,1,0,2,0.5,0.5,0
The Nest,4458,0,0,0,0,0,0,0
Tecmo Koei Games Co.,4479,0,0,0,0,0,0,0
Creative Manager,4481,0,0,0,0,0,0,0
Cavalia Inc.,4613,0,0,0,0,0,0,0
"Pearson Education, Inc.",4624,0,0,1,1,0,0,1
Performance Automotive Group,4415,0,0,0,0,0,0,0
TicketHorse,4690,5,0,0,5,1,0,0
Corset-Story,4422,0,0,0,0,0,0,0
Visual Concepts,4447,0,0,0,0,0,0,0
"IGA, Inc.",4656,0,0,0,0,0,0,0
BMO Harris Bank N.A.,4331,2,2,0,4,0.5,0.5,0
Varsity Automotive Group,4783,0,0,0,0,0,0,0
Deer Valley Resort,4790,0,0,0,0,0,0,0
The Kiplinger Washington Editors,4170,2,0,0,2,1,0,0
"Second Street Media Solutions, Inc",4815,0,0,0,0,0,0,0
Barker Door,4533,0,0,0,0,0,0,0
"Plushbeds, Inc.",4824,2,0,0,2,1,0,0
SHN,4540,0,0,0,0,0,0,0
Southern California Edison,4499,0,0,0,0,0,0,0
Gerber Life Insurance Company,4506,7,3,0,10,0.7,0.3,0
CJ Banks,4508,0,0,0,0,0,0,0
Sensa Products,3868,9,0,1,10,0.9,0,0.1
Polygon Northwest,4440,0,0,0,0,0,0,0
New Jersey Institute of Technology,4303,0,0,0,0,0,0,0
Postmedia Network Inc.,4665,0,0,0,0,0,0,0
MedSlant LLC,4674,0,0,0,0,0,0,0
Bellevue Arts Museum,4840,1,0,0,1,1,0,0
M.Lahart & Co LTD,4317,0,0,0,0,0,0,0
Network18 Group,4767,0,0,0,0,0,0,0
AT&T Performing Arts Center,4385,0,0,0,0,0,0,0
Export Development Canada,4908,0,0,0,0,0,0,0
UPICKEM,4167,0,0,1,1,0,0,1
Eventbrite,4772,1,1,1,3,0.333333333,0.333333333,0.333333333
Education180.com,4450,0,0,0,0,0,0,0
Telecharge.com,4774,0,0,0,0,0,0,0
Core77,4467,0,0,0,0,0,0,0
Oracle,4535,0,0,0,0,0,0,0
Medix Health,4503,0,0,0,0,0,0,0
The Palazzo,2864,3,0,0,3,1,0,0
Busuu Online,3848,0,0,0,0,0,0,0
Tom's of Maine,4603,0,0,0,0,0,0,0
True Religion Apparel Inc.,3962,0,0,0,0,0,0,0
Chicago Board Options Exchange,4518,0,0,1,1,0,0,1
Rapport Intl. Furniture,3657,0,0,0,0,0,0,0
Wibiya,2021,0,0,0,0,0,0,0
golden bridges,2036,0,0,0,0,0,0,0
Reed Business Information Ltd (fwi.co.uk),4159,2,0,1,3,0.666666667,0,0.333333333
Power4Home.tv,4161,0,0,0,0,0,0,0
Massachusetts Office of Travel & Tourism,4359,0,0,0,0,0,0,0
Dough Main,4361,0,0,0,0,0,0,0
"Lexington International, LLC",4176,0,0,0,0,0,0,0
Mecalux,4527,0,0,0,0,0,0,0
MyPCBackup,4476,0,0,1,1,0,0,1
Bigpoint Games,4493,1,0,0,1,1,0,0
Cerritos Center for the Performing Arts,4512,0,0,0,0,0,0,0
Download Nation,4427,0,0,0,0,0,0,0
Putnam Investments,3457,0,0,2,2,0,0,1
American Collectors Insurance,4659,0,0,0,0,0,0,0
InsureCenter.com,4829,0,0,0,0,0,0,0
Duraflame INC.,4759,0,0,0,0,0,0,0
Stuyvesant Town,4761,0,0,0,0,0,0,0
United States Holocaust Memorial Museum,4776,0,0,0,0,0,0,0
B&B Hotels Ltd,4863,0,0,0,0,0,0,0
VIA Rail Canada Inc.,4689,1,0,1,2,0.5,0,0.5
"The Receivables Exchange, LLC",3460,0,0,0,0,0,0,0
Relationship Rewind,3471,0,0,0,0,0,0,0
Johns Hopkins University,4832,0,0,0,0,0,0,0
Minnesota Public Radio,4839,0,0,0,0,0,0,0
Invesco Ltd.,4789,0,0,1,1,0,0,1
Zipia,4800,0,0,0,0,0,0,0
"Hearthware, Inc.",4807,0,0,0,0,0,0,0
Southern California Gas Company,4814,2,0,0,2,1,0,0
Merge Records,4825,0,0,0,0,0,0,0
Centers for Medicare & Medicaid Services,4989,4,0,2,6,0.666666667,0,0.333333333
"Bobbi Brown Professional Cosmetics, Inc.",4118,5,1,0,6,0.833333333,0.166666667,0
Ministry of Tourism Government of India,4136,0,0,0,0,0,0,0
Vodafone,2028,0,0,0,0,0,0,0
Prevent Asthma Attacks,4350,1,0,0,1,1,0,0
Chamilia,4353,0,0,0,0,0,0,0
Ultrasound-Colleges.com,4403,0,0,0,0,0,0,0
Decho Corp,4453,0,0,0,0,0,0,0
City CarShare,4468,0,0,0,0,0,0,0
Polyvore,4536,0,0,0,0,0,0,0
"Have The Relationship You Want, LLC",4500,2,0,0,2,1,0,0
Metropolitan Transportation Authority,4504,0,0,0,0,0,0,0
Alabama Department of Public Health,4604,0,0,0,0,0,0,0
The Nemours Foundation,4617,1,0,0,1,1,0,0
Matthews International Capital Management,4618,0,0,0,0,0,0,0
Gander Mountain Company,4686,6,0,3,9,0.666666667,0,0.333333333
Miami Dolphins,4417,0,0,0,0,0,0,0
Antonioli,4703,0,0,0,0,0,0,0
Julep,3482,8,2,4,14,0.571428571,0.142857143,0.285714286
Holmes County Chamber of Commerce,4653,0,0,0,0,0,0,0
"Gas South, LLC.",4753,0,0,2,2,0,0,1
"Gear Nuts, LLC",4667,0,0,0,0,0,0,0
LogiXML,4836,0,0,0,0,0,0,0
MAGIC CITY CASINO,4768,0,0,0,0,0,0,0
Portland Center Stage,4786,0,0,0,0,0,0,0
Auslogics Software Pty Ltd.,4985,0,0,0,0,0,0,0
The Artist Series,4986,0,0,0,0,0,0,0
eShakti.com,3861,0,0,0,0,0,0,0
"Gaia Interactive, Inc.",3872,0,0,0,0,0,0,0
STOOPID MONKEY,2025,0,0,0,0,0,0,0
business on main,2091,0,0,0,0,0,0,0
BrightTALK,4299,0,0,0,0,0,0,0
JFK Health System,4306,0,0,0,0,0,0,0
FAGE USA Dairy Industry Inc.,2098,0,0,0,0,0,0,0
CEA,4163,0,0,0,0,0,0,0
"LegalZoom.com, Inc.",4165,1,0,0,1,1,0,0
Colfax International,4399,0,0,0,0,0,0,0
Segerstrom Center for the Arts,4365,1,0,0,1,1,0,0
Ting,4406,0,0,1,1,0,0,1
"Contact Energy Trust or Oregon, Inc.",4372,1,0,0,1,1,0,0
Democratic Governors Association,4463,2,0,0,2,1,0,0
Bob's Discount Furniture,4531,0,0,0,0,0,0,0
"Hill Physicians Medical Group, Inc.",4538,0,0,1,1,0,0,1
Journey 2 the Mysterious Island Movie,4497,0,0,0,0,0,0,0
Hofstra University,4606,0,0,0,0,0,0,0
"The Corcoran Group, Inc.",4699,1,0,0,1,1,0,0
SAP AG,4431,0,0,2,2,0,0,1
Manta Media Inc,3463,0,0,0,0,0,0,0
harmon.ie,4708,0,0,0,0,0,0,0
The Salvation Army,3468,0,0,0,0,0,0,0
"Velocify, Inc.",3470,1,1,0,2,0.5,0.5,0
Nemacolin Woodlands Resort,4631,0,0,1,1,0,0,1
Hoag,4633,0,0,0,0,0,0,0
Gap Inc.,4672,2,0,2,4,0.5,0,0.5
Tipedia LLC.,4765,0,0,0,0,0,0,0
Evening Post Publishing Co.,4906,0,0,0,0,0,0,0
House of Pain,4806,0,0,0,0,0,0,0
Amara Gold,4999,0,0,0,0,0,0,0
Unicef,5008,1,0,0,1,1,0,0
"Seattle Children’s Hospital, Research and Foundation",3987,0,0,0,0,0,0,0
"Ziff Davis, Inc.",4080,0,0,1,1,0,0,1
Zenprise,4105,0,0,0,0,0,0,0
"Woodman Labs, Inc.",2758,2,2,2,6,0.333333333,0.333333333,0.333333333
Vns,3923,0,0,0,0,0,0,0
ETD Discount Tire,2083,0,0,1,1,0,0,1
Mercy Hospital & Medical Center (Chicago),4366,0,0,0,0,0,0,0
Quaker Oats Company,4405,2,0,1,3,0.666666667,0,0.333333333
Nice Kicks,4180,0,0,0,0,0,0,0
"Capital Gold Group, Inc.",4466,0,0,0,0,0,0,0
Hurley,4616,0,0,0,0,0,0,0
Fanedos Jewelry,4516,0,0,0,0,0,0,0
FindZerona.com,4523,0,0,0,0,0,0,0
Splash Media,4630,0,0,0,0,0,0,0
Extra Space Storage Inc,4448,0,0,0,0,0,0,0
Creative Recreation,4655,0,0,0,0,0,0,0
RAMIU.COM,4666,0,0,0,0,0,0,0
Jordache,4859,0,0,0,0,0,0,0
Brown Paper Tickets,4798,0,0,0,0,0,0,0
Crystal Cruises,4805,0,0,0,0,0,0,0
National Institute of Standards and Technology,4816,0,0,0,0,0,0,0
Highmark Inc.,4436,0,0,0,0,0,0,0
The Vow Movie,3464,0,0,0,0,0,0,0
Campus Explorer,3481,0,0,0,0,0,0,0
Otay Ranch Communities,4754,0,0,0,0,0,0,0
Consumer Energy Alliance,4835,0,0,0,0,0,0,0
"Constant Contact, Inc.",4771,12,0,1,13,0.923076923,0,0.076923077
XHeli.com,4853,0,0,0,0,0,0,0
Boston Herald and Herald Media,4854,0,0,1,1,0,0,1
My Natural Market,4785,0,0,0,0,0,0,0
abc carpet & home,4868,0,0,0,0,0,0,0
"HarvestINFO, Inc.",4804,0,0,0,0,0,0,0
Wilson Sporting Goods,4818,0,0,0,0,0,0,0
Lear Capital,2085,18,2,0,20,0.9,0.1,0
Ann Inc.,4142,6,0,1,7,0.857142857,0,0.142857143
"Così, Inc.",4325,0,0,0,0,0,0,0
Sotheby's International Realty,4342,1,0,1,2,0.5,0,0.5
The Parlor,4410,0,0,0,0,0,0,0
Red Tails Movie,4376,0,0,0,0,0,0,0
Barneys New York,4478,6,0,1,7,0.857142857,0,0.142857143
"Owens-IllInoIs, Inc",4542,0,0,0,0,0,0,0
Star Auctions,4510,1,0,0,1,1,0,0
Bright House Networks,2857,7,8,5,20,0.35,0.4,0.25
The Breakers,4425,0,0,0,0,0,0,0
Kellogg NA Co.,3474,124,60,19,203,0.610837438,0.295566502,0.093596059
University of New Haven,4627,0,0,0,0,0,0,0
City of San Antonio,3476,4,0,0,4,1,0,0
Vitalicious.com,4646,1,0,0,1,1,0,0
Palm Coast Data LLC,4661,0,0,0,0,0,0,0
Ashland,4678,0,0,1,1,0,0,1
Carnegie Library of Pittsburgh,4763,1,0,1,2,0.5,0,0.5
Sub Pop Records,4844,0,0,0,0,0,0,0
Immortal Gaming LLC,4912,4,0,0,4,1,0,0
consumerincentivepromotions,4778,0,0,0,0,0,0,0
Relax the Back,4980,0,0,1,1,0,0,1
RiffTrax,4993,0,0,0,0,0,0,0
SpamTitan Technologies,4981,1,0,0,1,1,0,0
"QuorumLabs, Inc.",4983,0,0,0,0,0,0,0
Legal Buds.com,4992,0,0,0,0,0,0,0
Lynx,297,0,0,0,0,0,0,0
Rainbow Play Systems,1216,0,0,0,0,0,0,0
Sleepy's,1301,15,1,2,18,0.833333333,0.055555556,0.111111111
Shopping.com,1105,0,0,0,0,0,0,0
Quicken Loans,1104,7,0,5,12,0.583333333,0,0.416666667
Instawares Restaurant Supply,1233,0,0,0,0,0,0,0
Current Biology,1111,0,0,0,0,0,0,0
Mr. Overshare Blog,1618,0,0,0,0,0,0,0
King County,2773,0,0,0,0,0,0,0
North Carolina Department of Commerce,2776,0,0,0,0,0,0,0
Seattle Symphony Orchestra,4881,0,0,0,0,0,0,0
Skullcandy,4884,0,0,0,0,0,0,0
Seagate Technology LLC,2777,5,0,1,6,0.833333333,0,0.166666667
Schubas Tavern,4883,0,0,0,0,0,0,0
Eve Online,1637,9,0,4,13,0.692307692,0,0.307692308
Boca Java,1737,0,0,0,0,0,0,0
Cheap Cheap Moving Boxes,5059,0,0,0,0,0,0,0
redken,2120,0,0,0,0,0,0,0
Pella Corporation,4890,19,0,2,21,0.904761905,0,0.095238095
"PrimaryGames, Inc.",2772,0,0,0,0,0,0,0
Hundson & Marshall,4198,1,0,1,2,0.5,0,0.5
"iboats, Inc.",5058,1,0,0,1,1,0,0
"The Doe Fund, Inc.",4898,0,0,1,1,0,0,1
Alchemy Worldwide,5163,0,0,0,0,0,0,0
InvestmentLifestyle.com,2137,0,0,0,0,0,0,0
Universal Technical Institute,1772,55,1,9,65,0.846153846,0.015384615,0.138461538
"STA Travel, Inc.",2537,0,0,0,0,0,0,0
Baltimore Ravens,4205,0,0,0,0,0,0,0
Legacy Learning Systems,2705,0,0,0,0,0,0,0
3dcart Shopping Carts,3930,5,0,0,5,1,0,0
VocabularySpellingCity.com,3358,1,0,0,1,1,0,0
"Bleacher Report, Inc",4212,0,0,2,2,0,0,1
AJ Madison Inc.,3492,0,0,0,0,0,0,0
"Elmer's Products, Inc.",5173,0,0,0,0,0,0,0
"Miraval Resort Tucson, LLC",3105,2,0,0,2,1,0,0
"American Greetings (AG Interactive, Inc.)",3107,18,1,4,23,0.782608696,0.043478261,0.173913043
Volvo,2003,12,0,4,16,0.75,0,0.25
SeaWorld Parks & Entertainment,2237,0,0,2,2,0,0,1
NASCAR,2239,3,5,1,9,0.333333333,0.555555556,0.111111111
Freshdesk Inc.,3392,0,0,0,0,0,0,0
Shoutback Concepts LLC.,2456,0,0,1,1,0,0,1
Fingerhut,1652,114,2,11,127,0.897637795,0.015748031,0.086614173
Parallels Holdings,2824,0,0,0,0,0,0,0
FTD,3439,7,0,0,7,1,0,0
Mashable,3122,0,0,0,0,0,0,0
US Weekly,3124,1,0,0,1,1,0,0
DePaul University,1109,1,0,1,2,0.5,0,0.5
The Golden 1 Credit Union,4885,0,0,0,0,0,0,0
American Medical Association,4882,0,0,0,0,0,0,0
Super Stock Plays,1780,0,0,0,0,0,0,0
Big Fish Games,1125,0,1,0,1,0,1,0
Athenos,1128,0,0,0,0,0,0,0
"Vox Media, Inc.",4194,0,0,3,3,0,0,1
Salesgenie,3943,0,0,0,0,0,0,0
"Better Education for Kids, Inc.",4548,0,0,0,0,0,0,0
The Motley Fool,1782,6,0,4,10,0.6,0,0.4
Quality Transformer and Electronics,1786,0,0,0,0,0,0,0
New Year's Eve Movie,5066,0,0,0,0,0,0,0
Bluestar Jets,1775,0,0,0,0,0,0,0
Don Davis Auto Group,4200,0,0,0,0,0,0,0
Force Factor,1788,2,0,4,6,0.333333333,0,0.666666667
Batanga Network,4888,0,0,0,0,0,0,0
MedImmune,4230,6,0,4,10,0.6,0,0.4
Tourism Board of Mexico,3945,0,0,0,0,0,0,0
Maharishi University of Management,4210,0,0,0,0,0,0,0
Burst Online Entertainment,5166,0,0,0,0,0,0,0
Comerica  Incorporated,4201,0,0,0,0,0,0,0
Med Help,4901,0,0,0,0,0,0,0
Metro Omaha Builders Association,5063,0,0,0,0,0,0,0
"Starnet Interactive, Inc.",3939,1,0,1,2,0.5,0,0.5
A Contemporary Theatre,5184,0,0,0,0,0,0,0
Smartpress.com,4220,0,0,0,0,0,0,0
Gallery Furniture,4559,0,0,1,1,0,0,1
CyrusOne,4903,0,0,0,0,0,0,0
MDVIP,1797,3,0,1,4,0.75,0,0.25
"Einstein Noah Restaurant Group, Inc.",3948,0,0,0,0,0,0,0
South African Airways,3933,0,0,1,1,0,0,1
AbeBooks Inc.,4894,0,0,0,0,0,0,0
"Kimmel Center, Inc.",5073,0,0,0,0,0,0,0
"Great Clips, Inc.",4202,0,0,0,0,0,0,0
American Chemistry Council,5175,0,0,0,0,0,0,0
Paradigm Real Estate Solutions,5241,0,0,0,0,0,0,0
Phoenix International Raceway,5244,0,0,0,0,0,0,0
1&1 Mail & Media Inc,4916,0,0,0,0,0,0,0
The Mighty Macs Movie,5182,0,0,0,0,0,0,0
Ylang|23,4224,0,0,0,0,0,0,0
Seton Hall University,4896,0,0,0,0,0,0,0
Top Producer Systems,5246,0,0,1,1,0,0,1
"Torstar, Inc.",4216,0,0,0,0,0,0,0
Elizabeth for MA,4556,0,0,0,0,0,0,0
James G. Murphy Co,3932,0,0,0,0,0,0,0
KontrolFreek,4560,0,0,0,0,0,0,0
reiwholesaleguy.com,4222,0,0,0,0,0,0,0
Tribeca Flashpoint Academy,4924,0,0,0,0,0,0,0
LumaTherm Inc.,4211,0,0,0,0,0,0,0
Red Roof Inns,5309,12,4,0,16,0.75,0.25,0
Hover,5172,0,0,0,0,0,0,0
Valley Health System,4547,0,0,0,0,0,0,0
Omni Hotels,5316,0,0,0,0,0,0,0
"J.C. Penney Company, Inc.",3941,46,7,10,63,0.73015873,0.111111111,0.158730159
Manfrotto Distribution Inc.,5236,0,0,0,0,0,0,0
What's Your True Sign,5198,0,0,0,0,0,0,0
Independent Living News,1801,0,0,0,0,0,0,0
America's Natural Gas Alliance,5179,2,0,2,4,0.5,0,0.5
Kaplan Higher Education,4232,0,0,0,0,0,0,0
WHG International Ltd.,5315,0,0,0,0,0,0,0
Paulsopportunity.com,4576,0,0,0,0,0,0,0
Bestofmedia Group,5183,0,0,0,0,0,0,0
College Book Rental Co,4195,0,0,0,0,0,0,0
Fujifilm,5238,2,0,3,5,0.4,0,0.6
Unique Home Solutions,4564,1,0,0,1,1,0,0
Billy Bob's Texas,4558,0,0,0,0,0,0,0
Journal Sentinel Inc.,5081,0,0,1,1,0,0,1
VKernel,4580,0,0,0,0,0,0,0
Outer Banks Visitors Guide,3676,0,0,0,0,0,0,0
San Manuel Indian Bingo & Casino,4581,0,0,0,0,0,0,0
Vitamix Corporation,5080,0,0,0,0,0,0,0
Mazda,1794,102,4,6,112,0.910714286,0.035714286,0.053571429
"Alloy, Inc.",5313,0,0,1,1,0,0,1
"City Harvest, Inc.",4588,13,0,11,24,0.541666667,0,0.458333333
Redstone College,5239,0,0,0,0,0,0,0
"FlowPlay, Inc.",4233,5,0,0,5,1,0,0
Canadian Curling Association,4926,0,0,0,0,0,0,0
Rob Rohrman Auto Group,4261,0,0,0,0,0,0,0
Doctor's Associates Inc. (Subway),3686,1,0,9,10,0.1,0,0.9
DVD Film Cafe,3680,0,0,0,0,0,0,0
"Major League Soccer, L.L.C. (MLS)",4204,3,0,4,7,0.428571429,0,0.571428571
Tennessee Department of Tourist Development,5190,0,0,1,1,0,0,1
PlaceWise Media,4928,0,0,0,0,0,0,0
Juicy Couture,4902,0,0,1,1,0,0,1
MIT Sloan School of Management,4255,0,0,1,1,0,0,1
"United HealthCare Services, Inc.",5262,12,2,13,27,0.444444444,0.074074074,0.481481481
Super 8 Movie,5192,0,0,0,0,0,0,0
The Truvia Company,5209,0,0,0,0,0,0,0
zZounds Music,5186,0,0,0,0,0,0,0
Fleet Laboratories,4241,0,0,0,0,0,0,0
Wiley-VCH,5259,0,0,0,0,0,0,0
Star Media Group,5070,0,0,0,0,0,0,0
University of Wisconsin,1840,0,0,0,0,0,0,0
Wolverine World Wide,4243,8,0,2,10,0.8,0,0.2
Luisviaroma.com,5211,0,0,1,1,0,0,1
Billabong,1795,0,0,0,0,0,0,0
"Cheezburger, Inc.",3673,10,0,1,11,0.909090909,0,0.090909091
LiveMixtapes.com,5323,0,0,0,0,0,0,0
"The Pediment Group, Inc.",3931,0,0,0,0,0,0,0
Quasar Distributors,4571,0,0,0,0,0,0,0
Playzo,5252,0,0,0,0,0,0,0
LA Weekly,3675,0,0,1,1,0,0,1
Davison,5174,2,0,1,3,0.666666667,0,0.333333333
Qiran.com,5318,0,0,0,0,0,0,0
GracePrayer.org,5169,0,0,0,0,0,0,0
United SGP,4593,0,0,0,0,0,0,0
South Dakota Department of Tourism,5235,0,0,0,0,0,0,0
"Bachman's, Inc.",5255,0,0,0,0,0,0,0
Heroic Era,5092,0,0,0,0,0,0,0
Vermont Teddy Bear Company,5264,0,0,0,0,0,0,0
What Are the Real Costs,5176,0,0,0,0,0,0,0
Thomas Publishing Company,4582,0,0,1,1,0,0,1
On-Demand Publishing,5217,2,0,0,2,1,0,0
ConsumerSoft,5330,0,0,0,0,0,0,0
"University of California, San Francisco",5256,0,0,0,0,0,0,0
"Leatherman Tool Group, Inc",5327,0,0,3,3,0,0,1
Independence Blue Cross,3661,0,0,0,0,0,0,0
Action MAX,5213,1,0,0,1,1,0,0
Whitefish Convention and Visitor Bureau,5331,0,0,0,0,0,0,0
"Nioxin Research Laboratories, Inc.",5320,0,0,0,0,0,0,0
David Yurman,1807,4,0,4,8,0.5,0,0.5
Cliqstudios.com,4930,4,0,1,5,0.8,0,0.2
Neogyn,5087,0,0,0,0,0,0,0
North American Spine,1809,3,0,0,3,1,0,0
Corning,1820,0,0,1,1,0,0,1
Mohegan Sun,5214,15,0,1,16,0.9375,0,0.0625
Overkings,4260,0,0,0,0,0,0,0
Angie's List,4947,17,0,2,19,0.894736842,0,0.105263158
Keystone Custom Homes,5170,0,0,1,1,0,0,1
Southern Technical College,4948,0,0,0,0,0,0,0
Shout! Factory,4231,0,0,0,0,0,0,0
Azusa Pacific University,4219,0,0,1,1,0,0,1
Sharp Electronics Corporation,5270,0,0,0,0,0,0,0
Vancl,1816,0,0,0,0,0,0,0
"Headsets.com, Inc.",5074,0,0,0,0,0,0,0
Codero,4944,0,0,0,0,0,0,0
ZENMED,3690,0,0,0,0,0,0,0
Freixenet USA,5460,0,0,0,0,0,0,0
Intermountain Healthcare,5231,0,0,0,0,0,0,0
CloudPassage Inc,4273,0,0,0,0,0,0,0
"American Teleconferencing Services, Ltd.",5317,0,0,0,0,0,0,0
usautoinsurancenow.com,4592,12,2,0,14,0.857142857,0.142857143,0
Berkadia Commercial Mortgage LLC,5415,0,0,0,0,0,0,0
TIBI,4932,0,0,0,0,0,0,0
Ministry of Tourism of Ecuador,3670,0,0,0,0,0,0,0
Mauna Lani Resort,4567,0,0,0,0,0,0,0
NHLPA,4943,0,0,0,0,0,0,0
Deere & Company,4269,0,0,0,0,0,0,0
Cougar Life,3689,0,0,0,0,0,0,0
Seiko Watch Corporation,5237,0,0,5,5,0,0,1
ATGStores.com,5341,0,0,0,0,0,0,0
"Paciolan, Inc.",4240,0,0,1,1,0,0,1
Kitco Metals Inc.,3692,3,0,1,4,0.75,0,0.25
"beRecruited, Inc.",5426,1,0,0,1,1,0,0
PetFoodDirect.com,4945,0,0,0,0,0,0,0
MSG Network,5091,0,0,0,0,0,0,0
Ex3D,4254,0,0,0,0,0,0,0
PowerMax Computers,5391,0,0,0,0,0,0,0
University of St. Thomas,5381,0,0,0,0,0,0,0
SEI Investments Company,5397,0,0,0,0,0,0,0
Borro L1 Inc.,5394,15,0,2,17,0.882352941,0,0.117647059
QuiBids.com,5216,5,0,1,6,0.833333333,0,0.166666667
Americans for Prosperity,4583,0,0,0,0,0,0,0
Polynesian Cultural Center,5234,0,0,0,0,0,0,0
Cricut,1825,0,0,0,0,0,0,0
FrontPageMagazine.com,5228,0,0,0,0,0,0,0
National Breast Cancer Foundation,4601,0,0,0,0,0,0,0
TD Auto Finance,5398,0,0,0,0,0,0,0
Servco Pacific INC.,5098,0,0,1,1,0,0,1
AppVault,5558,0,0,0,0,0,0,0
EntirelyPets.com,4551,0,0,0,0,0,0,0
Billy Graham Evangelistic Association,4886,0,0,0,0,0,0,0
Civic Center,5459,0,0,0,0,0,0,0
Kodiak,4921,0,0,0,0,0,0,0
"VMware, Inc.",3707,11,2,3,16,0.6875,0.125,0.1875
X.commerce,5332,0,0,0,0,0,0,0
DK Publishing,2774,0,0,0,0,0,0,0
Morro Bay,1106,0,0,0,0,0,0,0
PC Health Doc,2775,0,0,0,0,0,0,0
E. Philip Saunders College of Business,5546,0,0,0,0,0,0,0
Northwestern University,1113,0,0,1,1,0,0,1
"Women, Infants, and Children (WIC)",1793,0,0,0,0,0,0,0
Orange County Pacific Symphony,4199,0,0,0,0,0,0,0
U.S. Chamber of Commerce,5559,0,0,0,0,0,0,0
Window Nation,4263,0,0,0,0,0,0,0
NPR,4889,0,0,0,0,0,0,0
Red Laser,1777,0,0,0,0,0,0,0
Insurance.Comparisons.org,3698,12,0,0,12,1,0,0
"House of Blues Entertainment, Inc.",5411,0,0,0,0,0,0,0
Syndero,5548,0,0,0,0,0,0,0
Shades of Light,1122,0,0,0,0,0,0,0
"DAZ Productions, Inc",4892,1,1,0,2,0.5,0.5,0
Dey Pharma,4897,0,0,0,0,0,0,0
Bite Fight,1120,0,0,0,0,0,0,0
Lauren Moshi,5260,0,0,0,0,0,0,0
Excelsior College,4891,0,0,0,0,0,0,0
Digital Shelf Space,4899,0,0,0,0,0,0,0
"University of California, Davis",4940,0,0,0,0,0,0,0
CreditPing.com,2779,0,0,0,0,0,0,0
Pechanga Resort & Casino,3927,0,0,1,1,0,0,1
Mattress USA,5230,0,0,0,0,0,0,0
FirstBank Holding Company,5093,0,0,0,0,0,0,0
"FrmantleMedia North America, Inc.",3925,0,0,0,0,0,0,0
Nova Southeastern University,4207,1,0,0,1,1,0,0
Framingham State University,5462,0,0,0,0,0,0,0
Black Mountain Ranch,5556,0,0,0,0,0,0,0
RDN LLC,4206,0,0,0,0,0,0,0
Pala Casino Spa & Resort,5273,0,0,0,0,0,0,0
Radian6,4290,0,0,0,0,0,0,0
"Hagar Tools, Inc.",5187,0,0,0,0,0,0,0
Florida Orchestra,4256,0,0,0,0,0,0,0
"TuneCore, Inc.",3938,1,0,0,1,1,0,0
FlightCenter.com,4904,0,0,0,0,0,0,0
Gamestop,1842,1,1,8,10,0.1,0.1,0.8
Boca Raton Museum of Art,4887,0,0,0,0,0,0,0
CasualDatescom,5384,0,0,0,0,0,0,0
VH Essentials,1773,0,0,0,0,0,0,0
Logitech,1119,4,0,0,4,1,0,0
Driver Mender,1129,0,0,0,0,0,0,0
leaseweb,1791,0,0,0,0,0,0,0
La Mer Collections,5069,0,0,0,0,0,0,0
ZAIC,4880,0,0,0,0,0,0,0
Ehrman Tapestry,5324,0,0,0,0,0,0,0
Rixty,1123,0,0,0,0,0,0,0
Sam Bernstein Law Firm,1784,0,0,0,0,0,0,0
Utsav,4214,0,0,0,0,0,0,0
Cranfield University,5107,0,0,0,0,0,0,0
3dtoontube.com,5413,0,0,0,0,0,0,0
Steelcase Inc.,5253,0,0,0,0,0,0,0
Pantech Mobile,5109,0,0,0,0,0,0,0
Iminent,4291,0,0,0,0,0,0,0
Art.com Inc.,4900,5,3,1,9,0.555555556,0.333333333,0.111111111
Zumiez,5240,0,0,0,0,0,0,0
Targa Limited,3688,0,0,0,0,0,0,0
California Earthquake Authority,5477,0,0,0,0,0,0,0
Telerik,5545,0,0,0,0,0,0,0
iRobot,1834,6,2,3,11,0.545454545,0.181818182,0.272727273
iMesh,1110,13,0,0,13,1,0,0
"Automation Anywhere, Inc.",4223,0,0,0,0,0,0,0
Center Theatre Group,3934,0,0,0,0,0,0,0
ChannelAdvisor,4284,0,0,0,0,0,0,0
Singlesnet.com,5617,1,0,0,1,1,0,0
San Francisco Ballet,5067,2,0,3,5,0.4,0,0.6
Daniel Silva,1839,0,0,0,0,0,0,0
AEGON Religare,4280,0,0,0,0,0,0,0
Ben Bridge Jeweler,5547,11,2,1,14,0.785714286,0.142857143,0.071428571
"JumpFly, Inc.",4942,0,0,0,0,0,0,0
"Close Combat Company, LLC",5393,0,0,0,0,0,0,0
Virginia Community College System,5188,0,0,0,0,0,0,0
Lung Cancer Leaders,4250,0,0,0,0,0,0,0
Felician College,4227,0,0,0,0,0,0,0
"AVI-SPL, Inc.",5619,0,0,0,0,0,0,0
Case-Mate,5541,0,0,0,0,0,0,0
"PODS Enterprises, Inc.",3665,1,0,0,1,1,0,0
HR.com,3929,0,0,0,0,0,0,0
TrainPetDog.com,5550,0,0,0,0,0,0,0
TotallyMoney,3662,0,0,0,0,0,0,0
SpeedyComputer,5203,0,0,0,0,0,0,0
AMI Clubwear,4951,0,0,0,0,0,0,0
Tones7,5616,0,0,0,0,0,0,0
"PCWorld Communications, Inc.",4234,0,0,0,0,0,0,0
AMC Networks Inc.,3928,1,0,0,1,1,0,0
NextAdvisor.com,3663,0,0,0,0,0,0,0
Batteries Plus LLC.,5627,0,0,0,0,0,0,0
Jo Malone,5167,0,0,0,0,0,0,0
Mate1,1127,2,1,0,3,0.666666667,0.333333333,0
Horizon Structures,4244,0,0,0,0,0,0,0
The GRAMMY Museum,4294,0,0,0,0,0,0,0
"Eclipse Digital Imaging, Inc.",4289,0,0,0,0,0,0,0
Rodale Inc.,5385,3,0,4,7,0.428571429,0,0.571428571
Regal Lakeland,5464,0,0,0,0,0,0,0
"TOUS, Jewelers",4919,0,0,0,0,0,0,0
Club ABC Tours,5242,0,0,0,0,0,0,0
Orange County Transportation Authority,5466,0,0,0,0,0,0,0
Plentyoffish Media Inc.,5625,12,0,0,12,1,0,0
Top Rank,4958,0,0,5,5,0,0,1
"Michigan K.I.D.S., Inc.",5479,0,0,0,0,0,0,0
The Newsweek/Daily Beast Company LLC,5319,0,0,0,0,0,0,0
John barleycorn,5064,0,0,0,0,0,0,0
"38 Studios, LLC",4193,0,0,0,0,0,0,0
Tickets.com,4287,1,0,0,1,1,0,0
Discovery Times Square,5615,0,0,0,0,0,0,0
Birchwood Park Homes,5333,0,0,1,1,0,0,1
Oreck Clean Home Centers,4584,0,0,0,0,0,0,0
AEG Company,4253,0,0,1,1,0,0,1
Virginia Tech,5417,0,0,0,0,0,0,0
Strayer University,3695,18,0,0,18,1,0,0
Spokeo People Search,4292,0,0,0,0,0,0,0
St. Louis Blues Hockey Club,3684,0,0,0,0,0,0,0
TeaParty.org,5085,0,0,0,0,0,0,0
OMX Inc. (Office Max),4281,0,0,0,0,0,0,0
GroceryCouponsDirect,4272,0,0,0,0,0,0,0
"Lightspeed Financial, Inc.",4937,0,0,0,0,0,0,0
SOS Children's Villages - USA,4268,3,0,0,3,1,0,0
Simmons Bedding Company,5626,0,0,0,0,0,0,0
Zimride Carpool & Rideshare Community,4563,0,0,0,0,0,0,0
Intermix,4566,0,0,0,0,0,0,0
Take Shape For Life,5221,0,0,0,0,0,0,0
SmartCreditChoices.com,5276,0,0,0,0,0,0,0
GlassesUSA.com,4938,0,0,0,0,0,0,0
Québec City Tourism,5314,0,0,0,0,0,0,0
Booz Allen Hamilton Inc,5191,0,0,0,0,0,0,0
Vitomy,1830,0,0,0,0,0,0,0
Royal Bank of Canada,4953,10,2,2,14,0.714285714,0.142857143,0.142857143
"Ogden Publications, Inc.",5101,0,0,0,0,0,0,0
The Omaha World Herald,5248,0,0,0,0,0,0,0
Tampa's Lowry Park Zoo,4954,0,0,0,0,0,0,0
The Scotts Company LLC,4274,0,0,0,0,0,0,0
IronKey,4565,0,0,0,0,0,0,0
SmartPak Equine LLC.,5389,0,0,0,0,0,0,0
NowGamez.com,5342,0,0,0,0,0,0,0
Taleo Corporation,5269,0,0,0,0,0,0,0
The Coryn Group II,5422,0,0,0,0,0,0,0
Pfaltzgraff,4270,0,0,0,0,0,0,0
"Earth Trade Water, Inc.",5337,1,0,0,1,1,0,0
Northern Bank & Trust Company,5233,0,0,0,0,0,0,0
LC Sciences,5219,0,0,0,0,0,0,0
"DoctorsInTraining.com, LLC",5401,0,0,0,0,0,0,0
Egreetings.com,5102,0,0,0,0,0,0,0
Professional Diversity Network,5408,0,0,0,0,0,0,0
Chesapeake Energy Corporation,4952,0,0,0,0,0,0,0
"Healthfirst, Inc.",5471,0,0,0,0,0,0,0
Genzyme Corporation,5105,0,0,1,1,0,0,1
Sugar Inc.,4285,6,4,4,14,0.428571429,0.285714286,0.285714286
CareerPathJournal.com,3701,0,0,0,0,0,0,0
Intrepid Travel,5621,1,0,0,1,1,0,0
New Jersey Society of Optometric Physicians,5410,0,0,0,0,0,0,0
Infosys Limited,4955,0,0,0,0,0,0,0
Houghton Mifflin,1844,0,0,0,0,0,0,0
Hotel 71,5542,0,0,0,0,0,0,0
Southwood Nursery,5405,0,0,0,0,0,0,0
The Literacy Site and GreaterGood Network,5544,0,0,0,0,0,0,0
Arizona Theatre Company,5469,0,0,0,0,0,0,0
Pittsburgh Power,5474,0,0,0,0,0,0,0
"Lowe's Food Stores, Inc.",4283,0,0,0,0,0,0,0
University of Denver,4203,1,0,0,1,1,0,0
Gila River Casinos,4217,0,0,0,0,0,0,0
The Aldo Group Inc.,4553,0,0,0,0,0,0,0
Russell Investments,4554,0,0,0,0,0,0,0
Insperity Performance Management,5189,0,0,0,0,0,0,0
The Pageant,4235,0,0,0,0,0,0,0
Aeromexico,5072,0,0,1,1,0,0,1
YOOX Group S.p.A,4236,0,0,1,1,0,0,1
WorldNetDaily.com Inc.,3667,1,0,2,3,0.333333333,0,0.666666667
Save Mart Supermarkets,3668,0,0,0,0,0,0,0
Edgecast,1813,0,0,0,0,0,0,0
New York University School of Continuing and Professional Studies,5254,0,0,2,2,0,0,1
Masque,5204,0,0,0,0,0,0,0
"AOL, Inc.",3681,24,1,6,31,0.774193548,0.032258065,0.193548387
The Pharmaceutical Care Management Association,4935,0,0,0,0,0,0,0
"Church & Dwight Co., Inc.",4936,4,0,1,5,0.8,0,0.2
Pacific Ridge Homes,3685,2,0,1,3,0.666666667,0,0.333333333
Belk Inc.,5339,0,0,0,0,0,0,0
"ScriptRelief, LLC.",5104,0,0,0,0,0,0,0
Lautrec Corp,5539,5,0,0,5,1,0,0
Chronicle Season of Sharing Fund,5421,0,0,0,0,0,0,0
"AvalonMakeup, Inc.",5622,0,0,0,0,0,0,0
Movie Night Out,1789,0,0,0,0,0,0,0
News 7 Daily,5065,0,0,0,0,0,0,0
Skull Base Institute,4238,2,0,0,2,1,0,0
YLighting,5308,2,0,0,2,1,0,0
Soïa & Kyo,5076,0,0,0,0,0,0,0
East Jefferson General Hospital,4572,0,0,1,1,0,0,1
Shreve,5201,0,0,0,0,0,0,0
Mont Tremblant Ski Resort,5206,0,0,0,0,0,0,0
NewSoftwares Inc.,5265,0,0,0,0,0,0,0
Neutrogena Corporation,4265,0,0,0,0,0,0,0
Hollenbeck Associates,5335,0,0,0,0,0,0,0
"Virtual World Computing, LLC",5099,0,0,0,0,0,0,0
Scandinavian Designs,5340,0,0,1,1,0,0,1
Ramsey Auto Center,5476,0,0,0,0,0,0,0
Dimension Films,1774,0,0,0,0,0,0,0
Harvey Norman,1781,0,0,0,0,0,0,0
RightScale,4546,0,0,0,0,0,0,0
Relativity Media,4221,0,0,0,0,0,0,0
Parissa,1792,0,0,0,0,0,0,0
Tax Resolution Services Co.,4239,0,0,0,0,0,0,0
"Quake Kare, Inc.",5075,0,0,0,0,0,0,0
"Avanir Pharmaceuticals, Inc",5193,0,0,1,1,0,0,1
kate spade,3671,9,2,4,15,0.6,0.133333333,0.266666667
Catalent,1806,3,0,2,5,0.6,0,0.4
8tracks Inc,4925,1,0,0,1,1,0,0
Eurofurniture,4246,0,0,0,0,0,0,0
First Tech Federal Credit Union,1817,0,0,0,0,0,0,0
WFAA,3678,0,0,0,0,0,0,0
"eHarmony, Inc.",5082,0,0,0,0,0,0,0
University of Chicago Press,5089,0,0,0,0,0,0,0
The Hongkong & Shanghai Hotels,4939,0,0,1,1,0,0,1
BeautyUser.com,1831,0,0,0,0,0,0,0
Ron Paul Presidential Campaign Committee,5268,0,0,0,0,0,0,0
Thinkstock,4596,0,0,0,0,0,0,0
"Federated Media Publishing, Inc.",4271,0,0,1,1,0,0,1
"Romney for President, Inc.",5100,0,0,0,0,0,0,0
Bluelounge Design LLC,5343,0,0,0,0,0,0,0
Grapevine Convention & Visitor's Bureau,5225,0,0,1,1,0,0,1
Greater Miami Convention & Visitors Bureau,4957,0,0,0,0,0,0,0
"Unique Vacations, Inc.",5543,3,0,0,3,1,0,0
The Christian Science Monitor,5425,0,0,1,1,0,0,1
NapaStyle,5475,0,0,0,0,0,0,0
PEGI Online,5618,0,0,0,0,0,0,0
Meyer Corporation,4557,0,0,0,0,0,0,0
Dining Furniture Centre,5068,0,0,0,0,0,0,0
Minto Group Inc.,3664,0,0,1,1,0,0,1
"TheStreet, Inc.",4914,0,0,0,0,0,0,0
Jemstep Inc.,5243,0,0,0,0,0,0,0
Excellus BlueCross BlueShield,4575,0,0,0,0,0,0,0
Downtown Phoenix Partnership,5200,0,0,0,0,0,0,0
"Goldstar Events, Inc",5257,0,0,0,0,0,0,0
FortuneCity.com,5207,0,0,0,0,0,0,0
Touhill Performing Arts Center,4257,0,0,0,0,0,0,0
Alaska Seafood Marketing Institute,4589,0,0,0,0,0,0,0
Acquisio,5325,0,0,0,0,0,0,0
Michigan State University Board of Trustees,4600,0,0,0,0,0,0,0
Back to the Roots,5218,0,0,0,0,0,0,0
Pinehole Press,3696,0,0,0,0,0,0,0
MINI Dealerships,5382,17,3,1,21,0.80952381,0.142857143,0.047619048
Georgetown University,3703,3,0,0,3,1,0,0
Frontier Communications Corporation,5232,0,0,0,0,0,0,0
GlobalPost,5400,7,1,0,8,0.875,0.125,0
London Business School,5418,0,0,1,1,0,0,1
Perdue,5557,0,0,0,0,0,0,0
InSight Cruises,5561,0,0,1,1,0,0,1
"Lulu Enterprises, Inc.",4282,0,0,0,0,0,0,0
Renton Gentle Dentist,1800,0,0,0,0,0,0,0
Stardoll AB,3672,0,0,1,1,0,0,1
Pizzicato Pizza,4574,0,0,0,0,0,0,0
H-E-B. Central Market Division,5199,1,0,1,2,0.5,0,0.5
Love and Pride,4933,0,0,0,0,0,0,0
Klondike,1823,0,0,0,0,0,0,0
Greater Iowa Credit Union,5208,0,0,0,0,0,0,0
"Teletrac, Inc.",5210,2,0,0,2,1,0,0
"Haverty Furniture Companies, Inc",4597,0,0,2,2,0,0,1
FreeRateUpdate.com LLC,5274,2,0,0,2,1,0,0
OGPlanet,3697,22,0,0,22,1,0,0
Telluride Tourism,5108,11,0,0,11,1,0,0
SparkNotes,3704,0,0,0,0,0,0,0
Fantasy Action Sports League,5399,0,0,0,0,0,0,0
Carchex,5465,0,0,0,0,0,0,0
The Credit Union Difference,5467,0,0,0,0,0,0,0
Physicians Formula,4923,11,3,0,14,0.785714286,0.214285714,0
Rooster Teeth Productions,4573,0,0,0,0,0,0,0
"BuzzFeed, Inc",4248,0,0,0,0,0,0,0
HealthONE LLC,5084,0,0,0,0,0,0,0
Hickory Farms,4591,0,0,0,0,0,0,0
DiabetesReversed.com,4262,0,0,0,0,0,0,0
Reyn Spooner,5334,0,0,0,0,0,0,0
HaircolorForWomen.com,4598,0,0,0,0,0,0,0
Bingham McCutchen LLP,4959,0,0,0,0,0,0,0
Money Management International,5416,0,0,0,0,0,0,0
F. Korbel & Bros.,5427,0,0,0,0,0,0,0
Career-Reports.com,5552,3,0,0,3,1,0,0
Hibdon Tires Plus,5171,0,0,1,1,0,0,1
Saint Vincent de Paul Atlanta,4218,0,0,0,0,0,0,0
Vita Coco,1796,0,0,0,0,0,0,0
Instead Inc.,4918,0,0,0,0,0,0,0
"Ivy Funds Distributor, Inc.",5321,0,0,0,0,0,0,0
ZMags,4586,1,0,0,1,1,0,0
Marian University,5086,0,0,0,0,0,0,0
Toshiba,1828,2,0,1,3,0.666666667,0,0.333333333
Trudeau Corporation,4267,0,0,0,0,0,0,0
"Nova Technologies, Inc.",5272,0,0,0,0,0,0,0
LeadCola,5336,0,0,0,0,0,0,0
Webster University,5222,0,0,0,0,0,0,0
Scribol,3700,0,0,0,0,0,0,0
Avalon Carpet,5386,0,0,0,0,0,0,0
Kane's Furniture,5403,0,0,0,0,0,0,0
MassBay Community College,5472,0,0,0,0,0,0,0
"DTS, Inc.",5553,0,0,0,0,0,0,0
BradsDeals.com,4286,1,0,0,1,1,0,0
Science Museum of Minnesota,4578,0,0,0,0,0,0,0
ManpowerGroup,4927,1,0,1,2,0.5,0,0.5
Toei Animation,4929,0,0,0,0,0,0,0
Belkin,1819,6,2,2,10,0.6,0.2,0.2
Times Publishing Company,5212,0,0,0,0,0,0,0
The Daily Caller,3691,0,0,0,0,0,0,0
Brands 4 Friends,1836,0,0,0,0,0,0,0
Townhall.com,3693,0,0,0,0,0,0,0
TDK,1838,0,0,0,0,0,0,0
Cache Creek Casino Resort,5380,1,0,0,1,1,0,0
Archipelago Learning,5344,0,0,0,0,0,0,0
GlaxoSmithKline,3708,14,0,6,20,0.7,0,0.3
News Daily 7,5395,0,0,0,0,0,0,0
The University of Alabama,5412,0,0,0,0,0,0,0
Denny's,5463,0,0,0,0,0,0,0
U.S. Xpress,4295,0,0,0,0,0,0,0
Orsam Sylvania,3947,2,1,2,5,0.4,0.2,0.4
Human Events,4549,0,0,0,0,0,0,0
Open Road Films,4922,0,0,0,0,0,0,0
Yoshi's,5249,0,0,0,0,0,0,0
"United Domains, Inc.",4245,0,0,0,0,0,0,0
"ICF International, Inc.",4247,0,0,0,0,0,0,0
"Glam Media, Inc.",3679,11,0,0,11,1,0,0
WePay,5083,0,0,0,0,0,0,0
Net10,5258,4,0,2,6,0.666666667,0,0.333333333
Valpak Direct Marketing Systems,4590,0,0,0,0,0,0,0
Dark Horse Comics Inc.,5090,0,0,0,0,0,0,0
The Washington Post Company,5215,4,0,1,5,0.8,0,0.2
Leica Microsystems,4949,0,0,0,0,0,0,0
Scottsdale Convention & Visitors Bureau,5224,1,0,1,2,0.5,0,0.5
Audioengine Corp.,5226,1,0,0,1,1,0,0
J&R Electronics Inc.,4956,0,0,0,0,0,0,0
AppliancesConnection.com,5390,0,0,0,0,0,0,0
Georgia's Own Credit Union,5392,0,0,0,0,0,0,0
Seattle Art Museum,5419,0,0,0,0,0,0,0
Skye Tampa,5549,0,0,0,0,0,0,0
Life Insurance Corporation of India,5551,0,0,0,0,0,0,0
"Build-A-Bear Workshop, Inc",5560,13,4,0,17,0.764705882,0.235294118,0
Sister Schubert's Inc.,4279,0,0,0,0,0,0,0
"Novega Venture Partners, Inc.",4288,0,0,0,0,0,0,0
Vail Resorts Management Company,5624,8,1,0,9,0.888888889,0.111111111,0
Penguin Group USA,3666,0,0,0,0,0,0,0
Nevada Commission on Tourism,4569,0,0,0,0,0,0,0
Essentia,4570,0,0,0,0,0,0,0
Family Events,5202,0,0,0,0,0,0,0
Karen Millen,4252,0,0,0,0,0,0,0
Tornado Alley Live,4587,0,0,0,0,0,0,0
"Loggly, Inc.",3683,0,0,0,0,0,0,0
Charter,1826,17,1,9,27,0.62962963,0.037037037,0.333333333
Visit Milwaukee,4266,0,0,0,0,0,0,0
"Fortune3, Inc.",5338,0,0,0,0,0,0,0
Linenchest Inc.,5220,0,0,0,0,0,0,0
NetPlunder.org,5387,0,0,0,0,0,0,0
Renevati Inc.,5388,0,0,0,0,0,0,0
Tourisme Montréal,5420,0,0,0,0,0,0,0
Compuware Corporation,5423,0,0,0,0,0,0,0
Lenox Corporation,5470,1,0,0,1,1,0,0
AutoNation,5473,0,0,2,2,0,0,1
Aetna Inc.,5555,1,0,2,3,0.333333333,0,0.666666667
Champion Windows Manufacturing Inc.,5620,10,0,1,11,0.909090909,0,0.090909091
EDI,4893,0,0,0,0,0,0,0
eMinor Inc.,4208,8,1,0,9,0.888888889,0.111111111,0
The Nielsen Company,3942,0,0,0,0,0,0,0
Epicx.com,3944,0,0,0,0,0,0,0
"Prescriptives, Inc.",5061,0,0,0,0,0,0,0
Options Xpress,1787,0,0,9,9,0,0,1
Cox7,5180,0,0,0,0,0,0,0
Varian Medical Systems,1802,1,0,0,1,1,0,0
CyberPower Inc,4242,0,0,0,0,0,0,0
Henry Ford Health System,5078,1,0,5,6,0.166666667,0,0.833333333
"McGladrey & Pullen, LLP.",5312,0,0,0,0,0,0,0
"Rexall Sundown, Inc.",5261,0,0,0,0,0,0,0
"Minnesota Vikings Football, LLC",4259,0,0,0,0,0,0,0
HootSuite Media Inc.,5263,0,0,0,0,0,0,0
Metro Parks Tacoma,5329,0,0,2,2,0,0,1
LaDIFFERENCE,4595,0,0,0,0,0,0,0
The Mosaic Company,5095,0,0,0,0,0,0,0
"System76, Inc.",5097,0,0,0,0,0,0,0
Winster,4946,0,0,0,0,0,0,0
"Hard Rock Cafe International, Inc.",5227,1,0,3,4,0.25,0,0.75
Chumash Casino Resort,5229,2,0,0,2,1,0,0
Jacksonville.com,5414,0,0,0,0,0,0,0
SMU Cox School of Business,5461,3,0,0,3,1,0,0
Smartsheet.com,4276,3,0,0,3,1,0,0
"Cheapcaribbean.com, Inc",4278,1,0,0,1,1,0,0
"TechTarget, Inc.",5614,1,0,0,1,1,0,0
The Kroger Co.,2988,52,15,7,74,0.702702703,0.202702703,0.094594595
Voyetra Turtle Beach,2356,2,0,1,3,0.666666667,0,0.333333333
HITS Triathlon Series,5113,0,0,0,0,0,0,0
Aspose,5115,1,0,0,1,1,0,0
Business Development Bank of Canada,5117,0,0,1,1,0,0,1
National Journal Group Inc.,5116,1,0,0,1,1,0,0
Royal Canadian Mint,3322,6,5,1,12,0.5,0.416666667,0.083333333
boocoo auctions,4715,0,0,0,0,0,0,0
EmersonMade,5121,0,0,0,0,0,0,0
ChoozOn Corporation,4716,0,0,0,0,0,0,0
Harbor Freight Tools,5123,8,0,0,8,1,0,0
Cablevision Systems Corporation,4718,11,1,10,22,0.5,0.045454545,0.454545455
New Jersey Performing Arts Center (NJPAC),4719,0,0,0,0,0,0,0
"CustomInk, LLC.",4710,0,0,0,0,0,0,0
ArrowOutlet,2671,0,0,0,0,0,0,0
The Shubert Organization Inc.,4717,0,0,0,0,0,0,0
"Christianbook.com, LLC",5124,0,0,0,0,0,0,0
Miami Lakes Automall,5128,4,0,1,5,0.8,0,0.2
Women's Health Institute of Texas,5126,1,0,0,1,1,0,0
Washington Federation of State Employees,4728,0,0,0,0,0,0,0
The Wrap News Inc.,4726,0,0,0,0,0,0,0
SkinStore.com,4723,1,0,0,1,1,0,0
"TheHealthyWayDiet.com, Inc.",3609,0,0,0,0,0,0,0
Fisher Communications,2909,0,0,0,0,0,0,0
Pittsburgh Cultural Trust.,4734,0,0,0,0,0,0,0
"Various, Inc.",5013,0,0,4,4,0,0,1
Quikrete,2913,0,0,0,0,0,0,0
"Ultimate Survival Products, Inc.",2920,0,0,0,0,0,0,0
Canadian Association of Petroleum Producers (CAPP),4737,0,0,0,0,0,0,0
President & Fellows of Harvard College,2908,1,0,1,2,0.5,0,0.5
TaDa,2917,2,0,0,2,1,0,0
The College Network,4741,0,0,0,0,0,0,0
The Goodyear Tire & Rubber Company,2912,4,1,10,15,0.266666667,0.066666667,0.666666667
HemClear,5014,0,0,0,0,0,0,0
Sea Island Golf Club,5023,0,0,0,0,0,0,0
Plan International USA,2918,0,0,0,0,0,0,0
National College,5024,0,0,0,0,0,0,0
SavingStar Inc.,5016,0,0,0,0,0,0,0
Greater Cleveland Aquarium,5026,0,0,0,0,0,0,0
Free Investing Tools,5114,0,0,0,0,0,0,0
HealthPartners,5127,9,0,0,9,1,0,0
"Peppermill Casinos, Inc.",4727,1,0,0,1,1,0,0
6DollarShirts.com,4729,0,0,0,0,0,0,0
ABOR,2921,9,0,0,9,1,0,0
GuitarChordsMadeSimple.com,5012,0,0,0,0,0,0,0
COOLCAPITALS.com,5027,0,0,0,0,0,0,0
qumid.com,4733,0,0,0,0,0,0,0
On the Webs,4738,0,0,0,0,0,0,0
California Children & Families Commission,4740,6,0,0,6,1,0,0
Dreyfus,4714,4,0,0,4,1,0,0
"US Tax Shield, L.L.C.",4732,0,0,0,0,0,0,0
"eDiets.com, Inc.",5025,0,0,0,0,0,0,0
Maggie Sottero Designs LLC.,5118,0,0,1,1,0,0,1
GoodSearch,2910,0,0,0,0,0,0,0
Green Games And Ham,4731,0,0,0,0,0,0,0
QuoteWhiz LLC,4742,0,0,0,0,0,0,0
StateTheatreNJ.org,5112,0,0,0,0,0,0,0
"Journal Communications, Inc.",4712,0,0,1,1,0,0,1
SafeNet Inc,5129,0,0,0,0,0,0,0
Obesity Action Coalition,1903,0,0,0,0,0,0,0
Gunnar Optiks,2737,0,0,0,0,0,0,0
toronto escapes,3407,5,0,2,7,0.714285714,0,0.285714286
"ProPhase Labs, Inc.",3907,0,0,0,0,0,0,0
Costco Wholesale Corp,5122,1,0,0,1,1,0,0
Olympus America Inc.,4721,0,0,4,4,0,0,1
"Blackbaud, Inc.",4736,0,0,0,0,0,0,0
Aeroplan Canada Inc.,5021,0,0,0,0,0,0,0
Backwoods Equipment Inc.,5022,0,0,0,0,0,0,0
Arizona State University,4722,25,2,9,36,0.694444444,0.055555556,0.25
Icelandair,5119,7,5,4,16,0.4375,0.3125,0.25
ESP Computer Services,3712,3,0,1,4,0.75,0,0.25
"Exteris Audio, LLC",5120,0,0,0,0,0,0,0
Wingards Importants,2938,1,0,0,1,1,0,0
ShopRXO,5484,0,0,0,0,0,0,0
Everfast Inc.,5483,0,0,0,0,0,0,0
Nationwide Vision Laser & Medical Eye Centers,4720,0,0,0,0,0,0,0
Telemundo,2915,0,0,0,0,0,0,0
American Film Institute,2916,0,0,0,0,0,0,0
appMobi,3713,0,0,0,0,0,0,0
Celebrate Express,5020,0,0,0,0,0,0,0
New Orleans Arts District Association,5485,0,0,0,0,0,0,0
Viceroy Hotels and Resorts,5487,0,0,0,0,0,0,0
"Rudi's Organic Bakery, Inc.",3720,0,0,0,0,0,0,0
"SAKURA HOUSE Co.,ltd.",3722,0,0,0,0,0,0,0
"Ulta Salon, Cosmetics & Fragrance, Inc",5488,10,1,3,14,0.714285714,0.071428571,0.214285714
Rediff.com,5688,0,0,1,1,0,0,1
South Coast MedSpa,5564,0,0,0,0,0,0,0
JC Whitney,3726,0,0,0,0,0,0,0
SureFire,5492,0,0,1,1,0,0,1
"The Finish Line, Inc.",5686,10,0,0,10,1,0,0
Sixt,3715,0,0,0,0,0,0,0
Edun,5573,0,0,0,0,0,0,0
SweetIM Technologies Ltd.,3716,0,0,0,0,0,0,0
Mike's Bikes,5693,0,0,0,0,0,0,0
MotorTrend Magazine,3727,0,0,0,0,0,0,0
FHA.com,5494,1,0,1,2,0.5,0,0.5
"VeriSign, Inc.",5683,1,0,2,3,0.333333333,0,0.666666667
Authentic Provence Inc,5694,0,0,0,0,0,0,0
The Recording Academy,5685,0,0,0,0,0,0,0
Centenary College New Jersey,5570,0,0,0,0,0,0,0
EngineAdvocacy.org,5691,0,0,0,0,0,0,0
Benchmade,5574,1,0,0,1,1,0,0
Excellence Group Luxury Resorts,5692,0,0,0,0,0,0,0
FootSolutions Inc.,5566,0,0,0,0,0,0,0
The Nutro Company,5576,0,0,0,0,0,0,0
Autoweek,2926,0,0,0,0,0,0,0
Safe House Movie,2937,0,0,0,0,0,0,0
"Parfums de Coeur, Ltd.",5684,0,0,0,0,0,0,0
Kajeet,5577,0,0,0,0,0,0,0
J. Edgar Movie,3710,0,0,0,0,0,0,0
smartcarpet.com,3723,0,0,0,0,0,0,0
"Maui Jim, Inc.",3725,0,0,0,0,0,0,0
Online Publishing & Marketing,5495,0,0,0,0,0,0,0
IMI University Centre,5565,0,0,0,0,0,0,0
SingleHop,2925,2,0,0,2,1,0,0
AdaptedMind,5569,7,0,0,7,1,0,0
Banner Health,5482,2,0,0,2,1,0,0
Hilton Worldwide,2935,45,7,12,64,0.703125,0.109375,0.1875
Nautell Capital Limited,5493,0,0,0,0,0,0,0
LogoMojo,5568,0,0,0,0,0,0,0
VÄXA International,5575,0,0,0,0,0,0,0
CIT Group Inc.,3714,0,0,5,5,0,0,1
Florida Hospital ,5486,1,0,0,1,1,0,0
Wantickets,5489,0,0,0,0,0,0,0
City of San Luis Obispo,5572,0,0,0,0,0,0,0
Time Warner Cable Enterprises LLC,3717,31,0,14,45,0.688888889,0,0.311111111
The Western Center for Journalism,3718,2,0,0,2,1,0,0
"Marc Glassman, Incorporated",5689,0,0,0,0,0,0,0
Major League Fishing,5690,0,0,0,0,0,0,0
Mattress Discounters Pittsburgh,5571,0,0,1,1,0,0,1
Enterprise Media,5567,0,0,0,0,0,0,0
Drexel University,5695,1,0,0,1,1,0,0
Mercy Corps,5563,2,2,1,5,0.4,0.4,0.2
"Global Rebel, Inc.",5578,0,0,0,0,0,0,0
Search Institute,2905,0,0,0,0,0,0,0
Conceptus,2941,6,1,1,8,0.75,0.125,0.125
Convert Now,2942,0,0,0,0,0,0,0
Group Health Cooperative,3641,0,0,0,0,0,0,0
Automobile Club of Southern California,2944,33,0,4,37,0.891891892,0,0.108108108
24 Hour Fitness USA,2943,0,0,0,0,0,0,0
The Colonial Williamsburg Foundation,2946,4,0,1,5,0.8,0,0.2
The OpenSky Project,2953,0,0,0,0,0,0,0
Breastcancer.org,2956,1,0,1,2,0.5,0,0.5
New Orleans Tourism Marketing Corporation,2961,0,0,0,0,0,0,0
Brother International Corporation,3860,2,0,2,4,0.5,0,0.5
The Gatorade Company,2963,0,0,0,0,0,0,0
"Origins Natural Resources, Inc.",3656,1,0,0,1,1,0,0
Spy Kids 4 Movie,2969,0,0,0,0,0,0,0
Sift Partners,2966,0,0,0,0,0,0,0
FINRA Investor Education Foundation,5697,15,0,0,15,1,0,0
lonely planet,2020,0,0,0,0,0,0,0
"Z’Tejas, Inc.",5700,2,0,0,2,1,0,0
BOEING,2035,1,0,1,2,0.5,0,0.5
Wilmington University,5034,0,0,0,0,0,0,0
Cenegenics Medical Institute,2951,23,1,2,26,0.884615385,0.038461538,0.076923077
Sojourn Bicycling & Active Vacations,5499,0,0,0,0,0,0,0
Cuddledown,5707,0,0,0,0,0,0,0
King Broadcasting Company,5714,0,0,1,1,0,0,1
Thomas M. Cooley Law School,5500,0,0,0,0,0,0,0
Bomgar Corporation,5498,0,0,0,0,0,0,0
Bankers Trust Company,5762,0,0,0,0,0,0,0
"Nasty Gal, Inc.",5764,9,0,2,11,0.818181818,0,0.181818182
Federal Hockey League,5705,0,0,0,0,0,0,0
"VUDU, Inc.",5503,0,0,0,0,0,0,0
Dallas Children's Theater,5758,0,0,0,0,0,0,0
Single Muslim,5513,0,0,0,0,0,0,0
Branch Banking and Trust Company,5706,0,0,0,0,0,0,0
BrandsMart USA,2962,2,0,0,2,1,0,0
Agfa-Gevaert Group,5037,0,0,0,0,0,0,0
Newt,5504,0,0,0,0,0,0,0
Simplexity,5756,0,0,0,0,0,0,0
quantbench,5771,0,0,0,0,0,0,0
McKee Foods Corporation,5709,4,1,0,5,0.8,0.2,0
Lifestyle Lift Holdings,2973,1,0,0,1,1,0,0
Cornilles for Congress,5039,0,0,0,0,0,0,0
Adagio Teas,5795,0,0,1,1,0,0,1
Breathablebaby,5779,0,0,0,0,0,0,0
Faulkner Hospital,5775,0,0,0,0,0,0,0
Scholarships Finder,5525,0,0,0,0,0,0,0
Orlando Philharmonic Orchestra,5698,0,0,0,0,0,0,0
Indianapolis Downtown Inc.,5781,0,0,0,0,0,0,0
New York University,5804,22,4,4,30,0.733333333,0.133333333,0.133333333
SAS Institute,2977,3,0,4,7,0.428571429,0,0.571428571
Expo Experts,5765,0,0,0,0,0,0,0
Troy-Bilt,5774,0,0,0,0,0,0,0
HumanConcepts,5517,0,0,0,0,0,0,0
Steps Studio Inc.,5042,0,0,0,0,0,0,0
Diamond Ground Products Inc,5527,0,0,0,0,0,0,0
The New Republic,5519,0,0,0,0,0,0,0
Stetson University,5798,0,0,0,0,0,0,0
Purple Heart Services,5791,0,0,0,0,0,0,0
"Winter Park Resort, CO",5787,2,1,0,3,0.666666667,0.333333333,0
FurnitureDealer.net,5822,0,0,0,0,0,0,0
Belo Corp,5515,4,0,4,8,0.5,0,0.5
D.R. Horton,5813,0,0,0,0,0,0,0
"Kickstarter, Inc.",5505,1,0,1,2,0.5,0,0.5
GelaSkins Inc.,5512,0,0,0,0,0,0,0
Endless Electronics,5796,0,0,0,0,0,0,0
Flagstar Bank,5510,0,0,0,0,0,0,0
Fluke Corporation,5770,6,0,0,6,1,0,0
John Deere,5769,0,0,0,0,0,0,0
Contagion Movie,5823,0,0,0,0,0,0,0
Rogue Digital,5830,0,0,1,1,0,0,1
SOS Online Backup,5793,0,0,0,0,0,0,0
Mount Snow,5526,0,0,0,0,0,0,0
Mixbook,5801,0,0,0,0,0,0,0
Lesson Nine,5840,7,0,0,7,1,0,0
"Advanstar Communications, Inc.",5856,0,0,0,0,0,0,0
Avon Foundation for Women,5802,0,0,0,0,0,0,0
Florida Lottery,5819,0,0,1,1,0,0,1
Kayem Foods Inc,5810,0,0,0,0,0,0,0
Lucky Brand,5782,0,0,0,0,0,0,0
Outdoor Channel Outfitters,5799,0,0,0,0,0,0,0
Treasure Hunters Roadshow,5809,0,0,0,0,0,0,0
Dauphin Media Group,5849,0,0,0,0,0,0,0
"Indie Merchandising, LLC",5845,0,0,0,0,0,0,0
Costa Rican Vacations,5827,0,0,0,0,0,0,0
Sculptz,5847,0,0,0,0,0,0,0
PECO Energy Company,5859,0,0,0,0,0,0,0
Armed Forces Insurance,5834,16,0,0,16,1,0,0
BSkyB,5860,0,0,0,0,0,0,0
HMForces.co.uk,5773,0,0,0,0,0,0,0
Hostelworld.com,5800,0,0,0,0,0,0,0
New York School of Interior Design,5520,1,0,0,1,1,0,0
Stacy Adams Shoe Company,5824,0,0,0,0,0,0,0
UT Southwestern Medical Center,5855,0,0,0,0,0,0,0
The Solar Company,5783,0,0,0,0,0,0,0
U.S. Career Institute,5826,0,0,0,0,0,0,0
Practice Fusion,5851,0,0,0,0,0,0,0
Crystal Plus,5853,0,0,0,0,0,0,0
Elizabeth Arden,2945,0,0,1,1,0,0,1
LasikCustomVision.com,5038,0,0,1,1,0,0,1
"Mercer County, PA",5755,1,0,0,1,1,0,0
Standard Bar and Grill,5523,0,0,0,0,0,0,0
AskNow.com,5788,0,0,0,0,0,0,0
"Sage Software, Inc.",5837,5,0,0,5,1,0,0
Oranum.com,5838,0,0,0,0,0,0,0
Power A,2972,0,0,0,0,0,0,0
The Grove Park Inn Resort & Spa,2974,0,0,0,0,0,0,0
The Republic of Tea,5029,0,0,0,0,0,0,0
American Institute of CPAs,4744,1,0,0,1,1,0,0
The Pear Bureau Northwest,5514,0,0,0,0,0,0,0
The Adventures of Tin Tin Movie,5529,0,0,0,0,0,0,0
"Blistex, Inc.",5829,0,0,0,0,0,0,0
Tropical Traditions,5831,0,0,0,0,0,0,0
REV New Media,2952,0,0,0,0,0,0,0
Woman in Black Movie,5524,0,0,0,0,0,0,0
K&L Gates,5792,0,0,0,0,0,0,0
Merak,5828,0,0,0,0,0,0,0
DevMcGill,5858,0,0,0,0,0,0,0
PuppetLabs,5502,0,0,0,0,0,0,0
GuitarControl.com,5759,0,0,0,0,0,0,0
Bobcat Company,5509,0,0,0,0,0,0,0
Cintas,5766,0,0,0,0,0,0,0
Corbis Corporation,5777,2,2,0,4,0.5,0.5,0
"CX, Inc.",5816,0,0,0,0,0,0,0
Ryan Homes,2968,1,0,3,4,0.25,0,0.75
"Sports Endeavors, Inc.",5710,0,0,0,0,0,0,0
Wittlebee,5508,0,0,0,0,0,0,0
The Broward Center,5767,0,0,0,0,0,0,0
Washington's Lottery,5776,0,0,0,0,0,0,0
Spartan Race,5803,0,0,0,0,0,0,0
Librocity,5842,0,0,0,0,0,0,0
Tri Pointe Homes,5507,0,0,0,0,0,0,0
Northern Quest Resort & Casino,5768,2,0,2,4,0.5,0,0.5
AWGI,5518,0,0,0,0,0,0,0
Pink Method,5786,0,0,0,0,0,0,0
oFreeGames.Com,5825,0,0,0,0,0,0,0
LaFontaine Family Deal,5843,0,0,0,0,0,0,0
trueroots,2960,0,0,0,0,0,0,0
Century Interactive,5032,0,0,0,0,0,0,0
Lands' End,2978,1,1,3,5,0.2,0.2,0.6
Virgin Media,5711,0,0,0,0,0,0,0
SCANA Corporation,5761,1,0,0,1,1,0,0
Samford University,5811,0,0,0,0,0,0,0
Richard Grossman,5850,0,0,0,0,0,0,0
Toronto Interntional Film Festival,5861,4,0,0,4,1,0,0
San Francisco Jazz Organization,5699,0,0,0,0,0,0,0
"Indiana Repertory Theatre, Inc.",5703,0,0,0,0,0,0,0
Shopify Inc.,5031,5,0,1,6,0.833333333,0,0.166666667
TeraGanix Inc.,5708,0,0,0,0,0,0,0
Aditya Birla Management Corporation,5778,0,0,0,0,0,0,0
12-rules-to-flat-stomach.com,5808,0,0,0,0,0,0,0
Fairfield University,5833,1,0,0,1,1,0,0
Lincoln Hockey,5835,0,0,0,0,0,0,0
Commonwealth of Massachusetts,5844,0,0,4,4,0,0,1
Ralph Lauren,5036,0,0,0,0,0,0,0
Coastal Hotel Group,5521,0,0,0,0,0,0,0
Fay School,5821,0,0,0,0,0,0,0
X-Elerated Guides,5839,0,0,0,0,0,0,0
Look Love Send,5854,0,0,0,0,0,0,0
WeddingWire Inc.,3643,2,0,0,2,1,0,0
Gameforge Productions GmbH.,4141,1,0,0,1,1,0,0
Absolute Software Corporation,4326,0,0,0,0,0,0,0
Fruit of the Loom,5131,0,0,0,0,0,0,0
Team Coco Digital,2856,0,0,2,2,0,0,1
Global Auto Mall,5350,0,0,0,0,0,0,0
MovieFind,5347,1,0,1,2,0.5,0,0.5
"Crown Media Holdings, Inc.",5138,0,0,0,0,0,0,0
Team Escalade Texas,5357,0,0,0,0,0,0,0
Federal Emergency Management Agency (FEMA),5348,7,0,0,7,1,0,0
Publishers Clearing House,4609,42,2,4,48,0.875,0.041666667,0.083333333
"Family Dollar Stores, Inc.",5145,0,0,0,0,0,0,0
Noisey,4511,0,0,0,0,0,0,0
Clarizen,5147,0,0,0,0,0,0,0
l-arginine.com,4411,0,0,0,0,0,0,0
Fallsview Casino Resort,5864,3,0,0,3,1,0,0
United States Internal Revenue Service,5362,0,0,0,0,0,0,0
Automobile Magazine,5364,0,0,0,0,0,0,0
Iberostar Hoteles y Apartamentos S.L.,3456,0,0,0,0,0,0,0
Florida Prepaid College Plans,4626,0,0,0,0,0,0,0
Bank of Nova Scotia,3924,2,0,2,4,0.5,0,0.5
Sixjax,1103,0,0,0,0,0,0,0
"Emerging Global Advisors, LLC",5358,0,0,0,0,0,0,0
Yelp,5353,0,0,1,1,0,0,1
Wisedownloads.com,2771,0,0,0,0,0,0,0
"DADA Entertainment, LLC.",5439,0,0,0,0,0,0,0
Movoto,5158,0,0,0,0,0,0,0
Natural History Museum of Los Angeles County Foundation,4879,0,0,0,0,0,0,0
"International House of Pancakes, LLC",5639,1,0,0,1,1,0,0
RapidBuyr,5863,0,0,0,0,0,0,0
OUTSPARK Inc.,4192,0,0,0,0,0,0,0
Thompson Tractor,5889,0,0,0,0,0,0,0
National Multiple Sclerosis Society,1769,0,0,0,0,0,0,0
Sports Authority,5443,35,10,2,47,0.744680851,0.212765957,0.042553191
"Foster and Smith, Inc.",3926,2,0,0,2,1,0,0
"MultiView, Inc",5653,0,0,0,0,0,0,0
Swiss America Trading Corp,4209,0,0,1,1,0,0,1
KAYAK.com,5636,10,5,1,16,0.625,0.3125,0.0625
Aurora Bank FSB,4545,0,0,0,0,0,0,0
Seminole Casino Coconut Creek,5060,0,0,0,0,0,0,0
MacPaw Inc.,5363,0,0,0,0,0,0,0
SupportChoice.com,3660,0,0,0,0,0,0,0
Crutchfield New Media,5880,8,0,0,8,1,0,0
Mansueto Ventures LLC,4226,2,0,0,2,1,0,0
Better Homes and Gardens Real Estate,5882,0,0,0,0,0,0,0
Thomas Edison State College,4228,0,0,0,0,0,0,0
International Academy of Design & Technology,5668,0,0,0,0,0,0,0
Society for Human Resource Management,5652,0,0,1,1,0,0,1
"Hollywood.com, Inc.",5445,1,0,0,1,1,0,0
Cashdazzle.com,4963,0,0,0,0,0,0,0
StockCharts.com,5881,0,0,0,0,0,0,0
NEC India Pvt,5152,0,0,0,0,0,0,0
Saint James School of Medicine,5355,0,0,0,0,0,0,0
Palms Casino Resort,4966,0,0,0,0,0,0,0
Pacific Aviation Museum Pearl Harbor,5943,0,0,0,0,0,0,0
Foxaza.com,5356,0,0,0,0,0,0,0
Concordia University,6025,1,0,0,1,1,0,0
Pennsylvania Real Estate,5442,0,0,0,0,0,0,0
bestdamnpennystocks.com,5149,0,0,0,0,0,0,0
Domtar,5921,0,0,0,0,0,0,0
Ministère du Tourisme and Bell Canada,5632,0,0,0,0,0,0,0
Beiersdorf AG,5649,1,0,0,1,1,0,0
"Lawry's Foods, LLC",5279,0,0,0,0,0,0,0
"AccuVal Associates, Inc.",5665,0,0,0,0,0,0,0
AmoLatina.com,5873,3,0,0,3,1,0,0
"Ocean Spray International, Inc.",5593,0,0,0,0,0,0,0
Cargill,5920,16,0,4,20,0.8,0,0.2
Cineplex Entertainment LP,5370,1,0,0,1,1,0,0
National Organization for Marriage,5879,0,0,0,0,0,0,0
Swedish Medical Center,5651,2,1,7,10,0.2,0.1,0.7
Benefit Cosmetics,4973,0,0,0,0,0,0,0
Freelancer Technology,5156,0,0,0,0,0,0,0
Culligan,5718,0,0,0,0,0,0,0
OnPoint Community Credit Union,5285,0,0,0,0,0,0,0
Mercury Radio Arts,5725,1,0,1,2,0.5,0,0.5
Direct General Corporation,5666,0,0,0,0,0,0,0
Comfort Suites Miami Airport North,5662,0,0,0,0,0,0,0
Schedule Star LLC,5057,0,0,2,2,0,0,1
Dealer HD,5883,0,0,0,0,0,0,0
Ionizer Research,5155,0,0,0,0,0,0,0
Marvin Windows and Doors,5290,0,0,0,0,0,0,0
"U.S. Global Investors, Inc.",5359,0,0,0,0,0,0,0
West Virginia Division of Tourism,5919,0,0,0,0,0,0,0
Clarity Way Rehab Facility,5298,0,0,0,0,0,0,0
PerfectMatch.com,5366,0,0,0,0,0,0,0
Xanterra Parks & Resorts,5373,0,0,0,0,0,0,0
Memorial Hermann,6031,0,0,1,1,0,0,1
The National Campaign to Prevent Teen and Unplanned Pregnancy,5634,0,0,0,0,0,0,0
Aquent,5647,0,0,0,0,0,0,0
Gevalia,5907,1,0,0,1,1,0,0
Columbia College,5612,2,0,0,2,1,0,0
"MMG, Inc.",5664,0,0,0,0,0,0,0
Wishabi,5637,1,0,0,1,1,0,0
Split Reason Clothing Inc.,5292,0,0,0,0,0,0,0
Armstrong Steel,6050,1,0,0,1,1,0,0
Robert Wood Johnson Foundation,5296,0,0,0,0,0,0,0
Zayed Future Energy Prize,5660,0,0,0,0,0,0,0
KinderCare Learning Centers,6054,0,0,0,0,0,0,0
Movies Unlimited,5928,1,0,1,2,0.5,0,0.5
Nassau Paradise Island Promotion Board,5367,0,0,0,0,0,0,0
Graduate School USA,5638,0,0,0,0,0,0,0
Friends of Rob Mckenna,6013,0,0,0,0,0,0,0
Electric Fireplaces Direct and Net Direct Merchants,5896,0,0,0,0,0,0,0
The Teaching Company,5934,5,0,3,8,0.625,0,0.375
Smeet,5743,0,0,0,0,0,0,0
"Broadway.com, Inc.",4749,0,0,0,0,0,0,0
National Truck Driving Jobs,5677,0,0,0,0,0,0,0
TradingCharts.com,5534,0,0,0,0,0,0,0
S2 Games,5876,0,0,0,0,0,0,0
ONYX Service & Solutions Inc,5926,0,0,0,0,0,0,0
Calamos Investments LLC,5671,0,0,1,1,0,0,1
"Schneider National, Inc.",5302,0,0,0,0,0,0,0
Fungavir,4747,0,0,0,0,0,0,0
Millennium Partners Sports Club Management,6061,0,0,0,0,0,0,0
numerologist.com,5746,0,0,0,0,0,0,0
"Edina Realty, Inc.",5891,0,0,0,0,0,0,0
Ram's Horn Restaurants,5633,0,0,0,0,0,0,0
Dairy Farmers of Canada,5930,6,3,3,12,0.5,0.25,0.25
Balboa Press,6017,1,0,0,1,1,0,0
FIFA,5583,0,0,0,0,0,0,0
Diabetes Resource Page,5581,0,0,0,0,0,0,0
Quirky Incorporated,5288,0,0,0,0,0,0,0
ST Residential,6019,0,0,0,0,0,0,0
Veterinary Pet Insurance,4969,0,0,0,0,0,0,0
Lexmark,5951,9,7,2,18,0.5,0.388888889,0.111111111
Benedictine University,4970,0,0,0,0,0,0,0
Royal DSM N.V.,5717,0,0,0,0,0,0,0
MaxPoint Interactive,5906,0,0,0,0,0,0,0
GrillSmith,6028,0,0,0,0,0,0,0
THe Flowers of War Movie,5878,0,0,0,0,0,0,0
NTT Communications,5960,1,0,0,1,1,0,0
World Travel Holdings,5913,0,0,0,0,0,0,0
HomieGear.com,5673,0,0,0,0,0,0,0
"Advanced Internet Technologies, Inc.",5655,0,0,0,0,0,0,0
Holidays in the City Partnership,5903,0,0,0,0,0,0,0
San Francisco Shutter Company,6020,0,0,0,0,0,0,0
Interjet,6129,28,0,0,28,1,0,0
Inspired by Iceland,5679,69,6,0,75,0.92,0.08,0
National Alliance for Tobacco Cessation,5954,0,0,0,0,0,0,0
Sabre,5716,0,0,1,1,0,0,1
Ping,5915,0,0,0,0,0,0,0
DISCOUNT TWO-WAY RADIO,5895,0,0,0,0,0,0,0
InternetRewardHut.com,6243,0,0,0,0,0,0,0
"CTD, Inc.",6027,0,0,0,0,0,0,0
AlixPartners,6116,0,0,0,0,0,0,0
Birchbox,5719,5,1,1,7,0.714285714,0.142857143,0.142857143
CAVENDER'S OUT OF STATE STORES,5941,1,0,0,1,1,0,0
INDI,6089,0,0,0,0,0,0,0
"Beachmint, Inc.",5959,4,0,0,4,1,0,0
Tissot,5909,0,0,0,0,0,0,0
University of Maryland,5681,0,0,0,0,0,0,0
Spokane Regional CVB,5964,0,0,0,0,0,0,0
Fort Worth Stock Show and Rodeo,6012,0,0,0,0,0,0,0
TicketWeb,5935,0,0,0,0,0,0,0
Imagelly,6311,0,0,0,0,0,0,0
Brandeis University,5049,0,0,0,0,0,0,0
Babble.com,5301,0,0,4,4,0,0,1
"CRAVEONLINE MEDIA, LLC",5728,5,0,0,5,1,0,0
College of Saint Elizabeth,6254,0,0,1,1,0,0,1
eSaleRugs.com,5584,0,0,0,0,0,0,0
Logograph,6090,0,0,0,0,0,0,0
OnePath,5942,0,0,0,0,0,0,0
Sokolove Law,6336,0,0,0,0,0,0,0
Florida State Fair Authority,5953,0,0,0,0,0,0,0
University of Northern Iowa,5591,0,0,0,0,0,0,0
"Rowpar Pharmaceuticals, Inc.",5056,0,0,0,0,0,0,0
Purdue Products,6087,0,0,0,0,0,0,0
CNA,6023,0,0,0,0,0,0,0
The Regents of the University of Michigan,6386,0,0,0,0,0,0,0
Pine Crest School,6233,0,0,0,0,0,0,0
Town Sports International,5962,0,0,0,0,0,0,0
Fetch Enterprises,6393,0,0,0,0,0,0,0
Dean Koontz,5287,0,0,0,0,0,0,0
Agency for Healthcare Research and Quality,6316,0,0,1,1,0,0,1
LASIK MD,5976,0,1,1,2,0,0.5,0.5
WorldNow,5966,1,0,0,1,1,0,0
Cadreon,5924,0,0,0,0,0,0,0
Gorilla Leak,5978,0,0,0,0,0,0,0
First Republic Bank,5598,3,0,6,9,0.333333333,0,0.666666667
All Year Cooling and Heating,6095,0,0,0,0,0,0,0
PC HelpSoft,6361,0,0,0,0,0,0,0
Baumgartner for United States Senate,6267,0,0,0,0,0,0,0
Extreme Networks,6098,0,0,0,0,0,0,0
Halogen Software Inc.,5452,1,0,0,1,1,0,0
Burr & Forman LLP,5721,0,0,0,0,0,0,0
New Hampshire Lottery Commission,6115,0,0,0,0,0,0,0
Saffron Rouge,5955,0,0,0,0,0,0,0
Playhouse Square,5054,0,0,0,0,0,0,0
Carma Labs,6384,0,0,0,0,0,0,0
The Historic New Orleans Collection,6060,0,0,0,0,0,0,0
Alibris,5972,0,0,1,1,0,0,1
Williamson-Dickie Manufacturing Company,6350,0,0,0,0,0,0,0
"UCB, Inc.",5305,0,0,0,0,0,0,0
OMEGA S.A.,5603,0,0,1,1,0,0,1
Broward Health,5052,0,0,0,0,0,0,0
Limorges Jewelry,6096,0,0,0,0,0,0,0
Tennessee Valley Authority,6411,0,0,0,0,0,0,0
Powermat,6047,0,0,0,0,0,0,0
Celebrity Attractions,6368,0,0,0,0,0,0,0
Everglades Direct,6380,0,0,0,0,0,0,0
Guthrie Theater,6230,0,0,0,0,0,0,0
NTRglobal,6461,0,0,0,0,0,0,0
"Bubble Gum Interactive, Inc.",6164,0,0,0,0,0,0,0
The Hain Celestial Group,6126,0,0,0,0,0,0,0
Home Instead,6045,0,0,0,0,0,0,0
"Videology, Inc.",6158,0,0,0,0,0,0,0
TrailersPlus,5745,0,0,0,0,0,0,0
Eshop Enterprises,6247,0,0,0,0,0,0,0
Shabby Apple,5734,0,0,3,3,0,0,1
Media Reel LTD,6531,3,0,3,6,0.5,0,0.5
Team Epilepsy,6088,0,0,0,0,0,0,0
Monoprice,6315,1,0,1,2,0.5,0,0.5
InterSystems  Corporation,5744,0,0,0,0,0,0,0
Wise to Web,5602,0,0,0,0,0,0,0
NewsOK.com,6264,1,0,1,2,0.5,0,0.5
North Medical,6244,0,0,0,0,0,0,0
Kohl's Cares.,5451,0,0,0,0,0,0,0
AppleWay,5724,0,0,0,0,0,0,0
"Anytime Fitness, LLC.",5613,0,0,0,0,0,0,0
"Edmunds.com, Inc.",6548,1,0,0,1,1,0,0
APR Bay Area Open House Search,6113,0,0,0,0,0,0,0
Merial Limited,6543,0,0,0,0,0,0,0
Shoe Carnival Inc.,5977,2,0,0,2,1,0,0
Yoogames,6038,0,0,0,0,0,0,0
weeklyhealthbuzz.com,6249,0,0,0,0,0,0,0
"Hind Health Care, Inc.",5609,0,0,0,0,0,0,0
Peachtree Financial,6334,0,0,0,0,0,0,0
Evergreen Museum,6269,0,0,0,0,0,0,0
foursquare,6159,2,0,0,2,1,0,0
Experience Music Project Museum,5605,0,0,0,0,0,0,0
FileMaker,6128,0,0,0,0,0,0,0
Education Classes,5456,0,0,0,0,0,0,0
Makena Beach & Golf Resort,6317,0,0,0,0,0,0,0
American International Group,6094,0,0,0,0,0,0,0
Customer Magnetism,6253,0,0,0,0,0,0,0
Community College Philadelphia,6102,0,0,0,0,0,0,0
AwesomeClassicGames.com,6058,0,0,0,0,0,0,0
American Animal Hospital Association,6260,0,0,0,0,0,0,0
Attraction Formula,6281,0,0,0,0,0,0,0
The Florida Department of Citrus,5738,0,0,0,0,0,0,0
Doozy Cards,6122,0,0,0,0,0,0,0
Post-Dispatch Online Store,6328,0,0,0,0,0,0,0
Language Advantage Institute,5726,0,0,0,0,0,0,0
Cincinnati State Technical and Community College,6052,0,0,0,0,0,0,0
Desert News,6335,0,0,0,0,0,0,0
"Somaxon Pharmaceuticals, Inc.",6347,0,0,0,0,0,0,0
Republic of Panama,6059,0,0,0,0,0,0,0
Woobox,6364,0,0,0,0,0,0,0
Avatar Properties Inc.,5055,0,0,0,0,0,0,0
The Century Council,5365,0,0,0,0,0,0,0
Fibradetox and Proslimaction,6561,5,0,0,5,1,0,0
"Sturm, Ruger & Co",5741,0,0,1,1,0,0,1
Chloé,5142,0,0,0,0,0,0,0
Paper Mill Playhouse,5150,0,0,0,0,0,0,0
"South Moon Sales, Inc.",5134,0,0,0,0,0,0,0
Colorado Pen Direct,5869,0,0,0,0,0,0,0
Northrop Grumman Corporation,5360,0,0,0,0,0,0,0
Attwood Corporation,6618,0,0,0,0,0,0,0
Blue Canvas,5137,0,0,0,0,0,0,0
UncommonGoods,6394,0,0,0,0,0,0,0
Camelback Mountain Resort,6313,0,0,0,0,0,0,0
Calvin Klein,2940,3,0,3,6,0.5,0,0.5
Minor League Baseball,2955,1,0,1,2,0.5,0,0.5
The Clymb,6259,0,0,0,0,0,0,0
Camille La Vie,6396,0,0,0,0,0,0,0
U.S. SOCCER,6266,0,0,0,0,0,0,0
Cooking Channel,5973,0,0,1,1,0,0,1
M-Coin,6351,0,0,0,0,0,0,0
Warehouse Pool Supply,6611,0,0,0,0,0,0,0
PinpointMD,6631,0,0,0,0,0,0,0
Online Trading Academy,6330,0,0,0,0,0,0,0
Wrapsol,6403,0,0,0,0,0,0,0
PennyStocks123,6383,0,0,0,0,0,0,0
CourseSmart,6320,0,0,0,0,0,0,0
Popular Science,6402,1,0,0,1,1,0,0
Seton Healthcare Family,5051,0,0,0,0,0,0,0
"Aerohive Networks, Inc.",6679,0,0,0,0,0,0,0
Dove Mountain Investors,6105,0,0,0,0,0,0,0
"Software Advice, Inc.",5458,0,0,0,0,0,0,0
Waypoint Living Spaces,6353,0,0,0,0,0,0,0
Gogobot Inc.,6366,0,0,0,0,0,0,0
"SI-BONE, Inc.",6377,0,0,0,0,0,0,0
8x8 Inc.,6428,0,0,0,0,0,0,0
MLT Inc.,5135,0,0,0,0,0,0,0
BonitaSoft,6398,0,0,0,0,0,0,0
The Front Line Movie,6056,0,0,0,0,0,0,0
Interactive Brokers,6410,0,0,0,0,0,0,0
Maine Real Estate Information System,6413,0,0,1,1,0,0,1
Treasure Island Hotel & Casino,6636,3,0,0,3,1,0,0
"Half Off Depot, Inc.",6619,0,0,0,0,0,0,0
iballz,6117,0,0,0,0,0,0,0
Capital BlueCross,6552,0,0,0,0,0,0,0
Getawaylounge.com.au,6478,0,0,0,0,0,0,0
The Provident Bank of NJ,6470,0,0,0,0,0,0,0
Queen's Printer for Ontario,6307,0,0,2,2,0,0,1
AmericInn International,6106,0,0,0,0,0,0,0
Front Sight Firearms Training Institute,6563,0,0,0,0,0,0,0
Dovogame,5437,0,0,0,0,0,0,0
CookingGames.net,6612,0,0,0,0,0,0,0
"MarketTools, Inc.",5444,0,0,0,0,0,0,0
DriverBoost Pro,2964,0,0,0,0,0,0,0
Tivoli Lodge,5132,0,0,0,0,0,0,0
"Samela, Inc.",5136,0,0,0,0,0,0,0
Reebok Cricket North America,6534,0,0,0,0,0,0,0
Red Wind Casino,5139,0,0,0,0,0,0,0
Frette,5368,0,0,0,0,0,0,0
Sourcebits,5436,0,0,0,0,0,0,0
Star One Credit Union,6400,0,0,0,0,0,0,0
Geffen Playhouse,6621,0,0,0,0,0,0,0
Dance New Amsterdam,6119,0,0,0,0,0,0,0
Cleveland Live LLC.,6685,0,0,0,0,0,0,0
Tether Tools,6545,0,0,0,0,0,0,0
Herrmann Services,5635,0,0,0,0,0,0,0
Beneficial Bank,5704,4,0,0,4,1,0,0
L. & J.G. STICKLEY,6635,0,0,0,0,0,0,0
Murphy & Prachthauser,5887,0,0,0,0,0,0,0
Forest Pharmaceuticals,6627,0,0,0,0,0,0,0
Eversave.com,6415,0,0,0,0,0,0,0
"Lake Consumer Products, Inc.",5894,0,0,0,0,0,0,0
SkinCeuticals,5643,0,0,0,0,0,0,0
United Concordia,5497,0,0,0,0,0,0,0
Florida Grand Opera,6466,0,0,0,0,0,0,0
TOMY,5282,0,0,0,0,0,0,0
Bremer Financial Corporation,5712,1,0,0,1,1,0,0
VinceFlynn.com,5658,0,0,0,0,0,0,0
Holman Automotive Group,5918,0,0,0,0,0,0,0
The Vancouver Canucks Limited Partnership,6251,0,0,0,0,0,0,0
Cedar Shingles Direct,6432,0,0,0,0,0,0,0
AV Scripts,5865,0,0,1,1,0,0,1
Tetra Pak,5888,0,0,0,0,0,0,0
Russell Research,6637,0,0,0,0,0,0,0
Premier Polaris,6638,0,0,0,0,0,0,0
Zenga,6340,0,0,0,0,0,0,0
Scarlet Tanager,5537,0,0,0,0,0,0,0
Explore Christian Universities,6123,0,0,0,0,0,0,0
Pepsi Center,5446,0,0,0,0,0,0,0
The Northwestern Mutual Life Insurance Company,6644,0,0,1,1,0,0,1
ReputationChanger.com,6262,0,0,0,0,0,0,0
Southwest Florida College,6238,0,0,0,0,0,0,0
Public Service Enterprise Group,6390,0,0,0,0,0,0,0
The Oklahoma Publishing Company,6613,0,0,0,0,0,0,0
"Health and Human Services Agency, County of San Diego",6256,0,0,0,0,0,0,0
Ohio University,5912,0,0,0,0,0,0,0
Kimberly-Clark Corporation,6549,31,4,5,40,0.775,0.1,0.125
Nova Development,5868,0,0,0,0,0,0,0
Movado Group,6242,0,0,0,0,0,0,0
"Prestige Brands, Inc.",6687,0,0,0,0,0,0,0
Columbia Tourism,5354,0,0,0,0,0,0,0
Confirmit,6615,0,0,0,0,0,0,0
T.I.T.S. BRAND,6273,0,0,0,0,0,0,0
Demetriosbride,6323,2,0,0,2,1,0,0
FirstEnergy Corp,5035,0,0,0,0,0,0,0
StarKist Co,5585,0,0,1,1,0,0,1
Rocky Mountain Power,6387,0,0,0,0,0,0,0
RadioShack Corporation,6620,22,4,4,30,0.733333333,0.133333333,0.133333333
GirlEffect.org,6341,0,0,0,0,0,0,0
Healthy Living Reviewed,5797,0,0,0,0,0,0,0
Gym-Mark,6464,0,0,0,0,0,0,0
PrintingInABox.com,5772,0,0,0,0,0,0,0
Metropolitan Associates,5661,0,0,0,0,0,0,0
ALDI,6408,23,2,5,30,0.766666667,0.066666667,0.166666667
MINTED LLC,6551,2,1,2,5,0.4,0.2,0.4
Mid-Peninsula Vineyard Christian Church,6342,0,0,0,0,0,0,0
Liberty Travel,6359,0,0,0,0,0,0,0
All American Auto Sales Group,6698,0,0,0,0,0,0,0
Morgans Group LLC.,5293,0,0,0,0,0,0,0
Tiffin University,6391,0,0,0,0,0,0,0
Florida Power & Light Company,5522,0,0,1,1,0,0,1
University of Kentucky,6360,0,0,0,0,0,0,0
element14,5289,0,0,0,0,0,0,0
Aspen University,6375,0,0,0,0,0,0,0
"Basement Systems, Inc.",6556,1,0,0,1,1,0,0
Ana-White.com,6564,0,0,0,0,0,0,0
Plum District,5790,0,0,0,0,0,0,0
Citywide Banks,5592,0,0,0,0,0,0,0
Monterey County Convention & Visitors Bureau,5857,0,0,1,1,0,0,1
Toronto Convention and Visitors Association,6539,0,0,0,0,0,0,0
Oklahoma Lottery Commission,6473,0,0,1,1,0,0,1
T-fal USA,6617,0,0,0,0,0,0,0
Women of Faith,6683,0,0,0,0,0,0,0
"Discovery Communications, LLC.",5631,0,0,2,2,0,0,1
Tripp Lite,5933,0,0,0,0,0,0,0
The Corky McMillin Companies,6632,1,0,0,1,1,0,0
The First Tee,6460,0,0,0,0,0,0,0
Assura Group of NY,6475,0,0,0,0,0,0,0
Louise S. McGehee School,6462,0,0,0,0,0,0,0
Valiantrecovery.com,5280,0,0,0,0,0,0,0
"Apira Science, Inc.",6555,0,0,0,0,0,0,0
"FAIR Health, Inc.",6675,0,0,0,0,0,0,0
Intersections Inc.,6026,12,0,2,14,0.857142857,0,0.142857143
The Louisiana Seafood Safety Plan,6692,0,0,0,0,0,0,0
Washington Education Association,6634,0,0,0,0,0,0,0
"Healthy Advice Networks, LLC.",6649,1,0,0,1,1,0,0
Lumens Light + Living,5872,0,0,0,0,0,0,0
Airbus,6689,4,1,3,8,0.5,0.125,0.375
Parrish Medical Center,5674,1,0,0,1,1,0,0
Designer Apparel,6694,20,2,0,22,0.909090909,0.090909091,0
"Orleans Homebuilders, Inc.",5300,0,0,0,0,0,0,0
FC Barcelona,6642,0,0,0,0,0,0,0
Logic-Boxes.com,5656,0,0,0,0,0,0,0
Fastweb,6409,0,0,1,1,0,0,1
Nasdaq,5875,0,0,0,0,0,0,0
"Blizzard Entertainment, Inc.",6374,61,5,12,78,0.782051282,0.064102564,0.153846154
Funtank,5153,0,0,4,4,0,0,1
B & H Foto & Electronics Corp,5937,0,0,1,1,0,0,1
Park City Chamber / Bureau,6035,0,0,0,0,0,0,0
SocialFlow,5967,0,0,0,0,0,0,0
USAid,5969,2,0,0,2,1,0,0
Northwest Territorial Mint,5735,0,0,0,0,0,0,0
Higley Center for the Performing Arts,6424,0,0,0,0,0,0,0
Reeves Import Motorcars,6103,0,0,0,0,0,0,0
"T-Mobile USA, Inc.",6541,116,25,21,162,0.716049383,0.154320988,0.12962963
JSL Property Management,6641,0,0,0,0,0,0,0
Camuto Group,5812,0,0,0,0,0,0,0
"athenahealth, Inc",5814,2,0,0,2,1,0,0
KORG,5848,0,0,0,0,0,0,0
FirstMerit Corporation,5346,1,0,0,1,1,0,0
Arizona Broadway Theatre,5429,0,0,0,0,0,0,0
"Savers, Inc.",5431,2,2,0,4,0.5,0.5,0
Builders Digital Experience,5144,2,3,0,5,0.4,0.6,0
Ashford University,5146,0,0,0,0,0,0,0
Citizens Financial Group,4961,0,0,0,0,0,0,0
"Godwin's Gatorland, Inc.",5378,1,0,0,1,1,0,0
"EZ Freeware, LLC.",5648,0,0,0,0,0,0,0
The LEGO Group,5899,18,3,12,33,0.545454545,0.090909091,0.363636364
Barska,5929,0,0,0,0,0,0,0
Shop 'n Save,5914,0,0,0,0,0,0,0
Comdata Corporation,5931,0,0,0,0,0,0,0
Rovi Corporation,6016,0,0,0,0,0,0,0
Xero,4978,0,0,1,1,0,0,1
Searchlight Systems,5916,0,0,0,0,0,0,0
"AllBusiness.com, Inc.",5963,0,0,0,0,0,0,0
Videojet Technologies Inc,5595,0,0,0,0,0,0,0
West Glen Communications,5965,0,0,0,0,0,0,0
Belhaven University,5597,1,0,0,1,1,0,0
The Seminole Hard Rock Hotel & Casino in Tampa,5729,0,0,0,0,0,0,0
Intersoft Solutions,6046,0,0,0,0,0,0,0
Acura Dealerships,6163,32,0,6,38,0.842105263,0,0.157894737
McIlhenny Company,6114,0,0,1,1,0,0,1
Speakers Webinars,6231,0,0,0,0,0,0,0
YES ON 1183,6248,0,0,0,0,0,0,0
iN DEMAND LLC,6250,0,0,0,0,0,0,0
The Credit Solution Program,6314,7,0,1,8,0.875,0,0.125
Plukka,6263,0,0,0,0,0,0,0
New Charter University,6265,0,0,0,0,0,0,0
Got Vape,6399,0,0,0,0,0,0,0
Health Care Service Corporation,6416,12,0,0,12,1,0,0
"humble Brands, Inc.",6533,0,0,0,0,0,0,0
Intervet International,6465,0,0,0,0,0,0,0
Rate Rabbit,6616,0,0,0,0,0,0,0
Toronto Trending,6684,0,0,0,0,0,0,0
SlimGenics,6018,0,0,0,0,0,0,0
NYDJ Apparel,5586,0,0,0,0,0,0,0
LightSquared,6092,0,0,0,0,0,0,0
Norton Center for the Arts,5594,0,0,0,0,0,0,0
WhiteHat Security,5449,0,0,0,0,0,0,0
BIG 5 Sporting Goods,6051,0,0,0,0,0,0,0
Acushnet Company,6162,1,0,1,2,0.5,0,0.5
SU College of Law,6319,0,0,0,0,0,0,0
Biogen Idec.,6385,3,0,5,8,0.375,0,0.625
Freeworkz,6362,0,0,0,0,0,0,0
Software Shelf International,6421,0,0,0,0,0,0,0
The United Service Organizations Inc. (USO),6426,0,0,0,0,0,0,0
Asian Art Museum,6430,0,0,0,0,0,0,0
"Bankrate, Inc.",6553,0,0,1,1,0,0,1
Hayek's Leather Furniture Inc,6562,0,0,0,0,0,0,0
"The Rowing Team, LLC.",6630,0,0,0,0,0,0,0
CSA Audio Design,6696,0,0,0,0,0,0,0
"University of California, Irvine",5374,0,0,0,0,0,0,0
Silverpop,5905,0,0,0,0,0,0,0
Owens Corning,5376,0,0,0,0,0,0,0
"Grammarly, Inc.",5923,7,0,1,8,0.875,0,0.125
Celebrity Theatre,5533,0,0,0,0,0,0,0
"ACE Cash Express, Inc.",5670,0,0,0,0,0,0,0
The New Yorker,5644,0,0,0,0,0,0,0
"ION Media Networks, Inc.",5938,0,0,0,0,0,0,0
The AIDS Memorial Quilt The Names Project Foundation,4965,0,0,0,0,0,0,0
Jersey Mike's,5587,6,0,0,6,1,0,0
Madewell Inc.,4967,6,1,4,11,0.545454545,0.090909091,0.363636364
Alzheimer's Association,5306,18,1,0,19,0.947368421,0.052631579,0
Metropolitan State College of Denver,5901,0,0,0,0,0,0,0
Austin Community College,6024,0,0,0,0,0,0,0
MacMall,4972,0,0,0,0,0,0,0
Traditions of America,5956,0,0,2,2,0,0,1
Grocio Inc.,5908,0,0,0,0,0,0,0
Van Cleef & Arpels,5455,0,0,1,1,0,0,1
Viewpoints.com,4976,0,0,0,0,0,0,0
US Appliance,5910,0,0,0,0,0,0,0
Ex’pression College for Digital Arts,5974,0,0,0,0,0,0,0
"Club W, Inc.",5606,0,0,0,0,0,0,0
Acorn Stairlifts Inc.,5669,0,0,0,0,0,0,0
Daniels Trading,5737,2,0,0,2,1,0,0
Las Vegas Convention and Visitors Authority,5299,12,0,3,15,0.8,0,0.2
Alliance Health,6055,0,0,2,2,0,0,1
"Long & Foster Real Estate, Inc.",5676,0,0,0,0,0,0,0
DiscountFilters.com,6124,0,0,0,0,0,0,0
Oil and Natural Gas Industry Labor-Management Committee,6037,0,0,0,0,0,0,0
Ochsner Health System,6241,0,0,0,0,0,0,0
Thatsnotcool.com,5601,0,0,0,0,0,0,0
Bellevue University,6324,4,0,0,4,1,0,0
Jameson Irish Whiskey,6042,0,0,0,0,0,0,0
iskullgames.com,6392,0,0,0,0,0,0,0
Schnuck Markets Inc.,5733,0,0,0,0,0,0,0
GotDailyDeals.com,6373,0,0,0,0,0,0,0
"Redbox Automated Retail, LLC.",4750,6,2,1,9,0.666666667,0.222222222,0.111111111
"New IT, Ltd.",5610,0,0,0,0,0,0,0
SSPI,6246,0,0,0,0,0,0,0
MarketAxess Holdings,6310,0,0,0,0,0,0,0
American Diabetes Association,6312,17,2,2,21,0.80952381,0.095238095,0.095238095
Isabella Stewart Gardner Museum,6278,0,0,0,0,0,0,0
Sagamore Hotel,6337,0,0,0,0,0,0,0
Xamarin,6344,0,0,0,0,0,0,0
Centers for Disease Control and Prevention (CDC),6346,1,0,0,1,1,0,0
Premier Sports Management,6405,0,0,0,0,0,0,0
Positioner,6412,0,0,0,0,0,0,0
Chinesewomendate.com,6369,1,0,0,1,1,0,0
Mike's Car Wash,6371,2,0,0,2,1,0,0
"Bluewater Associates of Emerald Isle, Inc.",6376,0,0,0,0,0,0,0
Los Angeles County Museum of Art,6537,0,0,0,0,0,0,0
"iBUYPOWER, Inc.",6544,0,0,0,0,0,0,0
Midwest Construction,6605,0,0,1,1,0,0,1
"Rabobank, N.A.",6610,0,0,0,0,0,0,0
Three Sixty Entertainment,6480,0,0,0,0,0,0,0
I See Me! Inc.,6680,0,0,0,0,0,0,0
"KingsIsle Entertainment, Inc.",5352,1,0,0,1,1,0,0
LA INC.,5434,0,0,0,0,0,0,0
John Varvatos,5870,0,0,0,0,0,0,0
"Dietz & Watson, Inc.",5877,0,0,0,0,0,0,0
Hoveround Corporation,5641,0,0,0,0,0,0,0
Steppenwolf Theatre Company,5902,0,0,0,0,0,0,0
ClapAlong.com,5659,0,0,0,0,0,0,0
SelectQuote Insurance Services,5291,0,0,0,0,0,0,0
"The San Diego Union-Tribune, LLC",4748,0,0,0,0,0,0,0
TPS Parking Management,5952,0,0,0,0,0,0,0
The Donna Karan Company LLC,5048,0,0,0,0,0,0,0
ATP,5970,0,0,0,0,0,0,0
QVC,5727,14,12,0,26,0.538461538,0.461538462,0
Beyond.com,6109,0,0,0,0,0,0,0
Ernst & Young,6234,0,0,0,0,0,0,0
Tippr,6127,0,0,0,0,0,0,0
Booth Western Art Museum,6245,0,0,0,0,0,0,0
CityU of Seattle,6309,0,0,0,0,0,0,0
StriVectin,6252,0,0,0,0,0,0,0
Chamber of Commerce of the United States,6327,0,0,0,0,0,0,0
Republic Monetary Exchange,6277,0,0,0,0,0,0,0
RealClearPolitics,6338,0,0,0,0,0,0,0
The University of Texas,6388,0,0,0,0,0,0,0
Glue Dots International LLC,6345,0,0,0,0,0,0,0
Nefesh B’Nefesh,6352,0,0,0,0,0,0,0
University of Redlands,6363,0,0,0,0,0,0,0
Arctic Cat Corporation,6420,0,0,0,0,0,0,0
Interstate Battery System of America,6427,0,0,0,0,0,0,0
Aggregate Knowledge,6477,0,0,0,0,0,0,0
CVS Caremark,6695,6,3,5,14,0.428571429,0.214285714,0.357142857
National University,5157,3,0,0,3,1,0,0
Sunset Marquis,5375,0,0,0,0,0,0,0
Grocery Manufacturers Association,5886,0,0,0,0,0,0,0
RA Sushi Company,5893,1,0,0,1,1,0,0
Landmark Credit Union,4964,0,0,1,1,0,0,1
"Gazzang, Inc.",5900,0,0,0,0,0,0,0
Earth Networks,4975,0,0,0,0,0,0,0
Koch Industries,5925,0,0,0,0,0,0,0
The Madison Square Garden Company,5911,0,0,0,0,0,0,0
The Reader's Digest Association,5582,0,0,1,1,0,0,1
Space Coast Credit Union,5936,4,1,0,5,0.8,0.2,0
The Paley Center for Media,5968,0,0,0,0,0,0,0
Your Better Tomorrow,5736,0,0,0,0,0,0,0
WSI Cultivate,6104,0,0,0,0,0,0,0
NatureSweet Limited,6229,0,0,0,0,0,0,0
BNP Paribas,6329,0,0,0,0,0,0,0
"Curse, Inc.",6343,0,0,0,0,0,0,0
TheGreatEstateRoadshow.com,6404,0,0,0,0,0,0,0
California HealthCare Foundation,6379,0,0,0,0,0,0,0
Bin Weevils,6429,0,0,0,0,0,0,0
Temple University Fox School of Business,6547,0,0,0,0,0,0,0
Wetherly Fashion Group,6604,0,0,0,0,0,0,0
Perfetti Van Melle,6622,0,0,0,0,0,0,0
IMG Investment and Marketing Corporation,6686,0,0,0,0,0,0,0
DonorsChoose.org,5904,0,0,0,0,0,0,0
Leisure Pass Group,5922,0,0,0,0,0,0,0
4InkJets.com,5672,0,0,0,0,0,0,0
BDP,6021,0,0,0,0,0,0,0
"Jo-Ann Stores, Inc.",5589,7,0,1,8,0.875,0,0.125
America's Drive-In Brand Properties LLC,6022,0,0,2,2,0,0,1
Hostway Corporation,5957,0,0,0,0,0,0,0
Puget Sound Energy,5722,0,0,0,0,0,0,0
America's Job Exchange,5454,0,0,1,1,0,0,1
American College of Education,6040,1,0,1,2,0.5,0,0.5
Bosley,5971,0,1,0,1,0,1,0
"Syracuse Pro Sports, LLC",5604,0,0,0,0,0,0,0
wsgame.com,5607,0,0,0,0,0,0,0
Tarot.com,6107,0,0,0,0,0,0,0
Patch,6308,0,0,0,0,0,0,0
Gatlinburg Chamber of Commerce,6272,0,0,0,0,0,0,0
SodaHead.com,6275,0,0,0,0,0,0,0
Condé Nast,6357,5,0,9,14,0.357142857,0,0.642857143
Daisy Brand,6422,2,0,1,3,0.666666667,0,0.333333333
PhotoCardsDirect,6472,0,0,0,0,0,0,0
Sunstone Circuits,6476,1,0,0,1,1,0,0
Desert Auto Group,6608,0,0,0,0,0,0,0
Syracuse University,6625,0,0,0,0,0,0,0
William Jessup University,6690,0,0,0,0,0,0,0
Jewelers Mutual Insurance Company,6643,0,0,5,5,0,0,1
"Mindspark Interactive Network, Inc.",5608,107,7,13,127,0.842519685,0.05511811,0.102362205
Toyota Dealer Associations of America,5742,177,32,29,238,0.743697479,0.134453782,0.121848739
Dominican University of California,6110,0,0,0,0,0,0,0
Publix Asset Management Company,6112,6,0,0,6,1,0,0
Fab.com,6235,0,0,0,0,0,0,0
Fastaff,6271,0,0,0,0,0,0,0
Computer Sciences Corp,6276,0,0,0,0,0,0,0
Wheel Works,6546,0,0,0,0,0,0,0
WealthyMen.com,6469,0,0,0,0,0,0,0
AthletiCo,6471,0,0,0,0,0,0,0
G.L. Homes,6603,0,0,1,1,0,0,1
AirAsiaRedTix.com,6678,0,0,0,0,0,0,0
Hilex Poly,6639,0,0,0,0,0,0,0
"Intendis, Inc.",6646,0,0,0,0,0,0,0
Tax Relief Center,5307,0,0,0,0,0,0,0
BNP Paribas Open,6029,0,0,0,0,0,0,0
Capital Sports & Entertainment Inc.,5450,0,0,0,0,0,0,0
Firethorn Mobile,6093,0,0,0,0,0,0,0
iDateAsia.com,5050,1,0,0,1,1,0,0
MIss Matched Inc,5457,0,0,0,0,0,0,0
NewBridge Bank,6043,0,0,0,0,0,0,0
U.S. Food and Drug Administration,6161,2,0,0,2,1,0,0
Orlando Ballet,6111,0,0,0,0,0,0,0
Doll Hospital & Toy Soldier Shop,6236,0,0,0,0,0,0,0
Fort Wayne Newspapers,6261,0,0,0,0,0,0,0
Builder’s Surplus,6279,0,0,0,0,0,0,0
"Full Compass Systems, LTD.",6354,4,0,0,4,1,0,0
Spark Project,6418,0,0,0,0,0,0,0
"WarmlyYours, Inc.",6536,0,0,0,0,0,0,0
Inuvo,6468,0,0,0,0,0,0,0
Saul Ewing LLP,6554,0,0,0,0,0,0,0
Venus Fashion,6479,0,0,0,0,0,0,0
WJXT-Channel 4,6647,0,0,1,1,0,0,1
University of Cincinnati,6423,0,0,0,0,0,0,0
Excela Health,6459,0,0,1,1,0,0,1
InFocus Corporation,6559,0,0,0,0,0,0,0
"StreetAuthority, LLC.",6609,5,0,0,5,1,0,0
Service Experts LLC,6623,0,0,0,0,0,0,0
Lillian Vernon Corporation,6624,1,0,0,1,1,0,0
Food Lion,6691,0,0,0,0,0,0,0
Anilta Corporation,5663,0,0,0,0,0,0,0
"Proxy, LLC",5295,0,0,0,0,0,0,0
Franklin University,5580,1,0,0,1,1,0,0
"Capcom Entertainment, Inc.",6014,0,0,0,0,0,0,0
CustomizedGirl,5297,0,0,0,0,0,0,0
"Bluefly, Inc.",5161,0,0,0,0,0,0,0
Warby Parker,5946,0,0,0,0,0,0,0
Lyris Inc.,5948,0,0,0,0,0,0,0
Axway,5448,0,0,0,0,0,0,0
Preferred Penny Stocks,6033,0,0,0,0,0,0,0
DoubleStar,6097,1,0,0,1,1,0,0
Barksdale Theatre,6099,0,0,0,0,0,0,0
Nutter McClennen & Fish LLP,5731,0,0,0,0,0,0,0
Webster Bank,6048,0,0,0,0,0,0,0
"Webs, Inc.",6165,0,0,0,0,0,0,0
North Shore Medical Center,6063,0,0,1,1,0,0,1
"POM Wonderful, LLC",6333,0,0,0,0,0,0,0
Unitek College,6282,0,0,0,0,0,0,0
"AVS Forum.com, Inc.",6365,0,0,0,0,0,0,0
Silhouette at 4S Ranch,6414,0,0,0,0,0,0,0
Drake University Athletics,6431,0,0,0,0,0,0,0
American Ratings Corporation,6550,1,0,1,2,0.5,0,0.5
Burt's Bees,6467,1,0,0,1,1,0,0
National Australia Bank Limited,6565,0,0,0,0,0,0,0
Lady Gaga X Terry Richardson Photo Book,6614,0,0,0,0,0,0,0
Pan Pacific Hotels and Resorts,6682,0,0,0,0,0,0,0
Brandsclub,6699,0,0,0,0,0,0,0
Linden Lab,5371,0,0,0,0,0,0,0
RK TShirts,5372,5,0,1,6,0.833333333,0,0.166666667
"Deltek, Inc.",5640,0,0,0,0,0,0,0
Von Maur,5286,0,0,0,0,0,0,0
Epilog Laser,5654,1,0,0,1,1,0,0
Hazelden,4968,1,0,0,1,1,0,0
"Lamplighter Publishing, LLC",5657,0,0,0,0,0,0,0
Group Pty Ltd,5303,0,0,0,0,0,0,0
Aspect Software,5939,0,0,0,0,0,0,0
Cleveland Pops Orchestra,5304,0,0,1,1,0,0,1
Career Learning Centers,5940,0,0,0,0,0,0,0
Silver Cross Hospital,5590,0,0,0,0,0,0,0
OtterBox,5453,0,0,0,0,0,0,0
Redfin,5053,0,0,0,0,0,0,0
Wheeler Mission Ministries,5739,0,0,0,0,0,0,0
Shadow Men,5740,0,0,0,0,0,0,0
Islamic Relief,6108,0,0,0,0,0,0,0
LeadRival.com,6057,0,0,0,0,0,0,0
The John F. Kennedy Center for the Performing Arts,6121,0,0,0,0,0,0,0
Park 'N Fly,6125,0,0,0,0,0,0,0
OfficeFurniture2go.com,6239,0,0,0,0,0,0,0
Longchamp,6240,0,0,0,0,0,0,0
STACK,6257,0,0,1,1,0,0,1
The Jewish Museum,6258,0,0,0,0,0,0,0
ATB Financial,6322,0,0,0,0,0,0,0
GenoVive,6325,0,0,0,0,0,0,0
Viddler,6339,0,0,0,0,0,0,0
Mabel's Labels,6389,0,0,0,0,0,0,0
Austin City Limits Live,6358,0,0,0,0,0,0,0
American Heritage Schools,6372,0,0,0,0,0,0,0
TicketReturn,6425,0,0,0,0,0,0,0
Home Reserve,6458,0,0,0,0,0,0,0
Virginia Mason Medical Center,6540,0,0,0,0,0,0,0
Richmond CenterStage,6558,0,0,0,0,0,0,0
"Home Box Office, Inc. (HBO)",6607,7,0,15,22,0.318181818,0,0.681818182
Des Moines Community Playhouse,6676,0,0,0,0,0,0,0
Hawaiian Beach Rentals,6640,0,0,0,0,0,0,0
Alegent Health,4913,0,0,0,0,0,0,0
Fairleigh Dickinson University,5196,0,0,0,0,0,0,0
Similasan Corporation,5311,3,0,3,6,0.5,0,0.5
BeenVerified.com,5079,0,0,0,0,0,0,0
United States Coast Guard,4577,0,0,1,1,0,0,1
Paul Fredrick,4579,1,0,0,1,1,0,0
Total Attorneys,5750,0,0,0,0,0,0,0
Sal Vapiano,1818,0,0,0,0,0,0,0
University of Illinois,6168,0,0,0,0,0,0,0
Amica Mutual Insurance Company,4258,1,0,0,1,1,0,0
MTD Products Inc.,6443,0,0,0,0,0,0,0
Crunchyroll,4594,1,0,0,1,1,0,0
DreamWorks,1835,0,0,0,0,0,0,0
Dolce & Gabbana,1837,2,1,2,5,0.4,0.2,0.4
Clarín.com,4275,0,0,0,0,0,0,0
Phoenix Children's Hospital,5754,0,0,0,0,0,0,0
Savannah Area Chamber of Commerce,6442,0,0,0,0,0,0,0
"OriginOil, Inc.",5111,0,0,0,0,0,0,0
Entertainment Weekly Inc.,4709,0,0,0,0,0,0,0
Strategy First,6172,0,0,0,0,0,0,0
"NGames Co., Ltd.",5628,1,0,8,9,0.111111111,0,0.888888889
The Arizona Daily Star,5989,1,0,0,1,1,0,0
Epson America,2907,0,0,2,2,0,0,1
"McNEIL-PPC, Inc.",6138,5,3,8,16,0.3125,0.1875,0.5
"Gold & Silver, Inc",5011,0,0,0,0,0,0,0
The Independent Traveler,2924,0,0,1,1,0,0,1
Another Happy Day Movie,5481,0,0,0,0,0,0,0
One for the Money Movie,3709,0,0,0,0,0,0,0
Million Dollar Media,5562,0,0,0,0,0,0,0
Stanley Steemer International,2939,3,1,1,5,0.6,0.2,0.2
Columbia Sportswear,2958,24,4,0,28,0.857142857,0.142857143,0
Israel Ministry of Tourism,5696,0,0,0,0,0,0,0
Cogswell Polytechnical College,5028,0,0,0,0,0,0,0
Shaadi.com Matrimonials,5496,4,0,0,4,1,0,0
NitroPlanes.com,4743,0,0,0,0,0,0,0
DailyGroceryCoupon.com,5130,0,0,0,0,0,0,0
"Elan Pharmaceuticals, Inc",5345,3,1,5,9,0.333333333,0.111111111,0.555555556
Expect More Arizona,5428,0,0,0,0,0,0,0
Sena Technologies,5862,0,0,0,0,0,0,0
FunnelBrain,5043,0,0,0,0,0,0,0
Centrify Corporation,5630,0,0,0,0,0,0,0
Stanford University,5045,4,0,0,4,1,0,0
JA Cosmetics Corp.,5277,0,0,0,0,0,0,0
The Frye Company,6136,1,0,1,2,0.5,0,0.5
Westec,6291,0,0,0,0,0,0,0
Warren Miller,6447,0,0,0,0,0,0,0
Credit Union of Texas,6167,0,0,0,0,0,0,0
"Group Voyagers, Inc.",5751,0,0,0,0,0,0,0
NuGo Nutrition,6455,1,0,0,1,1,0,0
Kazaa,6441,0,0,0,0,0,0,0
"Microtel Inns and Suites Franchising, Inc.",6452,1,1,0,2,0.5,0.5,0
Artists Repertory Theatre,5987,0,0,0,0,0,0,0
"Cephalon, Inc.",5983,0,1,0,1,0,1,0
Mitsubishi Electric and Electronics,6438,0,0,0,0,0,0,0
LavaPlace.com,6453,0,0,0,0,0,0,0
"DataXu, Inc.",6185,0,0,0,0,0,0,0
Zurich American Insurance Company,6437,0,0,0,0,0,0,0
PCUtilitiesPro.com,5752,1,0,0,1,1,0,0
Exclusively Weddings,5996,1,1,0,2,0.5,0.5,0
easyJet Airline Company,6755,0,0,0,0,0,0,0
Goodman Theatre,6006,0,0,0,0,0,0,0
"McCormick & Schmick’s Seafood Restaurants, Inc. ",5993,13,0,0,13,1,0,0
TapJoint,6187,0,0,0,0,0,0,0
Newport News,6764,0,0,0,0,0,0,0
Michigan Economic Development Corporation,6292,0,0,0,0,0,0,0
EMC Corporation,6169,0,0,0,0,0,0,0
Car Care Council,6147,0,0,0,0,0,0,0
WeWOOD,6173,0,0,0,0,0,0,0
Girl Scouts of North East Ohio,6870,0,0,0,0,0,0,0
The Port of Seattle,6869,1,0,3,4,0.25,0,0.75
MicroSpec Systems,5982,0,0,0,0,0,0,0
SpreadsheetGear,6192,0,0,0,0,0,0,0
"Arctic Ease, LLC.",6184,0,0,0,0,0,0,0
The Sportsman's Guide,5981,55,31,0,86,0.639534884,0.360465116,0
Sonesta International Hotels Corporation,6142,0,0,0,0,0,0,0
"Slingshot SEO, Inc.",6883,0,0,0,0,0,0,0
TITAN Technology Partners,6887,0,0,0,0,0,0,0
National Retail Federation,6003,0,0,0,0,0,0,0
Eya,6286,0,0,1,1,0,0,1
B&H Education Inc.,6882,0,0,0,0,0,0,0
Magic Theatre,6881,0,0,0,0,0,0,0
Heifer International,6756,3,1,0,4,0.75,0.25,0
American University,5994,1,0,0,1,1,0,0
Nationwide Children's Hospital,6149,0,0,0,0,0,0,0
Richmond Ballet,6457,0,0,0,0,0,0,0
G Adventures,6293,0,0,0,0,0,0,0
"Crystal Mountain, Inc.",6151,0,0,0,0,0,0,0
THE COLLECTION Porsche,6483,2,0,6,8,0.25,0,0.75
My Plates,6765,0,0,0,0,0,0,0
Ingles Performance,6489,0,0,0,0,0,0,0
Prophet,6198,0,0,0,0,0,0,0
Financial Inquire.com,6759,0,0,0,0,0,0,0
Christian Community Credit Union,6288,0,0,0,0,0,0,0
StudentUniverse,6783,0,0,0,0,0,0,0
Alaska Travel Industry Association,6891,1,0,0,1,1,0,0
Institute of Technology (California),6702,0,0,0,0,0,0,0
Lifestyle Trends,6880,0,0,0,0,0,0,0
Omsi,6287,0,0,0,0,0,0,0
Gardner-White Furniture,6302,0,0,0,0,0,0,0
Heathrow Express,6897,0,0,0,0,0,0,0
Charter Oak State College,6703,0,0,1,1,0,0,1
Carpet Mill Outlet,6888,0,0,0,0,0,0,0
Iowa State University,6202,1,0,0,1,1,0,0
Almaden Valley Athletic Club,6194,0,0,0,0,0,0,0
University Book Store,6770,0,0,0,0,0,0,0
Lab Series Skincare for Men,6141,0,0,0,0,0,0,0
Ohlone College,6294,0,0,0,0,0,0,0
National Film Board of Canada,6304,0,0,0,0,0,0,0
CHG Management,6956,1,0,0,1,1,0,0
"BlackRock, Inc.",6877,1,0,3,4,0.25,0,0.75
Party World,6152,0,0,0,0,0,0,0
IMO'S Pizza,6771,0,0,0,0,0,0,0
State of Utah,6204,0,0,0,0,0,0,0
Fair Energy Rate Action Fund,6708,0,0,0,0,0,0,0
Avalon Communities,7020,0,0,3,3,0,0,1
The Bump Baby Shop,6005,0,0,0,0,0,0,0
IronStratus,6715,0,0,0,0,0,0,0
Porter Airlines,6196,49,0,0,49,1,0,0
Seattle Opera,6449,0,0,0,0,0,0,0
Brand.LIVE,6706,0,0,0,0,0,0,0
DRG,6711,1,0,1,2,0.5,0,0.5
CyberKnife Center,6301,0,0,0,0,0,0,0
"MLB Advanced Media, L.P.",6153,5,0,2,7,0.714285714,0,0.285714286
Boys & Girls Clubs of America,7029,1,0,0,1,1,0,0
Kaplan Development Group,6894,0,0,0,0,0,0,0
BroBible.com,6957,0,0,0,0,0,0,0
Download-21.com,6896,3,0,0,3,1,0,0
ESTsoft,6958,0,0,0,0,0,0,0
"One Medical Group, Inc.",6504,0,0,0,0,0,0,0
"Regent Hospitality Worldwide, Inc.",6868,0,0,0,0,0,0,0
New York Road Runners Inc.,7021,0,0,0,0,0,0,0
Canonica,6191,0,0,0,0,0,0,0
Interspire,6717,0,0,0,0,0,0,0
"Howard Johnson International, Inc.",6156,0,0,0,0,0,0,0
QuickSmart,6895,0,0,0,0,0,0,0
Pogo Linux,6983,0,0,0,0,0,0,0
Postcard Inn,6492,0,0,0,0,0,0,0
S&T Bank,6922,0,0,1,1,0,0,1
Confirio,6482,0,0,0,0,0,0,0
Peju Province Winery,6207,0,0,0,0,0,0,0
King College,6985,0,0,0,0,0,0,0
Chilton Hospital,6789,0,0,0,0,0,0,0
Title Nine,6705,0,0,0,0,0,0,0
Dallas Film Society,6962,0,0,0,0,0,0,0
Birks & Mayors,6919,0,0,0,0,0,0,0
Loma Linda University Medical Center,7051,0,0,0,0,0,0,0
PFIP,6963,2,1,0,3,0.666666667,0.333333333,0
ServiceMax,6774,0,0,0,0,0,0,0
CFIP,6793,0,0,0,0,0,0,0
Carnegie Hall Corporation,5998,0,0,0,0,0,0,0
Kendall-Jackson Winery,6794,0,0,0,0,0,0,0
U.S. Virgin Islands Department of Tourism,6201,0,0,0,0,0,0,0
twofour54 FZ-LLC,6496,0,0,0,0,0,0,0
Greater Saint Charles CVB,6920,0,0,0,0,0,0,0
Mackage.com,6767,0,0,0,0,0,0,0
INTEGRIS Health,6885,0,0,0,0,0,0,0
Wintergreen Resort,6305,1,0,0,1,1,0,0
Ecom Holdings Pty,6732,1,0,0,1,1,0,0
Inacan Concepts,6766,0,0,0,0,0,0,0
CarHop,6903,0,0,0,0,0,0,0
Tourisme Mont-Tremblant,6491,0,0,2,2,0,0,1
BidSync,6150,0,0,0,0,0,0,0
Walter Knoll Florist,6219,0,0,0,0,0,0,0
"AbsolutelyNew, Inc.",6797,0,0,0,0,0,0,0
NTT DATA Corporation,6905,0,0,0,0,0,0,0
"Soaring Adventures of America, Inc.",6925,0,0,0,0,0,0,0
BlackRapid Inc.,6912,0,0,0,0,0,0,0
Optimum,6206,39,13,14,66,0.590909091,0.196969697,0.212121212
farkitrol.com,6518,0,0,1,1,0,0,1
BookBaby,6787,0,0,0,0,0,0,0
All Season Solar Cooker,6210,0,0,0,0,0,0,0
Estate Buyers of America,6910,0,0,0,0,0,0,0
New Jersey Devils,6734,0,0,0,0,0,0,0
The Copia,6522,0,0,0,0,0,0,0
uBid.com,6220,0,0,0,0,0,0,0
Cinetic Rights Management,6719,0,0,0,0,0,0,0
American Lung Association,7104,0,0,0,0,0,0,0
"Lumension Security, Inc.",6926,0,3,0,3,0,1,0
Aero-Stream,6931,0,0,0,0,0,0,0
Winter Sports Inc.,7002,0,0,0,0,0,0,0
Bell & Ross,7024,0,0,0,0,0,0,0
OpenGate Software,6923,0,0,0,0,0,0,0
Choice Hotels Canada,7043,0,0,0,0,0,0,0
TheGreensheet.com,7253,0,0,0,0,0,0,0
Roca Labs,6503,4,0,0,4,1,0,0
Arbor Homes,6709,0,0,0,0,0,0,0
Tophatter,6226,5,1,0,6,0.833333333,0.166666667,0
"Gorton's, Inc.",6792,0,0,0,0,0,0,0
Remuda Ranch,6950,0,0,0,0,0,0,0
Animoto Productions,6971,1,0,0,1,1,0,0
Kendall College,6506,0,0,0,0,0,0,0
BetterWorks,6906,0,0,0,0,0,0,0
"Department of Culture, Recreation & Tourism",6066,0,0,0,0,0,0,0
Green Dot Corporation,7117,1,0,0,1,1,0,0
Opportunities Unified,7072,0,0,0,0,0,0,0
"Clear Channel Broadcasting, Inc.",6513,2,0,3,5,0.4,0,0.6
Tournament Players Club,7039,2,0,0,2,1,0,0
International Sportsmen's Expositions,6788,0,0,0,0,0,0,0
Pharmvite,6298,0,0,0,0,0,0,0
Sunset Porsche,6806,0,0,0,0,0,0,0
Living Sober,6205,0,0,0,0,0,0,0
Florida RV Trade Association,6720,0,0,0,0,0,0,0
Northwestern University School of Continuing Studies,6834,0,0,0,0,0,0,0
Miami City Ballet,6724,0,0,0,0,0,0,0
The Fresh Diet,6938,0,0,0,0,0,0,0
The Howard Hughes Corporation,6782,0,0,0,0,0,0,0
President’s Choice Financial,7094,0,0,1,1,0,0,1
International Paper Company,7268,0,0,0,0,0,0,0
Tires Plus Total Car Care,6977,1,0,0,1,1,0,0
Paul Cerame Auto Group,6969,0,0,0,0,0,0,0
Radiomasha,7055,0,0,0,0,0,0,0
Einstein Healthcare Network,7045,0,0,0,0,0,0,0
Touro,6216,0,0,0,0,0,0,0
Qdoba Restaurant Inc.,6940,0,0,0,0,0,0,0
Vanguard Properties,6909,0,0,0,0,0,0,0
EF Cultural Trave,6819,0,0,0,0,0,0,0
Christie's,6221,0,0,0,0,0,0,0
California State Treasurer's Office,6990,0,0,0,0,0,0,0
"Steiner Beauty Products, Inc.",6982,0,0,0,0,0,0,0
Sundance Institute,6306,1,0,0,1,1,0,0
Bossa Nova Robotics,7091,0,0,0,0,0,0,0
Quinnipiac University,6930,0,0,0,0,0,0,0
Starfall Education,6200,0,0,1,1,0,0,1
La Salle University,7056,3,0,1,4,0.75,0,0.25
Detroit Media Partnership,7173,0,0,0,0,0,0,0
Lahey Clinic Foundation,7092,0,0,0,0,0,0,0
Wilsonart International,6949,0,0,0,0,0,0,0
Pacific Sales,6813,0,0,0,0,0,0,0
Lancaster Colony Corporation,6728,3,0,1,4,0.75,0,0.25
"Etsy, Inc.",7027,0,0,6,6,0,0,1
Just A Game GmbH,6941,2,0,0,2,1,0,0
JLM Couture,7063,2,0,3,5,0.4,0,0.6
Eagle Creek Academy,7061,0,0,0,0,0,0,0
Florida Dental Implants and Oral Surgery,6974,0,0,0,0,0,0,0
Cloudsleuth,6814,0,0,0,0,0,0,0
Chili Entertainment,6083,0,0,0,0,0,0,0
"Aaron's, Inc",6747,0,0,0,0,0,0,0
KEF Direct,6994,0,0,0,0,0,0,0
TradeKing Group,7059,0,0,2,2,0,0,1
Dr. Wade Barker,6745,0,0,0,0,0,0,0
Sytosoft Corporation,6951,0,0,0,0,0,0,0
Cherry Bekaert & Holland,6987,0,0,0,0,0,0,0
Highland Homes,6738,1,1,0,2,0.5,0.5,0
BlogHer,7111,0,0,0,0,0,0,0
"Jinx, Inc.",7136,0,0,1,1,0,0,1
First Niagara Financial Group,6741,0,0,0,0,0,0,0
Life Time Fitness Inc.,6935,0,0,0,0,0,0,0
Earlez Grille,7188,0,0,0,0,0,0,0
Georg Jensenhe Convention & Visitors Bureau,7190,0,0,0,0,0,0,0
123RF Limited,7089,14,0,0,14,1,0,0
Pear Tree Greetings,6516,0,0,0,0,0,0,0
JWG Judaica and Dead Sea Cosmetics,7081,0,0,0,0,0,0,0
CruiseOne,6829,0,0,0,0,0,0,0
Carolinas HealthCare System,7177,0,0,0,0,0,0,0
Wolters Kluwer Health,7169,0,0,0,0,0,0,0
A. B. Coleman Mortuary,7283,0,0,0,0,0,0,0
"Weiss, Savedoff & Ciccone",6924,0,0,0,0,0,0,0
UW World Series,6744,0,0,0,0,0,0,0
swim-fitness.com,6085,0,0,0,0,0,0,0
American Sentinel University,7099,0,0,0,0,0,0,0
ClearWay Minnesota,6785,0,0,0,0,0,0,0
Jack Frost Big Boulder Ski Area,7042,0,0,0,0,0,0,0
Villas IP,7114,0,0,0,0,0,0,0
eNom Inc.,6735,0,0,0,0,0,0,0
"Fishkind, Bakewell and Maltzman Eyecare and Surgery Center",7053,0,0,0,0,0,0,0
Clearview Federal Credit Union,7300,1,0,0,1,1,0,0
gift-rewardcentral.com,7182,0,0,0,0,0,0,0
Ritz Interactive,7010,0,0,0,0,0,0,0
EHM Productions,6228,0,0,0,0,0,0,0
Surprise Phase,6816,0,0,0,0,0,0,0
GovDelivery,6509,0,0,0,0,0,0,0
Simon G,6845,1,0,0,1,1,0,0
Petroglyph Games,6743,0,0,0,0,0,0,0
Cartridge World,6224,0,0,0,0,0,0,0
IR Solutions LLC,6498,0,0,0,0,0,0,0
Prometheus Laboratories,7062,0,0,0,0,0,0,0
Great Glam,7008,0,0,0,0,0,0,0
"ProCure Treatment Centers, Inc.",7265,1,0,1,2,0.5,0,0.5
Floor and Decor Outlets of America Inc.,7287,0,0,0,0,0,0,0
Baxter Auto Stores,6966,0,0,0,0,0,0,0
Bally Shoe Factories,6809,0,0,0,0,0,0,0
Bonne Terre Limited,6824,0,0,0,0,0,0,0
Mattress City,7067,0,0,0,0,0,0,0
Pharmacy Discount Network,7272,0,0,0,0,0,0,0
NovaStor,6915,0,0,0,0,0,0,0
Teradata Corporation,7468,0,0,0,0,0,0,0
Wilson Lighting,6074,0,0,0,0,0,0,0
Perfect North Slopes,6810,0,0,0,0,0,0,0
TAG Oil Ltd,6854,0,0,0,0,0,0,0
Popcorn Palace,7080,0,0,0,0,0,0,0
The Watch Avenue,7250,0,0,0,0,0,0,0
"VISIT DENVER, The Convention & Visitors Bureau",7191,0,0,0,0,0,0,0
Aico’s Dental Group,7295,0,0,0,0,0,0,0
"Z Gallerie, Inc.",5753,0,0,0,0,0,0,0
Akron-Canton Airport,7388,0,0,1,1,0,0,1
SPEER Laboratories,6171,0,0,0,0,0,0,0
Photo File,7271,0,0,0,0,0,0,0
"TaxHawk, Inc.",7252,0,0,0,0,0,0,0
Alexander Wang,6070,0,0,0,0,0,0,0
Columbus Bicentennial,6846,0,0,0,0,0,0,0
ZocDoc,6748,0,0,0,0,0,0,0
Mission Federal Credit Union,6826,0,0,1,1,0,0,1
Drafthouse Films,7289,0,0,0,0,0,0,0
Smooth Fitness,7140,0,0,0,0,0,0,0
Eden Foods,7195,0,0,0,0,0,0,0
Camden Property Trust,6864,3,0,0,3,1,0,0
Charlotte Collegiate Football,6861,0,0,0,0,0,0,0
The Iowa Fund - Support Herman Cain,7260,0,0,0,0,0,0,0
ACIR,7387,0,0,0,0,0,0,0
Mootlie.com,7258,0,0,0,0,0,0,0
FIJI Water Company,6968,0,0,0,0,0,0,0
MyOutdoorTV.com,7391,0,0,0,0,0,0,0
John Galt Refining,7399,0,0,0,0,0,0,0
International Diamond Center,7088,0,0,0,0,0,0,0
U.S. Department of Transportation,7390,6,0,0,6,1,0,0
Lexapro Attorneys,7731,0,0,0,0,0,0,0
National WWII Museum,7141,0,0,1,1,0,0,1
Valley Medical Center,6992,0,0,0,0,0,0,0
FYYGame.com,7466,0,0,0,0,0,0,0
Cupid plc.,7142,7,0,1,8,0.875,0,0.125
Sulekha.com,7116,0,0,0,0,0,0,0
State of Connecticut,6213,0,0,0,0,0,0,0
BostonTheatreScene.com,7397,0,0,0,0,0,0,0
Polar Generation,6932,0,0,0,0,0,0,0
America Wants You,6838,0,0,0,0,0,0,0
Protect Your Home,7280,0,0,0,0,0,0,0
Established Men,7060,0,0,0,0,0,0,0
The Shadow Gang,7064,0,0,0,0,0,0,0
"McAfee, Inc.",7282,33,39,1,73,0.452054795,0.534246575,0.01369863
LiquidMedia Networks,6523,0,0,0,0,0,0,0
Nevada Mining Association,7533,0,0,0,0,0,0,0
Samy's Camera,7049,0,0,0,0,0,0,0
St. John Knits,6750,0,0,0,0,0,0,0
Alcance Media Group,7174,0,0,0,0,0,0,0
BAO Productions,7118,0,0,0,0,0,0,0
Great Steaks and More,7733,0,0,0,0,0,0,0
Pennsylvania Department of Transportation,6817,0,0,0,0,0,0,0
"JOYMAX.CO.,LTD.",6528,0,0,0,0,0,0,0
InCharge Debt Solutions,7270,0,0,0,0,0,0,0
Fort Worth Convention & Visitors Bureau,6749,0,0,0,0,0,0,0
Conseil Interprofessionnel du Vin de Bordeaux (CIVB),7241,0,0,1,1,0,0,1
"OpticsPlanet, Inc.",7274,11,0,0,11,1,0,0
Golf Town,7018,0,0,0,0,0,0,0
Fuse.tv,7242,0,0,0,0,0,0,0
The Bravern,6821,0,0,0,0,0,0,0
Fiesta Bowl,7194,1,1,0,2,0.5,0.5,0
South Coast Repertory,6082,0,0,0,0,0,0,0
"Heartland Payment Systems, Inc.",6530,0,0,0,0,0,0,0
Republic of Turkey Ministry of Culture and Tourism,7110,0,0,0,0,0,0,0
Orlando Shakespeare Theater,7395,0,0,0,0,0,0,0
Ignatius Press,7144,1,0,1,2,0.5,0,0.5
Rodale Institute,7728,0,0,0,0,0,0,0
California Chemical Dependency Counseling,7189,0,0,0,0,0,0,0
Las Vegas Review-Journal,7462,0,0,1,1,0,0,1
Zara,7017,0,0,0,0,0,0,0
Mountain Lumber Company,6742,1,0,0,1,1,0,0
VoiceQuilt,6830,0,0,0,0,0,0,0
Essie,7074,0,0,0,0,0,0,0
Parellels,7134,0,0,0,0,0,0,0
Minnesota Orchestral Association,6827,0,0,0,0,0,0,0
Mountain High Yoghurt,7121,0,0,0,0,0,0,0
Maryland E-ZPass,6842,0,0,0,0,0,0,0
Unrabble,7123,0,0,0,0,0,0,0
CrownPeak Inc.,7278,0,0,0,0,0,0,0
Arizona Renaissance Festival,6849,0,0,0,0,0,0,0
"DC Shoes, Inc.",7285,0,0,0,0,0,0,0
Consumers Credit Union,7385,1,0,0,1,1,0,0
Studio East,7135,0,0,0,0,0,0,0
Paradisus Resorts,6856,0,0,0,0,0,0,0
Depositphotos Inc.,7292,1,0,0,1,1,0,0
KegWorks.com,6852,0,0,0,0,0,0,0
O'Neil,7386,0,0,0,0,0,0,0
Parts Express,7145,0,0,0,0,0,0,0
Papillon Grand Canyon Helicopters,7087,0,0,0,0,0,0,0
Kent State University,7735,0,0,0,0,0,0,0
Oklahoma Energy Resources Board,7299,0,0,0,0,0,0,0
HearUSA,6863,0,0,0,0,0,0,0
etrailer,6753,1,0,0,1,1,0,0
ComponentOne,7128,0,0,0,0,0,0,0
SpecialSavings.com,7463,0,0,0,0,0,0,0
Canadian Cancer Society,7132,0,0,0,0,0,0,0
"McCormick & Company, Inc.",7531,9,7,4,20,0.45,0.35,0.2
Newsday,6285,0,0,0,0,0,0,0
PrintCouponsNow.net,7296,0,0,0,0,0,0,0
WorldRemit.com,6762,0,0,0,0,0,0,0
"PennyGrab, Inc.",7298,0,0,0,0,0,0,0
Greenwich Jewelers,7734,3,0,0,3,1,0,0
Colorado Christian University,6862,0,0,0,0,0,0,0
Nadex,7398,0,0,0,0,0,0,0
Simms Furniture,7530,1,0,0,1,1,0,0
Theory Chicago,7532,0,0,0,0,0,0,0
The Lean Startup,7725,0,0,0,0,0,0,0
Country Music Association,6953,0,0,0,0,0,0,0
John Walker & Sons,6955,0,0,2,2,0,0,1
"Brookfield Capital Partners, LLC",6494,0,0,0,0,0,0,0
Fair Trade USA,7023,0,0,0,0,0,0,0
Colorado Springs Utilities,6964,0,0,0,0,0,0,0
AMResorts,7028,2,0,0,2,1,0,0
HealthBridge Management,6921,1,0,0,1,1,0,0
"Wistia, Inc.",6796,3,0,0,3,1,0,0
SCG Power Rangers,7096,0,0,0,0,0,0,0
Li-Ning,6730,0,0,0,0,0,0,0
The Washington Examiner,6989,0,0,0,0,0,0,0
BadCreditOffers.com,6519,0,0,0,0,0,0,0
Liberty Trading Group,6521,0,0,0,0,0,0,0
The Repertory Theatre of St. Louis,6996,0,0,1,1,0,0,1
Automatic Data Processing (ADP),7187,0,0,0,0,0,0,0
The Village of Burr Ridge Hotels,7255,0,0,0,0,0,0,0
Groove Stream,7262,0,0,0,0,0,0,0
GMI,7196,0,0,0,0,0,0,0
Unique Air Services,7396,0,0,0,0,0,0,0
HA North American Sales AB,7464,0,0,0,0,0,0,0
Studio Center Corporation,6382,0,0,0,0,0,0,0
Ebates Performance Marketings,6131,0,0,0,0,0,0,0
"Kiss Products, Inc.",6133,0,0,0,0,0,0,0
Alacer,6448,3,2,0,5,0.6,0.4,0
"GolfSwitch, Inc.",6450,0,0,0,0,0,0,0
Derma E Natural Bodycare,6867,0,0,0,0,0,0,0
GameTap LLC.,6180,0,0,0,0,0,0,0
AllHealthcareJobs.com,5999,0,0,0,0,0,0,0
DegreePath.com,6701,0,0,0,0,0,0,0
Ross-Simons,6484,0,0,0,0,0,0,0
Denver Post Community,6899,0,0,0,0,0,0,0
Alpha Media Group,6901,0,0,0,0,0,0,0
Marine Products Pro Shop,6497,0,0,0,0,0,0,0
Donors Trust,6916,1,1,0,2,0.5,0.5,0
United States Gypsum Company,6718,0,0,0,0,0,0,0
Allure Las Vegas,7033,0,0,0,0,0,0,0
Detroit Lions,6933,0,0,0,0,0,0,0
"Spring Metrics, Inc.",7052,0,0,0,0,0,0,0
"French West, Inc.",6514,0,0,0,0,0,0,0
American Booksellers Association,6733,0,0,0,0,0,0,0
Korman Communities,7101,0,0,0,0,0,0,0
Rugged Races,7001,0,0,0,0,0,0,0
The Colorado Cyclist Inc,7069,0,0,0,0,0,0,0
Moguldom Media Group,6818,1,0,2,3,0.333333333,0,0.666666667
Above It All Treatment,6065,0,0,0,0,0,0,0
The Fruit Company,6835,0,0,0,0,0,0,0
Eisai Inc.,7269,0,0,0,0,0,0,0
Atlantic Florida Dental,6848,0,0,0,0,0,0,0
"Western Union Holdings, Inc.",7316,68,13,1,82,0.829268293,0.158536585,0.012195122
Brett/Robinson,7467,0,0,0,0,0,0,0
Forgotten Harvest,7469,0,0,0,0,0,0,0
Ignite Game Technologies,7601,0,0,0,0,0,0,0
Gospel for Asia,6436,0,0,0,0,0,0,0
TRIBAL Hollywood,5986,0,0,0,0,0,0,0
Unicomm,6872,0,0,0,0,0,0,0
Mr. Rooter Corporation,6761,0,0,0,0,0,0,0
Agora Publishing,6879,0,0,0,0,0,0,0
San Diego Hospice and The Institute for Palliative Medicine,6193,0,0,0,0,0,0,0
Baker Publishing Group,6886,0,0,0,0,0,0,0
Luckie Enterprises,6947,0,0,0,0,0,0,0
Super ATV LLC.,6154,1,0,0,1,1,0,0
Summit Brewing Company,6493,0,0,0,0,0,0,0
The Foundry Studios,6961,0,0,0,0,0,0,0
American Council on Education & Lumina Foundation for Education,6911,0,0,0,0,0,0,0
e-Eighteen.com Ltd.,6722,0,0,0,0,0,0,0
Chevrolet Dealerships,6218,56,3,22,81,0.691358025,0.037037037,0.271604938
Iowa Public Television,7040,0,0,0,0,0,0,0
The Cabinet Spot,7047,0,0,0,0,0,0,0
"Gold’s Gym International, Inc.",6511,0,0,1,1,0,0,1
Blue Cross and Blue Shield of Louisiana,6986,0,0,0,0,0,0,0
Ipsos Interactive Services,6729,0,0,0,0,0,0,0
"Weplay, Inc.",7097,0,0,0,0,0,0,0
Premier Farnell,7054,0,0,0,0,0,0,0
University of Florida,6811,0,0,0,0,0,0,0
"Bear Naked, Inc.",7172,0,0,0,0,0,0,0
Portland State University,6997,0,0,0,0,0,0,0
DocsGolfTips.com,7065,1,0,0,1,1,0,0
Winkflash,7004,0,0,0,0,0,0,0
"Bumbleandbumble.Products, LLC",6529,0,0,0,0,0,0,0
Consejo de Promoción Turística de México,7247,0,0,0,0,0,0,0
Denver Museum of Nature & Science,7115,2,0,0,2,1,0,0
The Trustees of Indiana University,7015,0,0,0,0,0,0,0
Boston Ballet,6079,0,0,0,0,0,0,0
Circa Inc.,6847,0,0,0,0,0,0,0
DIYSEO,7290,0,0,0,0,0,0,0
University of San Francisco,7147,0,0,0,0,0,0,0
Dreamfields,5748,1,0,0,1,1,0,0
The Christ Hospital,5980,1,0,2,3,0.333333333,0,0.666666667
Go Ski WV,6182,0,0,0,0,0,0,0
Urban Outfitters,6148,0,0,1,1,0,0,1
Hornblower Cruises & Events,6297,0,0,0,0,0,0,0
Thundershirt,6965,0,0,0,0,0,0,0
OBOption.com,6716,0,0,0,0,0,0,0
Krewe of Orpheus,6967,0,0,0,0,0,0,0
Greektown Casino,6501,0,0,0,0,0,0,0
AnastasiaDate.com,6918,7,0,0,7,1,0,0
Second Harvest Food Bank,6214,0,0,0,0,0,0,0
FX Direct Dealer,7035,0,0,0,0,0,0,0
Register.com,6799,0,0,0,0,0,0,0
"Indiana Botanic Gardens, Inc.",6984,0,0,0,0,0,0,0
Teatro ZinZanni,6801,0,0,0,0,0,0,0
Compass Outreach Media,6731,9,1,3,13,0.692307692,0.076923077,0.230769231
Washington State Departments of Labor and Industries,7016,0,0,0,0,0,0,0
Miami Children's Hospital,7082,0,0,0,0,0,0,0
Holiday Travel,7084,0,0,0,0,0,0,0
Hansen's Clothing,6833,0,0,0,0,0,0,0
The Tech Museum,7267,0,0,0,0,0,0,0
The Resort at Glade Springs,7086,0,0,0,0,0,0,0
Paessler,6080,1,0,0,1,1,0,0
University of Massachusetts,7133,0,0,0,0,0,0,0
"Western Communications, Inc.",6850,0,0,0,0,0,0,0
Deep Silver Inc.,7284,0,0,0,0,0,0,0
RareDiamondAssets.com,7286,0,0,0,0,0,0,0
SiteScout Innovative Advertising Technology,6865,0,0,0,0,0,0,0
Soka University of America,6435,0,0,0,0,0,0,0
Hyatt Corporation,6135,63,3,8,74,0.851351351,0.040540541,0.108108108
Turnstone,6176,0,0,0,0,0,0,0
"Red Beacon, Inc.",6137,0,0,0,0,0,0,0
Volkswagen Dealerships,6873,40,1,9,50,0.8,0.02,0.18
[x]object Inc,6946,0,0,0,0,0,0,0
Gig City,6010,0,0,0,0,0,0,0
USA People Search,6303,0,0,0,0,0,0,0
Farm Bureau Financial Services,6780,0,0,0,0,0,0,0
Hofmeister Personal Jewelers,6212,0,0,0,0,0,0,0
Catholic Online,6978,0,0,1,1,0,0,1
MAX Workouts,6510,0,0,0,0,0,0,0
Tourisme Québec,6512,0,0,0,0,0,0,0
"Ruby Tuesday, Inc.",6937,0,0,0,0,0,0,0
Sound Components,6939,0,0,0,0,0,0,0
Firefly Studios,7171,0,0,0,0,0,0,0
Newman's Own,6812,0,0,0,0,0,0,0
Fertility Physicians of Northern California,7103,0,0,0,0,0,0,0
"Qualys, Inc.",6739,1,0,0,1,1,0,0
iYogi,7005,0,0,0,0,0,0,0
Pure Matters,7246,0,0,0,0,0,0,0
DSM Nutritional Products,7112,0,0,0,0,0,0,0
Knicks Store,7073,0,0,0,0,0,0,0
Crucon.com,7180,0,0,0,0,0,0,0
Solar Energy World,7078,0,0,0,0,0,0,0
Urban Decay Cosmetics,6078,0,0,0,0,0,0,0
Zinch Inc.,6837,0,0,0,0,0,0,0
"Etix, Inc.",6844,0,0,0,0,0,0,0
Mercury Casualty Company,7146,0,0,0,0,0,0,0
Abacus Data Systems,7148,0,0,0,0,0,0,0
Powells.com,6444,0,0,0,0,0,0,0
Lions Gate Entertainment,6144,0,0,0,0,0,0,0
Gulf Coast Regional Tourism Partnership,6146,1,0,0,1,1,0,0
Macerich,6203,1,1,0,2,0.5,0.5,0
Time4Learning.com,6712,1,0,0,1,1,0,0
Fusion9 Design,6973,0,0,0,0,0,0,0
"Columbia Management Investment Distributors, Inc.",6505,0,0,1,1,0,0,1
DMX,6980,0,0,0,0,0,0,0
Aqua Hotels & Resorts,7048,0,0,0,0,0,0,0
SMART Technologies,7003,0,0,0,0,0,0,0
Vida Shoes International,7248,0,0,0,0,0,0,0
PetFirst Healthcare,7014,0,0,0,0,0,0,0
Gulf Shores and Orange Beach Tourism,6076,0,0,0,0,0,0,0
San Diego Zoo Global,7273,0,0,0,0,0,0,0
Ottawa University,7137,0,0,0,0,0,0,0
healthfair.com,7139,0,0,0,0,0,0,0
Oceania Cruises,6170,1,0,1,2,0.5,0,0.5
Crunch LLC,6445,0,0,0,0,0,0,0
Lulus Fashion Lounge,6134,2,0,0,2,1,0,0
MyMilitarySaving.Com Inc.,6752,0,0,0,0,0,0,0
CampusCorner.com,5984,0,0,0,0,0,0,0
Procom America,5995,1,0,0,1,1,0,0
FreePriceAlerts.com,6002,0,0,0,0,0,0,0
Costa Developers,6763,0,0,0,0,0,0,0
"Intuit, Inc.",6488,14,0,12,26,0.538461538,0,0.461538462
The University of Vermont,6495,0,0,0,0,0,0,0
Soave Automotive/Aristocrat Motors,6209,0,0,0,0,0,0,0
SpringCM,7031,0,0,0,0,0,0,0
BestSeniorCareOnline.com,6502,0,0,0,0,0,0,0
Cambridge Trust Company,6970,9,0,0,9,1,0,0
DealChicken.com,7038,0,0,0,0,0,0,0
Allegro Classics,6981,0,0,0,0,0,0,0
"Moda Operandi, Inc",6727,1,0,0,1,1,0,0
Forever 21,7095,0,0,0,0,0,0,0
Cameron Hughes Wine,6802,0,0,0,0,0,0,0
Syracuse Home Association,6988,0,0,0,0,0,0,0
Railbookers,7170,0,0,0,0,0,0,0
Shift Summit,7070,0,0,0,0,0,0,0
Reinhart Boerner Van Deuren,7006,0,0,0,0,0,0,0
Eye Center of Texas,7113,0,0,0,0,0,0,0
Children International,7013,0,0,0,0,0,0,0
Ballet San Jose,7256,0,0,0,0,0,0,0
WorldMediaRights,6077,0,0,0,0,0,0,0
Children's Hospital of Philadelphia,6084,2,2,1,5,0.4,0.4,0.2
deautos.com,7131,0,0,0,0,0,0,0
Mockingbird Station,7281,0,0,0,0,0,0,0
Select Comfort Corporation,6754,6,0,1,7,0.857142857,0,0.142857143
"HealthyLife Sciences, LLC",6179,0,0,0,0,0,0,0
Mill Creek Carpet & Tile,6186,0,0,0,0,0,0,0
"Red Hat, Inc.",6486,0,0,0,0,0,0,0
NewNowNext.com,6704,0,0,0,0,0,0,0
Fupa Games,6772,0,0,0,0,0,0,0
"NVR, Inc",6954,2,0,1,3,0.666666667,0,0.333333333
Donald E. McNabb Company,6779,0,0,0,0,0,0,0
Brain Host,6904,0,0,0,0,0,0,0
Amegy Mortgage Company,6786,0,0,0,0,0,0,0
"William A. Graber, MD.",6211,0,0,1,1,0,0,1
Hagopian,6972,0,0,0,0,0,0,0
ZIPS Franchising,6936,0,0,0,0,0,0,0
CallFire.com,6822,0,0,0,0,0,0,0
"ZELTIQ Aesthetics, Inc.",7011,0,0,0,0,0,0,0
Penn National Gaming,6068,2,1,1,4,0.5,0.25,0.25
F5 Networks,7079,0,0,0,0,0,0,0
Panor Corp,7122,3,0,0,3,1,0,0
Browns Clowns,7197,0,0,0,0,0,0,0
Union Bank Of India,7090,0,0,0,0,0,0,0
Layla Grayce,7129,0,0,0,0,0,0,0
SCMinds@Work,7279,0,0,0,0,0,0,0
Power4Patriots.com,6086,7,2,0,9,0.777777778,0.222222222,0
Rosenblum Cellars,7465,0,0,0,0,0,0,0
NW Cryobank,6439,0,0,0,0,0,0,0
Bio-Rad Laboratories,6440,0,0,0,0,0,0,0
Boston Lyric Opera,6175,0,0,0,0,0,0,0
Digital Federal Credit Union,5990,0,0,0,0,0,0,0
CNIB,6758,0,0,0,0,0,0,0
Auxilium Pharmaceuticals,6290,0,0,0,0,0,0,0
The Adrienne Arsht Center for the Performing Arts of Miami-Dade County,6190,0,0,0,0,0,0,0
Compassion International,6008,0,0,1,1,0,0,1
Rag & Bone Industries,6943,0,0,0,0,0,0,0
Cruises.com,6944,0,0,0,0,0,0,0
Libby Kirwin Real Estate,6893,0,0,0,0,0,0,0
Joss & Main,6208,65,4,1,70,0.928571429,0.057142857,0.014285714
Abingdon Press,6790,0,0,0,0,0,0,0
JustBlinds.com,6508,0,0,0,0,0,0,0
American Association of Orthodontists,6222,3,1,0,4,0.75,0.25,0
"Senica Airconditioning, Inc.",6808,0,0,0,0,0,0,0
"Business.com Media, Inc.",7057,0,0,1,1,0,0,1
alpacacollections.com,6993,0,0,0,0,0,0,0
Rocky Point Convention and Visitors Bureau,6525,0,0,0,0,0,0,0
Visionary Home Audio & Home Theater,6526,0,0,0,0,0,0,0
Neonga AG,6740,0,0,0,0,0,0,0
Illinois Office of Tourism,7176,0,0,0,0,0,0,0
"CBOA Financial, Inc.",7243,0,0,0,0,0,0,0
Air National Guard,7075,0,0,0,0,0,0,0
Los Angeles Opera,7076,0,0,0,0,0,0,0
Stanfield's Limited,6072,0,0,0,0,0,0,0
Loopnet,6840,1,0,0,1,1,0,0
Sur La Table,6843,0,0,0,0,0,0,0
myZone Media Inc,6857,0,0,0,0,0,0,0
Broadway/LA -Nederlander.Inc.,7293,0,0,0,0,0,0,0
Brooksville Regional Hospital,7393,0,0,0,0,0,0,0
Creature Movie,7458,0,0,0,0,0,0,0
"OnGuard Insurance Services, LLC",6174,0,0,0,0,0,0,0
TimesofMoney,6456,0,0,0,0,0,0,0
John Spiegel Columbia Sportswear,6874,0,0,0,0,0,0,0
MacCleaners.org,6760,0,0,0,0,0,0,0
Northern Trust,6942,1,0,0,1,1,0,0
Hearst Business Media Corporation,6892,0,0,0,0,0,0,0
Wingstop Restaurants,6773,1,0,1,2,0.5,0,0.5
Baker College,6155,0,0,0,0,0,0,0
CarsDirect.com,6710,0,0,0,0,0,0,0
My Patriot Supply,6791,0,2,0,2,0,1,0
Berklee College of Music,6723,0,0,0,0,0,0,0
Towerstream Corporation,7041,0,0,0,0,0,0,0
Peter Cooper Village,6927,0,0,0,0,0,0,0
Healthy Choice Mattress,6223,0,0,0,0,0,0,0
FXMResearch.com,6991,0,0,0,0,0,0,0
Howard Alan Events,7178,0,0,0,0,0,0,0
Idaho Department of Commerce,6823,0,0,0,0,0,0,0
JDRF,7077,0,0,0,0,0,0,0
"FidoPharm, Inc.",7192,0,0,0,0,0,0,0
BrainBank Inc.,7127,0,0,0,0,0,0,0
"Home Value Protection, Inc.",7277,0,0,0,0,0,0,0
The Burton Corporation,6859,0,0,0,0,0,0,0
New Orleans Regional Transit Authority,7392,0,0,0,0,0,0,0
Super 8 Hitting System,7459,0,0,0,0,0,0,0
University of London,7460,0,0,0,0,0,0,0
Auto-Price-Finder.com,7528,1,0,0,1,1,0,0
Purity Products,7727,0,0,0,0,0,0,0
Alliance Theatre,6139,0,0,0,0,0,0,0
Air France,6875,0,0,0,0,0,0,0
Collection Auto Group,6876,0,0,0,0,0,0,0
NextSportStar,6007,1,0,1,2,0.5,0,0.5
California Walnut Commission,6490,0,0,0,0,0,0,0
Tops Friendly Markets,6775,4,0,1,5,0.8,0,0.2
International Speedway Corporation,6776,0,0,0,0,0,0,0
Lionel.com LLC.,6157,1,0,0,1,1,0,0
Belair Insurance Company Inc.,7026,0,0,0,0,0,0,0
Saxon Shoes,6975,0,0,0,0,0,0,0
"Yachting Promotions, Inc.",6976,0,0,0,0,0,0,0
Market Motive,6507,0,0,0,0,0,0,0
theHIGHERLIFESTYLE.com,6725,0,0,0,0,0,0,0
Ruth Eckerd Hall,6726,0,0,0,0,0,0,0
Arizona Science Center,6225,0,0,0,0,0,0,0
Ole.com.ar,7058,0,0,0,0,0,0,0
Wholesale Furniture Brokers,7175,0,0,0,0,0,0,0
Standout Designs,7107,1,0,0,1,1,0,0
Legacy Food Storage,7108,0,0,0,0,0,0,0
Clariness,6825,8,1,0,9,0.888888889,0.111111111,0
Hiras Fashion,7261,0,0,0,0,0,0,0
ASRock,7193,1,0,0,1,1,0,0
Meritage Homes Corp,7126,0,0,2,2,0,0,1
Riviera Nayarit Convention & Visitors Bureau (Riviera Nayarit CVB),7275,0,0,0,0,0,0,0
MagnaFlow Exhaust Products,7276,0,0,0,0,0,0,0
"Blip Networks, Inc.",6858,0,0,0,0,0,0,0
Lagardère Group,7394,2,0,0,2,1,0,0
"Jenkat Media, Inc.",7729,0,0,0,0,0,0,0
Petty's Fine Foods,5530,0,0,0,0,0,0,0
"Boehringer Ingelheim Pharmaceuticals, Inc.",4960,2,0,5,7,0.285714286,0,0.714285714
TXU Energy Retail Company,4962,3,3,0,6,0.5,0.5,0
"Days Inn Worldwide, Inc.",5281,0,0,0,0,0,0,0
Bake Pop,5579,0,0,0,0,0,0,0
Electronics Design Group,7203,0,0,0,0,0,0,0
DegreeSearch.com,4745,0,0,0,0,0,0,0
Kotak Mahindra Group,6658,0,0,0,0,0,0,0
PetCareRx.com,7617,0,0,0,0,0,0,0
Aurum Advisors,6661,0,0,0,0,0,0,0
"Expedited Travel, LLC.",6667,0,0,0,0,0,0,0
Perricone MD,6655,0,0,0,0,0,0,0
Omhu,7606,0,0,0,0,0,0,0
IObit,7613,0,0,1,1,0,0,1
Cheung Kong Graduate School of Business (CKGSB),7634,0,0,0,0,0,0,0
Dittrich Furs,6660,0,0,0,0,0,0,0
ReadWriteWeb,7481,0,0,0,0,0,0,0
The Speaker Shop,7208,0,0,0,0,0,0,0
Llywelyn's Pub,7206,0,0,0,0,0,0,0
Johnson Motor,6664,0,0,0,0,0,0,0
Cudo,7473,0,0,0,0,0,0,0
InterviewSuccessFormula.com,7404,2,0,0,2,1,0,0
Fannie Mae,6662,2,0,1,3,0.666666667,0,0.333333333
"JFC International, Inc.",7621,0,0,0,0,0,0,0
Le Moyne College,7792,0,0,0,0,0,0,0
Hot Topic,7406,0,0,0,0,0,0,0
National Collegiate Scouting Association,6656,0,0,0,0,0,0,0
Lung LLC,7649,0,0,0,0,0,0,0
"EarthGrains Baking Companies, Inc.",7212,0,0,0,0,0,0,0
TriHealth,7202,0,0,0,0,0,0,0
Check N Gold,7635,0,0,0,0,0,0,0
Captain Lucas Inc,7431,0,0,0,0,0,0,0
ClassesandCareers.com,7211,0,0,0,0,0,0,0
The Alpha Group,7215,0,0,0,0,0,0,0
"Institute of Health Sciences, L.L.C.",7625,1,0,0,1,1,0,0
Beverly Hills Conference and Visitors Bureau,7646,0,0,0,0,0,0,0
P&O Cruises,6672,0,0,0,0,0,0,0
St. Joseph's Hospital and Medical Center,7609,0,0,1,1,0,0,1
DealTaker Inc.,7874,0,0,0,0,0,0,0
BeddingStyle.com,7791,0,0,0,0,0,0,0
Speedway LLC,7610,0,0,0,0,0,0,0
Provident Films,7604,0,0,0,0,0,0,0
Grove Opticians,7637,0,0,0,0,0,0,0
"KIDZ BOP, L.L.C.",7857,0,0,0,0,0,0,0
"Boost Worldwide, Inc.",7483,124,15,12,151,0.821192053,0.099337748,0.079470199
TicketBiscuit,7430,0,0,0,0,0,0,0
Smarter Agent,7797,0,0,0,0,0,0,0
Blue Hills Bank,7476,0,0,0,0,0,0,0
PR Newswire Association LLC.,7854,0,0,0,0,0,0,0
"Planar Systems, Inc.",6666,0,0,0,0,0,0,0
iUniverse.com,7626,0,0,0,0,0,0,0
Casino Queen,6668,0,0,0,0,0,0,0
Newport Natural Health,7636,0,0,0,0,0,0,0
The Los Angeles Times Media Group (LATMG),7632,0,0,0,0,0,0,0
Mount Auburn Hospital,7409,0,0,0,0,0,0,0
Home Decorators Collection,7421,0,0,0,0,0,0,0
ING Belgique SA,7798,0,0,0,0,0,0,0
National September 11 Memorial & Museum,7417,0,0,0,0,0,0,0
Hilton Head Island-Bluffton Chamber of Commerce and Visitor & Convention Bureau,7624,0,0,0,0,0,0,0
Funjet Vacations,7853,1,0,4,5,0.2,0,0.8
"Insomniac, Inc.",7799,0,0,0,0,0,0,0
SmartLoans.com,7864,0,0,0,0,0,0,0
Waters,7427,0,0,0,0,0,0,0
"California Cryobank, Inc.",7815,0,0,0,0,0,0,0
Parties That Cook,7868,0,0,0,0,0,0,0
Scripps Interactive Newspapers Group,6659,0,0,0,0,0,0,0
ProFund Advisors,7432,0,0,0,0,0,0,0
Algonquin College of Applied Arts and Technology,7870,0,0,0,0,0,0,0
California West Communities,7210,0,0,0,0,0,0,0
SureBaby,7810,0,0,0,0,0,0,0
Smarter.com,7802,0,0,0,0,0,0,0
Delverde,7804,0,0,0,0,0,0,0
Hildreth's Home Goods,7806,0,0,0,0,0,0,0
Luscinia Health,7478,0,0,0,0,0,0,0
United States Golf Association,7800,0,0,0,0,0,0,0
"The Coin Market, LLC",7885,3,0,0,3,1,0,0
"Trex Company, Inc.",6673,0,0,0,0,0,0,0
GolfTEC,7878,0,0,0,0,0,0,0
Exclusive Resorts LLC.,7627,1,0,0,1,1,0,0
HobbyPartz.com,7410,0,0,0,0,0,0,0
The New York Times Company,7645,10,8,10,28,0.357142857,0.285714286,0.357142857
The American Conservative Union,7796,0,0,0,0,0,0,0
PeopleSmart,7809,2,0,1,3,0.666666667,0,0.333333333
NavyPier.com,7408,0,0,0,0,0,0,0
"Live Better Brands, LLC.",7629,0,0,0,0,0,0,0
Shred-it International,7426,0,0,0,0,0,0,0
The Sound Room,7861,0,0,0,0,0,0,0
Aestique Medical Center,7876,0,0,0,0,0,0,0
Public Service Alliance of Canada,7812,0,0,0,0,0,0,0
"Choice Hotels International, Inc.",4977,2,0,5,7,0.285714286,0,0.714285714
Tobacco Free Florida,5932,3,1,3,7,0.428571429,0.142857143,0.428571429
Keck Futures Initiative,5160,0,0,0,0,0,0,0
"7-Eleven, Inc.",5715,0,0,3,3,0,0,1
"BillGuard, Inc.",7538,0,0,0,0,0,0,0
GameDemo.com,7542,0,0,0,0,0,0,0
"Acceller, Inc.",7545,0,0,0,0,0,0,0
Mount Sinai Medical Center,7549,1,0,0,1,1,0,0
Flightraja Travels,5447,0,0,0,0,0,0,0
Client Connections USA LLC,7738,0,0,0,0,0,0,0
"Market Visions, LLC.",7536,0,0,0,0,0,0,0
Direct Relief International,7737,0,0,0,0,0,0,0
Washington Restaurant Association,7551,0,0,0,0,0,0,0
Corel Corporation,6030,0,1,0,1,0,1,0
Mirvish Productions,7553,0,0,0,0,0,0,0
California Table Grape Commission,5047,0,0,0,0,0,0,0
Eastern Sports & Outdoor Show,6100,0,0,0,0,0,0,0
Maple Hill Auto Group,6434,0,0,0,0,0,0,0
Broadway In Detroit,5747,0,0,0,0,0,0,0
K1 Speed INC.,6166,0,0,0,0,0,0,0
The Palm Beach Post,7563,0,0,0,0,0,0,0
Air China,7893,0,0,0,0,0,0,0
Blue Cross and Blue Shield of Georgia,7743,0,0,0,0,0,0,0
EraseThatDebt.com,7219,0,0,0,0,0,0,0
City of Austin,7898,0,0,0,0,0,0,0
Vince and Joe's Gourmet Markets,7568,0,0,0,0,0,0,0
LA Auto Show,7745,0,0,0,0,0,0,0
Invest Northern Ireland,7744,0,0,0,0,0,0,0
The Original Mattress Factory,7556,0,0,0,0,0,0,0
Spotify USA Inc,7826,0,0,0,0,0,0,0
"Get Me On Media, Inc.",7753,0,0,0,0,0,0,0
San Francisco Orchid Society,7900,0,0,0,0,0,0,0
300 New York,7579,0,0,0,0,0,0,0
HUDForeclosed.com,7438,0,0,0,0,0,0,0
WorldAPP,7740,0,0,0,0,0,0,0
Waste Management Phoenix Open,7761,0,0,0,0,0,0,0
Namecheap.com,7541,0,0,0,0,0,0,0
"RANLife, Inc.",7889,2,0,0,2,1,0,0
Système 41,7442,0,0,0,0,0,0,0
Red Gate Software Limited,7566,0,0,0,0,0,0,0
NitroRCX.com,7234,0,0,0,0,0,0,0
Altrec.com,7659,0,0,0,0,0,0,0
Cuyahoga Community College,7902,0,0,1,1,0,0,1
FLOFORM Countertops,7929,0,0,0,0,0,0,0
Wolfgang's Vault,7557,0,0,0,0,0,0,0
Universal Music Group,7820,0,0,0,0,0,0,0
Federal Voting Assistance Program (FVAP),7751,0,0,0,0,0,0,0
BioNitrogen Corp,7655,0,0,0,0,0,0,0
Pacific Coast Feather Company,7451,0,0,0,0,0,0,0
Henrico County Government,7742,0,0,0,0,0,0,0
Lakeshore Entertainment Group,7910,0,0,0,0,0,0,0
ArcadeHall.com,7657,0,0,0,0,0,0,0
PhantomALERT,7559,0,0,0,0,0,0,0
Express Scripts Holding Company,7994,0,0,0,0,0,0,0
University of Washington School of Social Work,7220,0,0,0,0,0,0,0
"Alpari (US), LLC",7565,0,0,0,0,0,0,0
Kemper Corporation,7827,0,0,0,0,0,0,0
Mercy College of Health Sciences,7654,0,0,0,0,0,0,0
International Hospitality Enterprises,7921,0,0,0,0,0,0,0
PsPrint LLC,7222,0,0,0,0,0,0,0
LexisNexis Risk Solutions,7830,0,0,0,0,0,0,0
"LiquidPlanner, Inc.",7150,0,0,0,0,0,0,0
Clearview Mall,7936,0,0,0,0,0,0,0
"Zmanda, Inc.",7572,0,0,0,0,0,0,0
Dana-Farber/Children's Hospital Cancer Center,7754,0,0,0,0,0,0,0
divine.ca,7938,0,0,0,0,0,0,0
Bytro Labs,7548,0,0,0,0,0,0,0
American Laser Skincare,7560,0,0,0,0,0,0,0
University Village,7749,0,0,0,0,0,0,0
Vivendi Entertainment,7668,0,0,0,0,0,0,0
Noble House Hotels & Resorts,7658,0,0,0,0,0,0,0
DogSupplies.com,7899,0,0,0,0,0,0,0
"Legacy Keepers, Inc",7667,0,0,0,0,0,0,0
Premier Driving School,7670,0,0,0,0,0,0,0
Escoffier School of Culinary Arts,7824,16,1,0,17,0.941176471,0.058823529,0
Reno-Sparks Convention and Visitors Authority (RSCVA),7228,0,0,0,0,0,0,0
Fezzari Bicycles,7224,1,0,0,1,1,0,0
Marc Ecko Enterprises,7231,0,0,0,0,0,0,0
Moody's Jewelry,7831,0,0,1,1,0,0,1
Torre & Company,7669,0,0,0,0,0,0,0
eFinancialCareers Ltd.,7764,0,0,0,0,0,0,0
The Jim Click Automotive Team,7227,0,0,0,0,0,0,0
Audio-Technica U.S.,7449,1,0,0,1,1,0,0
Massachusetts Institute of Technology,7452,0,0,0,0,0,0,0
Miss Jessie's,7585,0,0,0,0,0,0,0
Samaritan Fundraising,7908,0,0,0,0,0,0,0
"GrindMedia, LLC.",7951,1,0,0,1,1,0,0
Flight Centre Limited,7919,0,0,0,0,0,0,0
"Michaels Stores, Inc.",7756,38,6,0,44,0.863636364,0.136363636,0
SIFF,7748,0,0,0,0,0,0,0
Official Tourism Site of Tuscany,7584,0,0,0,0,0,0,0
Give More Media Inc.,7238,0,0,0,0,0,0,0
"Gray & Sons, Inc.",7681,0,0,0,0,0,0,0
MISI Surgery Center,7918,0,0,0,0,0,0,0
Dallas County Community College District,7944,0,0,0,0,0,0,0
Margaret L. Williams Developmental Evaluation Center,7445,0,0,0,0,0,0,0
BestBuyP.C.S.,7937,0,0,0,0,0,0,0
USA Science & Engineering Festival,7578,0,0,0,0,0,0,0
The Gansevoort Miami Beach,7573,0,0,0,0,0,0,0
StarCall,7917,0,0,0,0,0,0,0
Dassault Systèmes SolidWorks Corp,7996,0,0,0,0,0,0,0
Strand-Capitol Performing Arts Center,7932,0,0,0,0,0,0,0
Moe's Home Furniture Collection,7914,0,0,0,0,0,0,0
Royal Council of the Real Fairyland,7447,6,0,0,6,1,0,0
The American Petroleum Institute,7942,0,0,0,0,0,0,0
Marine Corps Marathon,7833,0,0,0,0,0,0,0
Environment Furniture,7946,0,0,0,0,0,0,0
"Diet Direct, Inc.",7583,0,0,0,0,0,0,0
"Jobvite, Inc.",7941,0,0,0,0,0,0,0
"RMHC of the Philadelphia Region, Inc.",7913,0,0,0,0,0,0,0
Aspen Skiing Company,7760,1,0,0,1,1,0,0
OrthoCarolina,7915,0,0,0,0,0,0,0
"Empire Today, LLC",7674,0,0,0,0,0,0,0
Missouri History Museum,7677,0,0,0,0,0,0,0
Micro-Cap Consultants LLC,7927,0,0,0,0,0,0,0
Greatland Corporation,7922,11,0,5,16,0.6875,0,0.3125
Del City,7767,0,0,0,0,0,0,0
Orlando Science Center,7928,0,0,1,1,0,0,1
SPAN Pine,7209,0,0,0,0,0,0,0
"Worth Ave. Group, LLC.",7933,0,0,0,0,0,0,0
TRYST NIGHTCLUB AT WYNN,7924,0,0,0,0,0,0,0
Calloway's Nursery,8001,0,0,0,0,0,0,0
The J. Paul Getty Trust,7947,0,0,0,0,0,0,0
RG Barry Corporation,7949,0,0,0,0,0,0,0
Ski Lifts Inc.,7948,0,0,0,0,0,0,0
Pennsylvania Historical and Museum Commission,7755,0,0,0,0,0,0,0
Conservatory of Recording Arts & Science,7477,2,0,0,2,1,0,0
European Association Association for the Study of the Liver,6674,0,0,0,0,0,0,0
Bell Mitsubishi,7232,0,0,0,0,0,0,0
March of Dimes Foundation,7642,2,0,0,2,1,0,0
"OPTIMA Batteries, Inc.",7666,0,0,0,0,0,0,0
TradeWinds Island Resort,7832,0,0,0,0,0,0,0
CakeStyle,7923,0,0,0,0,0,0,0
JetBrains.com,7401,0,0,0,0,0,0,0
Edgar Snyder & Associates,7925,0,0,0,0,0,0,0
KISSmetrics,7934,0,0,0,0,0,0,0
Whitaker Center for Science and the Arts,8000,0,0,0,0,0,0,0
Discovery Science Center,7795,0,0,0,0,0,0,0
"Calvert Investments, Inc.",7860,0,0,0,0,0,0,0
Ohio State University,7863,0,0,0,0,0,0,0
"North Brothers Automotive Services, Inc.",7877,0,0,0,0,0,0,0
Seattle Children’s,7813,0,0,0,0,0,0,0
Nashville Convention & Visitors Bureau,7895,2,0,1,3,0.666666667,0,0.333333333
U.S. Department of the Interior,7896,0,0,0,0,0,0,0
AT&T Pebble Beach National Pro-Am,7746,0,0,0,0,0,0,0
"DailyCandy, LLC.",7660,2,0,0,2,1,0,0
"LARK Technologies, Inc.",7828,0,0,0,0,0,0,0
Primrose School Franchising Company,7759,0,0,0,0,0,0,0
Mattress.com,7678,0,0,0,0,0,0,0
Dillman & Upton,7945,0,0,0,0,0,0,0
Knowledge Adventure LLC,7618,0,0,0,0,0,0,0
Paulson’s Audio & Video,7620,0,0,0,0,0,0,0
Civic Ventures,7216,0,0,0,0,0,0,0
Adventist Midwest Health,7484,0,0,0,0,0,0,0
Hilltop Steakhouse,7420,0,0,0,0,0,0,0
Poarch Band of Creek Indians,7801,0,0,0,0,0,0,0
University of North Texas,7869,0,0,0,0,0,0,0
Effy Jewelers Corp.,7818,0,0,0,0,0,0,0
Microchip Technology Inc.,7886,0,0,1,1,0,0,1
FMA Solutions Inc.,7537,0,0,0,0,0,0,0
Wisconsin Department of Tourism,7652,0,0,0,0,0,0,0
PowerMMO,7550,0,0,0,0,0,0,0
Safavieh Home Furnishings,7437,0,0,0,0,0,0,0
Jeff Ruby Culinary Entertainment,7567,1,0,0,1,1,0,0
Council for the Advancement of Public Schools,7752,0,0,0,0,0,0,0
Regina Tours & Group IST,7233,0,0,0,0,0,0,0
Consumers Energy,7450,0,0,0,0,0,0,0
"Ventura Foods, LLC.",7684,0,0,0,0,0,0,0
New America Energy Corp,7952,0,0,0,0,0,0,0
Babylon Ltd.,6653,2,0,4,6,0.333333333,0,0.666666667
BoxWave Corporation,7623,0,0,0,0,0,0,0
"Prosperity Action, Inc.",7630,0,0,0,0,0,0,0
Chicago Symphony Orchestra Association,7789,0,0,0,0,0,0,0
"Goodman Acker, PC",7855,0,0,0,0,0,0,0
Harlequin Enterprises Limited,7859,0,0,0,0,0,0,0
TuneUp Corporation,7866,0,0,0,0,0,0,0
"Sashco, Inc.",7555,0,0,0,0,0,0,0
"Clinaero, Inc.",7891,1,0,0,1,1,0,0
"A Spotmau, Inc.",7564,0,0,0,0,0,0,0
People for Good,7221,0,0,0,0,0,0,0
Vein Care Pavilion of Nashville,7223,0,0,0,0,0,0,0
"New Meadowlands Racetrack, LLC",7825,0,0,0,0,0,0,0
National Outdoor Leadership School,7757,0,0,0,0,0,0,0
The Rockport Company,7766,0,0,0,0,0,0,0
Range Resources,7998,0,0,0,0,0,0,0
Acorn Media Group,7201,0,0,0,0,0,0,0
"South Florida Fair & Palm Beach County Expositions, Inc",7603,0,0,0,0,0,0,0
SBE Entertainment Group,7403,0,0,0,0,0,0,0
Hammersite Inc.,6665,0,0,0,0,0,0,0
ValueClick Brands,7418,0,0,0,0,0,0,0
Phat Fashions,7433,0,0,0,0,0,0,0
Intlock Ltd.,7803,0,0,0,0,0,0,0
"Happy Chef, Inc.",7535,0,0,0,0,0,0,0
SingTel Optus Pty Limited,7552,0,0,0,0,0,0,0
Virginia Polytechnic Institute and State University,7218,0,0,0,0,0,0,0
Frecklebox,7901,0,0,0,0,0,0,0
"PlaySpan, Inc.",7586,0,0,0,0,0,0,0
Swedish Match North Europe AB,6652,0,0,0,0,0,0,0
Cathay Pacific Airways Limited,6670,6,0,1,7,0.857142857,0,0.142857143
JSA Interactive,7631,0,0,0,0,0,0,0
CentraState Healthcare System,7413,0,0,0,0,0,0,0
WeedMaps Media,7638,0,0,1,1,0,0,1
Spin Master Ltd.,7856,1,0,1,2,0.5,0,0.5
The Coca-Cola Company,7881,2,0,11,13,0.153846154,0,0.846153846
Escape Media Group Inc,7817,0,0,0,0,0,0,0
LoanReduce.com,7892,0,0,0,0,0,0,0
Oscilloscope Laboratores,7906,0,0,0,0,0,0,0
Intrawest Resorts,7574,5,0,3,8,0.625,0,0.375
"Pay Anywhere, LLC",7663,0,0,0,0,0,0,0
Tropicana Las Vegas,7581,0,0,0,0,0,0,0
Value Place,7607,0,0,0,0,0,0,0
American Casino & Entertainment Properties,7207,0,0,0,0,0,0,0
texansforprop8.com,7412,0,0,0,0,0,0,0
Streamlight Inc.,7414,0,0,0,0,0,0,0
"Vivox, Inc.",7639,0,0,0,0,0,0,0
Bountii Inc.,7805,0,0,0,0,0,0,0
Fidelus Technologies,7873,0,0,0,0,0,0,0
Takeda Pharmaceutical Company Limited,7807,8,0,3,11,0.727272727,0,0.272727273
The Heart and Stroke Foundation,7875,0,0,0,0,0,0,0
San Francisco Opera,7884,1,0,0,1,1,0,0
"COMCAST SPECTACOR, L.P.",7546,0,0,0,0,0,0,0
First Choice Bank,7741,0,0,0,0,0,0,0
"Merz Pharmaceuticals, LLC.",7905,12,0,1,13,0.923076923,0,0.076923077
United Methodist Communications,7571,0,0,1,1,0,0,1
Check Point Software Technologies Ltd.,7907,0,0,0,0,0,0,0
OurParentsPlace.com,7750,0,0,0,0,0,0,0
FamilyCouponNetwork,7446,0,0,0,0,0,0,0
Vaftv.com,7448,0,0,0,0,0,0,0
Chinglish Broadway,7237,0,0,0,0,0,0,0
"LUXA Enterprises, LLC",7239,0,0,0,0,0,0,0
Trinity Railway Express,7675,0,0,0,0,0,0,0
"wrench science, inc.",7939,0,0,0,0,0,0,0
drugstore.com,7204,10,1,10,21,0.476190476,0.047619048,0.476190476
LUSH North America,7472,0,0,0,0,0,0,0
"MOJOCREATIVES, INC.",7479,1,0,0,1,1,0,0
Solaria Riverdale,7415,3,1,0,4,0.75,0.25,0
HIPHOPNEWS24-7.COM,7422,0,0,0,0,0,0,0
Points of Light Institute,7858,0,0,0,0,0,0,0
Gate.com,7429,0,0,0,0,0,0,0
Parts Town,7865,0,0,0,0,0,0,0
Communication Federal Credit Union,7872,0,0,0,0,0,0,0
"The Thurswell Law Firm, PLLC",7808,0,1,0,1,0,1,0
"The Cheesecake Factory, Inc.",7540,0,0,0,0,0,0,0
"GOJO Industries, Inc.",7547,0,0,0,0,0,0,0
Cedar Fair Entertainment Company,7765,0,0,1,1,0,0,1
"Buddy Media, Inc.",7240,0,0,0,0,0,0,0
Lincoln Center,7997,0,0,0,0,0,0,0
WhiteSmoke Inc.,7605,0,0,0,0,0,0,0
NVIDIA Corporation,7205,19,0,2,21,0.904761905,0,0.095238095
Dedham Institution for Savings,7405,0,0,0,0,0,0,0
New Call Telecom,7407,0,0,0,0,0,0,0
ICM Registry LLC,6669,0,0,0,0,0,0,0
Children's Hospital Los Angeles,7482,0,0,0,0,0,0,0
Tata Communications,7416,0,0,0,0,0,0,0
BigHelp,7648,0,0,0,0,0,0,0
Deeb Family Homes,7650,0,0,0,0,0,0,0
Siegfried and Jensen’s,7880,1,0,0,1,1,0,0
Fairfax Media,7882,0,0,0,0,0,0,0
Virginia Tourism Corporation,7539,0,0,0,0,0,0,0
Mesquite Pro Rodeo,7739,0,0,0,0,0,0,0
CarRentals.com,7439,0,0,0,0,0,0,0
"YNK Interactive, Inc.",7441,0,0,0,0,0,0,0
Kristin Hannah,7909,0,0,0,0,0,0,0
"RockResorts International, LLC",7580,0,0,0,0,0,0,0
Mirantis Inc.,7916,0,0,0,0,0,0,0
"Alcon, Inc.",7950,0,0,0,0,0,0,0
USAFIS Organization,7611,1,0,0,1,1,0,0
Barry University,7644,1,0,0,1,1,0,0
"Hinkle, Jachimowicz, Pointer & Emanuel",7793,0,0,0,0,0,0,0
"XOS Technologies, Inc",7425,0,0,0,0,0,0,0
MedStar Health,7794,1,0,2,3,0.333333333,0,0.666666667
Alpaytac Inc.,7862,0,0,0,0,0,0,0
Yves Saint Laurent,7811,0,0,4,4,0,0,1
"Help Me See, Inc.",7879,0,0,0,0,0,0,0
AGA Service Company,7894,0,0,0,0,0,0,0
consumerhealthawareness.com,7561,0,0,0,0,0,0,0
Meteor,7911,0,0,0,0,0,0,0
GS Media & Events,7912,0,0,0,0,0,0,0
LibertyBell Law Group,7829,0,0,0,0,0,0,0
Washington State University,7676,0,0,0,0,0,0,0
"iTOK, Inc.",7993,0,0,0,0,0,0,0
National Geographic Society,7930,2,0,1,3,0.666666667,0,0.333333333
Regus PLC,6381,10,0,0,10,1,0,0
Littman Jewelers,6130,0,0,0,0,0,0,0
ExploreTalent.com,5979,0,0,0,0,0,0,0
The Florida Aquarium,6132,0,0,0,0,0,0,0
Clabber Girl Corporation,6283,0,0,0,0,0,0,0
Tekserve Corporation,6181,0,0,0,0,0,0,0
Xpressbath.com,7454,5,0,0,5,1,0,0
NHK (Japan Broadcasting Corporation),7154,0,0,0,0,0,0,0
Athabasca University,6183,0,0,0,0,0,0,0
Canadian Geographic,7954,0,0,0,0,0,0,0
ERA Franchise Systems LLC.,6481,0,0,1,1,0,0,1
"Trip Network, Inc.",7157,1,0,2,3,0.333333333,0,0.666666667
"AutoTrader.com, Inc.",7486,12,2,6,20,0.6,0.1,0.3
Stereo Exchange Inc.,6700,0,0,0,0,0,0,0
Sanford-Brown Institute,6768,0,0,0,0,0,0,0
Russell Country,7689,0,0,0,0,0,0,0
The University of Tampa,6900,2,0,0,2,1,0,0
Avios,6902,0,0,0,0,0,0,0
Yale New Haven Health System,8003,0,0,0,0,0,0,0
"Replacements, Ltd.",7159,0,0,0,0,0,0,0
Bombardier Recreational Products Inc.,7492,21,12,3,36,0.583333333,0.333333333,0.083333333
"Turner Broadcasting System, Inc.",7965,55,1,9,65,0.846153846,0.015384615,0.138461538
Pneu-Logic Corporation,7985,0,0,0,0,0,0,0
Front Room Furnishings,7155,0,0,0,0,0,0,0
Ezine9,7312,0,0,0,0,0,0,0
The University of Southern California,8078,0,0,0,0,0,0,0
Watermark Retirement Communities,7955,1,0,0,1,1,0,0
"MAC Events, LLC.",7308,0,0,0,0,0,0,0
Wm. Wrigley Jr. Company,7982,53,10,19,82,0.646341463,0.12195122,0.231707317
"Building and Construction Trades Department, AFL-CIO",7306,0,0,0,0,0,0,0
CAZE Company Ltd.,7490,2,0,4,6,0.333333333,0,0.666666667
Navistar,7456,3,0,0,3,1,0,0
RYU,7687,0,0,0,0,0,0,0
Bayliner,7457,0,0,0,0,0,0,0
watercrisissurvival.com,7311,0,0,0,0,0,0,0
"the Holland, Inc.",7970,0,0,0,0,0,0,0
IDT,8141,0,0,0,0,0,0,0
WyzAnt Tutoring,7494,0,0,0,0,0,0,0
"The Yokohama Rubber Co., Ltd.",7156,0,0,0,0,0,0,0
Texas Stampede,8140,0,0,0,0,0,0,0
Rosemont College,8013,0,0,0,0,0,0,0
"Avidian Technologies, Inc.",7706,0,0,0,0,0,0,0
Baker Motor Company,7309,0,0,0,0,0,0,0
Canyons Resort,8008,2,1,0,3,0.666666667,0.333333333,0
"Bennett, Coleman & Co. Ltd.",8067,0,0,0,0,0,0,0
National Pest Management Association,8005,0,0,0,0,0,0,0
Big Tree Supply Inc.,8011,0,0,0,0,0,0,0
Sports Time Ohio,8076,0,0,0,0,0,0,0
Novant Health,7168,0,0,0,0,0,0,0
"O2 Media, Inc.",7718,0,0,0,0,0,0,0
Tuffy Tire & Auto Service,8144,0,0,0,0,0,0,0
Idea Interactive,8166,0,0,0,0,0,0,0
MacKenzie-Childs,8210,0,0,0,0,0,0,0
ICDC College,8009,0,0,0,0,0,0,0
Univision Communications Inc.,7974,0,0,4,4,0,0,1
Johnny’s Selected Seeds,7702,0,0,0,0,0,0,0
National Marine Manufacturers Association,8368,0,0,0,0,0,0,0
"Nextag, Inc.",7714,59,3,9,71,0.830985915,0.042253521,0.126760563
Ritchie Bros. Auctioneers,8153,0,0,0,0,0,0,0
Exchange Online Store,8016,0,0,0,0,0,0,0
California Miramar University,8006,0,0,0,0,0,0,0
"Wantful, Inc.",7715,0,0,0,0,0,0,0
St. Joseph's Imaging Associates,7520,0,0,0,0,0,0,0
Sandestin Golf Beach Resort,7845,0,0,0,0,0,0,0
LL Magnetic Clay Inc.,8298,0,0,0,0,0,0,0
"Quiksilver, Inc.",7846,0,0,1,1,0,0,1
Crimson Lounge,7521,0,0,0,0,0,0,0
James Allen,8287,0,0,0,0,0,0,0
Korum Automotive Group,8142,0,0,1,1,0,0,1
Famous Tate,8370,0,0,0,0,0,0,0
John F. Kennedy University,8083,0,0,0,0,0,0,0
Nottingham University Business School,8068,0,0,0,0,0,0,0
LIN Television Corporation,7959,0,0,0,0,0,0,0
GuitarTricks,8077,0,0,0,0,0,0,0
Sirius XM Radio Inc.,7506,1,0,0,1,1,0,0
Era Alaska,7691,0,0,0,0,0,0,0
Silver and Blue Outfitters,8213,0,0,0,0,0,0,0
Insight Credit Union,8074,0,0,0,0,0,0,0
Common Cause,8160,0,0,0,0,0,0,0
Liberty University,7513,3,0,1,4,0.75,0,0.25
Amoozle.com,7713,0,0,0,0,0,0,0
Tufts Associated Health Plans,8372,0,0,0,0,0,0,0
CourseAdvisor Inc.,8079,0,0,0,0,0,0,0
Aspen Daily News,8206,0,0,0,0,0,0,0
Voodoo Experience,8163,0,0,0,0,0,0,0
Dallas Cowboys Pro Shop,8379,0,0,0,0,0,0,0
Boston Private Bank & Trust Company,7842,0,0,0,0,0,0,0
Parker Hannifin Corp,8363,0,0,0,0,0,0,0
Snow White & the Huntsman Movie,8292,0,0,0,0,0,0,0
Rhode Island Zoological Society,8148,0,0,0,0,0,0,0
Monrovia,8295,0,0,0,0,0,0,0
The Avant/Garde Diaries,8004,0,0,0,0,0,0,0
Evangelical Lutheran Church in America,8385,0,0,0,0,0,0,0
BOP LLC,7704,3,1,4,8,0.375,0.125,0.5
IBFX Australia Pty. Ltd.,8207,0,0,0,0,0,0,0
"Multiphone Latin America, Inc.",7489,0,0,0,0,0,0,0
Gulf Air,7841,0,0,0,0,0,0,0
VIPSingles.com,7724,0,0,0,0,0,0,0
Rouses Enterprises,8378,0,0,0,0,0,0,0
Roaring 20's San Francisco,8170,0,0,0,0,0,0,0
"Canon U.S.A., Inc.",7989,60,6,29,95,0.631578947,0.063157895,0.305263158
"LivePerson, Inc.",7836,2,0,0,2,1,0,0
Speedy Cash,7723,0,0,0,0,0,0,0
"City of Riverside, California",7840,0,0,0,0,0,0,0
TotalDivorce,8366,0,0,0,0,0,0,0
GreenSQL LTD.,7523,0,0,0,0,0,0,0
"Enterprise Holdings, Inc.",8209,4,1,0,5,0.8,0.2,0
LaRog Brothers,8151,0,0,1,1,0,0,1
Lifealike Limited,7838,0,0,0,0,0,0,0
The Art Institutes International LLC,7848,8,3,1,12,0.666666667,0.25,0.083333333
Sun Pharmaceuticals,8217,0,0,0,0,0,0,0
"Safeway, Inc.",8300,53,27,9,89,0.595505618,0.303370787,0.101123596
Woodstream Corporation,7719,0,0,0,0,0,0,0
"CEC Entertainment, Inc.",8435,4,0,0,4,1,0,0
WGBH,8381,0,0,0,0,0,0,0
"Altus Dental Insurance Co., Inc.",8164,0,0,0,0,0,0,0
"Qlipso, Inc.",8365,0,0,0,0,0,0,0
Erassmuss ltd.,7721,1,0,0,1,1,0,0
OPI Products,8218,0,0,0,0,0,0,0
University of Hartford,8376,0,0,0,0,0,0,0
RightSignature,8296,0,0,0,0,0,0,0
The Birmingham News,8168,0,0,0,0,0,0,0
Live365,8433,0,0,0,0,0,0,0
Haw Par,8155,0,0,0,0,0,0,0
Carpet Corner,8373,0,0,0,0,0,0,0
Blue Cross and Blue Shield Association,8289,0,0,0,0,0,0,0
Territorial Seed Company,8384,0,0,0,0,0,0,0
Tacticsoft Ltd.,7517,0,0,0,0,0,0,0
Kitchen Tune-Up,7519,0,0,1,1,0,0,1
"STUN, L.L.C.",8302,0,0,0,0,0,0,0
Jenson USA,7963,0,0,2,2,0,0,1
McMahon & Hadder Insurance,7692,0,0,0,0,0,0,0
Texas Health Resources Inc.,7695,1,1,0,2,0.5,0.5,0
RentalHQ.com,7310,0,0,0,0,0,0,0
Hong Kong Tourism Board,7977,0,0,0,0,0,0,0
MoneyMutual.com,7978,0,0,1,1,0,0,1
350.org Action Fund,7710,0,0,0,0,0,0,0
ITT Corporation,8145,0,0,0,0,0,0,0
ICYNENE Inc.,8146,0,0,0,0,0,0,0
Sabta IT Learning,7509,0,0,0,0,0,0,0
TradeTang.com,8214,0,0,0,0,0,0,0
Mid-America Christian University,7510,0,0,0,0,0,0,0
MacTeam,8364,0,0,0,0,0,0,0
Best Drug Rehabilitation Services,7527,0,0,0,0,0,0,0
Triumph Motorcycles,7152,0,0,1,1,0,0,1
eFile LLC,7303,0,0,0,0,0,0,0
"M/I Homes, Inc.",7686,0,0,0,0,0,0,0
The Land of Nod,7167,15,1,1,17,0.882352941,0.058823529,0.058823529
"Medallia, Inc.",7971,0,0,0,0,0,0,0
"Turtle Wax, Inc.",7988,0,0,0,0,0,0,0
Williamsburg Area Destination Marketing Committee,7501,0,0,0,0,0,0,0
Kars4Kids,7503,0,0,0,0,0,0,0
News Association of America,8205,0,0,0,0,0,0,0
Dallas Theological Seminary,8018,0,0,1,1,0,0,1
Sunvalley Chamber of Commerce,8154,1,0,0,1,1,0,0
Digital Scrapbook Experts,8286,0,0,0,0,0,0,0
Unisfair,8369,0,0,0,0,0,0,0
Baptist Health South Florida,8169,0,0,0,0,0,0,0
USAFish,8303,0,0,0,0,0,0,0
EiEi Homes Inc.,8386,0,0,0,0,0,0,0
IMG Academies,7703,0,0,0,0,0,0,0
"Shopzilla, Inc",8069,2,0,0,2,1,0,0
"Investor's Business Daily, Inc.",7986,1,0,1,2,0.5,0,0.5
EnergyWise Solutions,7835,0,0,0,0,0,0,0
Chandler Regional Medical Center,7837,0,0,0,0,0,0,0
THE GLENLIVET,7720,0,0,0,0,0,0,0
HealthJournalReview.com,8152,0,0,0,0,0,0,0
Builders Land Link,8288,0,0,0,0,0,0,0
World Society for the Protection of Animals,7518,0,0,0,0,0,0,0
Van Daele Homes,8371,0,0,0,0,0,0,0
Liberator Medical Supply,7153,0,0,0,0,0,0,0
"Random House, Inc.",7455,1,0,3,4,0.25,0,0.75
"Power Equipment Direct, Inc.",7957,1,0,0,1,1,0,0
Pinnacle Entertainment Inc.,7964,0,0,1,1,0,0,1
S. Rob Sobhani,7698,0,0,0,0,0,0,0
The Bonati Spine Institute,7498,0,0,0,0,0,0,0
Global Ipsos Group,7991,0,0,0,0,0,0,0
shop.mothering.com,8157,0,0,0,0,0,0,0
CableMover.com,8291,1,0,1,2,0.5,0,0.5
"ScholarOne, Inc.",8293,0,0,1,1,0,0,1
State of Michigan,8432,0,0,0,0,0,0,0
Mount Airy 1,8434,0,0,0,0,0,0,0
Lapworks,7443,0,0,0,0,0,0,0
Grand Lucayan Beach & Golf Resort,7226,4,0,0,4,1,0,0
CyberInk,7444,0,0,0,0,0,0,0
The Marcus Corporation,7661,0,0,0,0,0,0,0
Vineyard Vines,7575,10,0,0,10,1,0,0
Pest Away Inc,7662,0,0,0,0,0,0,0
"Stock Market Authority, LLC",7576,0,0,0,0,0,0,0
Simpson College,7926,0,0,0,0,0,0,0
GameBabylon.Com,7962,0,0,0,0,0,0,0
Goodwin College,7693,0,0,0,0,0,0,0
Williams-Sonoma Inc.,7694,65,49,0,114,0.570175439,0.429824561,0
Parents for Choice in Education,7980,0,0,0,0,0,0,0
University of Rochester,7711,0,0,0,0,0,0,0
FIDM,8211,0,0,0,0,0,0,0
Matrix Funds,7843,0,0,0,0,0,0,0
DocuSign Inc.,7512,1,0,0,1,1,0,0
LXR Luxury Resorts & Hotels,8294,0,0,0,0,0,0,0
ADTECH GmbH,7526,6,0,0,6,1,0,0
John Hancock,6654,0,0,2,2,0,0,1
"AdvancedMD Software, Inc",7608,1,0,0,1,1,0,0
"Lorex Techonlogy, Inc.",7615,0,0,0,0,0,0,0
Sheriff Joe PAC,7633,0,0,0,0,0,0,0
"Jimmy John's Franchise, LLC",7883,4,0,0,4,1,0,0
Minnesotans United for All Families,7897,0,0,0,0,0,0,0
SpectorSoft Corporation,7747,0,0,0,0,0,0,0
Zattoo,7440,0,0,0,0,0,0,0
Fiverr International Limited,7822,0,0,0,0,0,0,0
Neebo,7758,0,0,0,0,0,0,0
HowToSucceedBroadway.com,7672,0,0,0,0,0,0,0
White Castle Management Co,7165,1,0,0,1,1,0,0
PIMCO Investments LLC.,7697,0,0,0,0,0,0,0
Rocketts Landing,7972,0,0,0,0,0,0,0
R+L Carriers New Orleans Bowl,8015,0,0,0,0,0,0,0
Country Folk Art Craft Shows,7504,0,0,0,0,0,0,0
Chabot Space & Science Center,7956,0,0,0,0,0,0,0
CarsForBreastCancer.org,7163,0,0,0,0,0,0,0
Virginia College Savings Plan,7967,0,0,0,0,0,0,0
"Inkling Systems, Inc.",7699,0,0,0,0,0,0,0
Ultimatepdfconverter.com,7488,0,0,0,0,0,0,0
Marin Humane Society,7313,0,0,0,0,0,0,0
The Library of Congress,7499,0,0,0,0,0,0,0
Children's Hospital of Pittsburgh of UPMC,8149,0,0,0,0,0,0,0
Slimming World,8285,0,0,0,0,0,0,0
Cambria Bicycle Outfitter,7849,0,0,0,0,0,0,0
KineticD,8367,0,0,0,0,0,0,0
PlanetLoveMatch,8299,0,0,0,0,0,0,0
"AtTask, Inc.",7524,0,0,0,0,0,0,0
Music Box Films,7305,0,0,0,0,0,0,0
NewlinLaw.com,7707,0,0,0,0,0,0,0
SmartBear Software,7984,0,0,0,0,0,0,0
"Netbriefings, Inc.",7314,0,0,0,0,0,0,0
Steptoe & Johnson,8143,0,0,0,0,0,0,0
Medi-Share,8082,3,0,1,4,0.75,0,0.25
"Weight Watchers International, Inc.",7505,12,0,13,25,0.48,0,0.52
Cardi's Furniture,8084,0,0,0,0,0,0,0
Seattle Central Community College,8150,0,0,0,0,0,0,0
PetSmart Charities,8216,0,0,0,0,0,0,0
CityXpress Ltd,7304,0,0,1,1,0,0,1
Eredan,7690,0,0,0,0,0,0,0
"TradeStation Forex, Inc.",7708,0,0,0,0,0,0,0
Braintree & New England Rehabilitation Hospitals,7497,1,0,0,1,1,0,0
Oh No They Didn't!,7990,0,0,0,0,0,0,0
Cablevision 99%,7722,0,0,0,0,0,0,0
netzwelt GmbH,8208,0,0,0,0,0,0,0
BRER Affiliates Inc.,7508,0,0,1,1,0,0,1
"Ning, Inc.",7515,13,0,0,13,1,0,0
Easy Health Digest,8290,0,0,0,0,0,0,0
eWebinars,8165,0,0,0,0,0,0,0
7 Day Furniture,8301,0,0,0,0,0,0,0
Bigger Bidder,7307,0,0,0,0,0,0,0
Kareo,7975,6,2,0,8,0.75,0.25,0
Simplyhealth,8075,0,0,0,0,0,0,0
Iowa Hospice,7716,0,0,0,0,0,0,0
Way Better Snacks,8014,0,0,0,0,0,0,0
"Web Merchants, Inc.",7839,0,0,0,0,0,0,0
"Human Genome Sciences, Inc.",7507,0,0,0,0,0,0,0
Emergency Seed Bank,7516,0,0,0,0,0,0,0
Magnet Releasing,8377,0,0,0,0,0,0,0
FoodInsurance.com,8382,0,0,0,0,0,0,0
Honeydewdonuts.com,7158,0,0,0,0,0,0,0
Graphic Products,7161,0,0,0,0,0,0,0
"ECMO KOEI GAMES CO., LTD.",7979,0,0,0,0,0,0,0
St. Joseph's College,7712,0,0,0,0,0,0,0
The Lexington Philharmonic,8012,0,0,0,0,0,0,0
Storage Post,8080,0,0,0,0,0,0,0
Frick Art & Historical Center,8147,0,0,0,0,0,0,0
"Toktumi, Inc",8212,0,0,0,0,0,0,0
"CNY Cosmetic & Reconstructive Surgery, LLC",7511,0,0,0,0,0,0,0
"Ethicon Endo-Surgery, Inc.",8161,0,0,0,0,0,0,0
Seattle Bank,8162,0,0,0,0,0,0,0
Diamond in the Rough,8362,0,0,0,0,0,0,0
"TypePad, Inc.",8297,0,0,0,0,0,0,0
pegadaian.co,7525,0,0,0,0,0,0,0
Games & Things,8380,0,0,0,0,0,0,0
"Half Price Books, Records, Magazines, Incorporated.",8215,0,0,0,0,0,0,0
"Blue Cross and Blue Shield of Florida, Inc.",7847,0,0,0,0,0,0,0
Pierce County Washington,8158,0,0,0,0,0,0,0
Indianpolis Symphony Orchestra,7019,0,0,0,0,0,0,0
"Enzymatic Therapy, Inc.",6500,0,0,0,0,0,0,0
AeroGrow International,6917,0,0,0,0,0,0,0
Alaska USA Federal Credit Union,7032,0,0,0,0,0,0,0
WestJet,8087,3,0,3,6,0.5,0,0.5
Mizuno USA Inc.,6573,2,0,5,7,0.285714286,0,0.714285714
Braun Corporation,6577,0,0,0,0,0,0,0
Monmouth University,7770,9,3,0,12,0.75,0.25,0
Johnson County Community College,6217,0,0,0,0,0,0,0
"DrapeStyle, Inc.",6581,0,0,0,0,0,0,0
Little Caesar,6798,4,0,3,7,0.571428571,0,0.428571429
"AG Interactive, Inc.",7776,0,0,0,0,0,0,0
"AdvanceMe, Inc.",6800,0,0,0,0,0,0,0
Kikkor,6589,0,0,0,0,0,0,0
"HALO Innovations, Inc.",8097,0,0,0,0,0,0,0
"Social Concepts, Inc.",8093,0,0,0,0,0,0,0
SRU,6934,0,0,0,0,0,0,0
"Home Theater Cruise, LLC.",8100,0,0,0,0,0,0,0
"Demand Media, Inc.",6588,1,0,0,1,1,0,0
National Railroad Passenger Corporation,6594,5,0,8,13,0.384615385,0,0.615384615
Tristar Products Inc.,7777,1,0,0,1,1,0,0
"Altria Group, Inc.",6591,0,0,2,2,0,0,1
Telstra,6517,0,0,0,0,0,0,0
California Travel & Tourism Commission,8223,1,0,2,3,0.333333333,0,0.666666667
Gettington.com,8095,0,0,0,0,0,0,0
San Diego Golf Academy,8225,2,0,0,2,1,0,0
Pratt & Whitney Rocketdyne,8174,0,0,0,0,0,0,0
Maharishi Foundation USA,7778,0,0,0,0,0,0,0
Cox Auto,8180,0,0,0,0,0,0,0
HealthCompare Insurance Services,7100,0,0,0,0,0,0,0
"Museum of Science and Industry, Chicago",8177,0,0,0,0,0,0,0
Eden Advanced Pest Technologies,7102,0,0,0,0,0,0,0
Dictionary.com,8227,0,0,0,0,0,0,0
"Playboy Enterprises, Inc.",8090,0,0,1,1,0,0,1
State Compensation Insurance Fund,8228,0,0,0,0,0,0,0
PPR,8185,0,0,0,0,0,0,0
Sitecore,8395,0,0,0,0,0,0,0
R P Funding,8582,0,0,1,1,0,0,1
"Kohl's Illinois, Inc.",6579,125,3,12,140,0.892857143,0.021428571,0.085714286
Amare INC,8236,2,0,0,2,1,0,0
"AA Sports, Ltd.",8101,0,0,0,0,0,0,0
Eagle Bullion Group,7600,0,0,0,0,0,0,0
Reviance Plastic Surgery & Aesthetic Center,8570,0,0,0,0,0,0,0
Wahl Clipper,8394,4,0,1,5,0.8,0,0.2
O'Keeffe's Company,7595,0,1,0,1,0,1,0
ActiveState Software Inc.,8091,0,0,0,0,0,0,0
"Geographic Solutions, Inc.",8388,0,0,0,0,0,0,0
HTTO Group,8587,0,0,0,0,0,0,0
"Your Baby Is Christian, LLC.",7774,0,0,0,0,0,0,0
ACH Foods,8183,0,0,0,0,0,0,0
"PC Mall, Inc.",7781,0,0,0,0,0,0,0
The SCOOTER Store,8390,0,0,0,0,0,0,0
Campaign for Liberty,8181,0,0,0,0,0,0,0
IDA Ireland,6585,2,0,2,4,0.5,0,0.5
MediciGlobal,8392,0,0,0,0,0,0,0
Huntsman Cancer Institute,8578,0,0,0,0,0,0,0
East Carolina University,8234,0,0,0,0,0,0,0
Shape Collage Inc.,8235,0,0,0,0,0,0,0
Ronald Reagan Presidential Foundation and Library,8397,0,0,0,0,0,0,0
Rhapsody International,8222,34,20,1,55,0.618181818,0.363636364,0.018181818
Thomas Jefferson University Hospitals,8579,0,0,0,0,0,0,0
LifeBridge Health,8400,0,0,0,0,0,0,0
FreebiesEveryDay.net,8437,0,0,0,0,0,0,0
"PrivateBancorp, Inc.",7588,0,0,0,0,0,0,0
GrowNYC,6587,0,0,0,0,0,0,0
John Hancock Center,8233,0,0,0,0,0,0,0
"Ipswitch, Inc.",7599,0,0,0,0,0,0,0
Orb Audio,8401,0,0,0,0,0,0,0
Limelight Networks Inc.,7598,0,0,0,0,0,0,0
Four Seasons,8567,0,0,0,0,0,0,0
Fisher College of Business,8588,0,0,0,0,0,0,0
Cincinnati/North Kentucky International Airport,8592,0,0,0,0,0,0,0
NRC Realty & Capital Advisors,8569,0,0,0,0,0,0,0
West Coast Flooring Center,8232,0,0,0,0,0,0,0
IDL SERVICES INC.,8598,0,0,0,0,0,0,0
iGObanking.com,7589,0,0,0,0,0,0,0
Total Temperature Instrumentation,8591,0,0,0,0,0,0,0
MHN Hair Restoration,8576,0,0,0,0,0,0,0
Telogis,8590,0,0,0,0,0,0,0
GDSInternational,8402,0,0,0,0,0,0,0
Duke University Health System,8599,0,0,0,0,0,0,0
Games Workshop Limited,8602,0,0,0,0,0,0,0
MeetRealGUYS,8566,0,0,0,0,0,0,0
"WebMD, LLC.",6572,0,0,4,4,0,0,1
The Henry Ford,7772,1,0,0,1,1,0,0
West Jefferson Medical Center,8176,0,0,0,0,0,0,0
"The Ride, Inc.",7590,0,0,0,0,0,0,0
"IdeaPaint, Inc.",8583,0,0,0,0,0,0,0
Palladium Boots,6570,0,0,0,0,0,0,0
Madrone By Bosa,8092,0,0,0,0,0,0,0
GoFreeCredit.com,6595,3,0,1,4,0.75,0,0.25
Desert Botanical Garden,8399,0,0,0,0,0,0,0
Legacy Health System,8574,0,0,0,0,0,0,0
National Crime Prevention Council,8585,0,0,0,0,0,0,0
My Wedding Favors,6569,0,0,0,0,0,0,0
Travelex Currency Services Inc,6578,0,0,0,0,0,0,0
Intrax Inc.,6580,0,0,0,0,0,0,0
Qliance Medical Group of Washington PC,7773,0,0,0,0,0,0,0
The GOOD L.A. Fund,7780,0,0,0,0,0,0,0
Long Wharf Theatre,8173,1,0,0,1,1,0,0
"Acorda Therapeutics, Inc.",7782,4,0,1,5,0.8,0,0.2
"Assurant, Inc.",8175,0,0,0,0,0,0,0
"greenwood gaming and entertainment, inc.",8184,0,0,0,0,0,0,0
Shawnee Mission Medical Center,8575,0,0,0,0,0,0,0
KEEN,8577,6,0,5,11,0.545454545,0,0.454545455
"OSI RESTAURANT PARTNERS, LLC",6586,26,0,4,30,0.866666667,0,0.133333333
Levita LLC.,7783,0,0,0,0,0,0,0
Max Velasques,6597,0,0,0,0,0,0,0
Jewel Dunns River Resort,8226,0,0,0,0,0,0,0
"Gurwitch Products, LLC",7597,1,0,1,2,0.5,0,0.5
LIDS,8594,1,0,0,1,1,0,0
Softchoice,8601,0,0,0,0,0,0,0
"Mad Catz Interactive, Inc.",6571,0,0,0,0,0,0,0
IWC Schaffhausen,7775,0,0,0,0,0,0,0
Carrell Blanton Garrett & Van Horn,8182,0,0,0,0,0,0,0
Sino Biological Inc.,6575,1,0,0,1,1,0,0
PoorFish Outdoors,6576,0,0,0,0,0,0,0
Ballet Arizona,8094,2,0,0,2,1,0,0
Memorial Healthcare System,7779,0,0,0,0,0,0,0
HOP Movie,8179,0,0,0,0,0,0,0
"Daekyo Co, LTD",6590,0,0,0,0,0,0,0
Welcomebabyhome,6593,0,0,0,0,0,0,0
Sucker Punch Movie,8229,0,0,0,0,0,0,0
AR15outfitters.com,8398,0,0,0,0,0,0,0
Total Seal USA,7593,0,0,0,0,0,0,0
Everglades University,8086,0,0,0,0,0,0,0
"PayScale, Inc.",7771,0,0,0,0,0,0,0
Glacier Country Regional Tourism Commission,6584,0,0,0,0,0,0,0
North American Savings Bank,7784,0,0,0,0,0,0,0
Deluxe Enterprise Operations,8220,0,0,0,0,0,0,0
ConsumerFinanceTrends,8403,0,0,0,0,0,0,0
We Heart Freebies,8571,0,0,0,0,0,0,0
GameSamba,8573,0,0,0,0,0,0,0
Dominion,8603,0,0,1,1,0,0,1
PBS & WGBH Educational Foundation,6567,0,0,0,0,0,0,0
"Landry's, Inc.",8088,0,0,0,0,0,0,0
LetsTalk.com Inc.,7769,0,0,0,0,0,0,0
"iGuiders, Inc.",6599,0,0,0,0,0,0,0
Illinois Resorts Eagle Ridge Resort & Spa Galena Territory,8237,0,0,0,0,0,0,0
Longwood Gardens,8096,0,0,0,0,0,0,0
Puerto Rico Tourism Company,6592,2,0,0,2,1,0,0
Franklin Templeton Investments,8178,0,1,0,1,0,1,0
Manhattan College,8396,0,0,0,0,0,0,0
Glitz Toppers Incorporated,7592,0,0,0,0,0,0,0
Cars 4 Causes,8563,0,0,0,0,0,0,0
Paramount Equity Mortgage,8564,2,0,0,2,1,0,0
NEXT LEVEL FUNDING,8581,0,0,0,0,0,0,0
Generation Opportunity,8595,0,0,0,0,0,0,0
Barclays Bank PLC.,8089,1,1,1,3,0.333333333,0.333333333,0.333333333
Trademarkia,8098,0,0,0,0,0,0,0
Actuate Corporation,8391,0,0,0,0,0,0,0
Youth Basketball On-Line LLC,7591,0,0,0,0,0,0,0
Washington Hospital Center,7596,0,0,0,0,0,0,0
Bryan College,8568,0,0,0,0,0,0,0
"Fisico, Inc.",8593,0,0,0,0,0,0,0
Northern Ireland Tourist Board,7066,0,0,0,0,0,0,0
"Midwest Sports, Inc.",6064,0,0,0,0,0,0,0
Dade County Federal Credit Union,7083,0,0,0,0,0,0,0
"CBT Sports, LLC",7119,0,0,0,0,0,0,0
Bausch & Lomb Incorporated,7787,0,0,0,0,0,0,0
Eastern Bank,7322,0,0,1,1,0,0,1
Naturaful (DFLK Inc),7321,0,0,0,0,0,0,0
The Sewickley Spa,6832,0,0,0,0,0,0,0
KeyCorp.,7330,0,0,0,0,0,0,0
"CMI Marketing, Inc.",7323,2,2,1,5,0.4,0.4,0.2
National Council for Freedom & Enterprise,7334,0,0,0,0,0,0,0
Detachment Movie,7332,0,0,0,0,0,0,0
Village Theatre,7336,0,0,0,0,0,0,0
J. J. Keller & Associates,8610,0,0,0,0,0,0,0
Jefferson Performing Arts Society,6751,0,0,0,0,0,0,0
The Clinton Hotel & Spa South Beach,7788,0,0,0,0,0,0,0
St. Barnabas Health System,7333,0,0,0,0,0,0,0
Mobile Media Solutions,7266,0,0,0,0,0,0,0
Empire Vacations,7085,0,0,0,0,0,0,0
The Baker Companies,6081,0,0,0,0,0,0,0
San Francisco Museum of Modern Art,8614,0,0,0,0,0,0,0
Silicon Graphics International,7200,0,0,0,0,0,0,0
Four Seasons Heating and Air Conditioning,7341,1,0,0,1,1,0,0
TECH-NET Professional Auto Service,7345,0,0,0,0,0,0,0
"Rail Europe, Inc.",6651,0,0,0,0,0,0,0
"Agora Financial, LLC",7602,0,0,0,0,0,0,0
Grand Valley State University,7350,0,0,0,0,0,0,0
Performance Harley Davidson,8613,0,0,0,0,0,0,0
PTO Today,8191,0,0,0,0,0,0,0
Saveology,7324,0,0,0,0,0,0,0
Robson Communities,7349,0,0,0,0,0,0,0
Wells Enterprises,8612,0,0,0,0,0,0,0
Syracuse Stage,8198,0,0,0,0,0,0,0
Wet 'n Wild Inc.,7340,0,0,0,0,0,0,0
"City Ventures, Inc.",8611,0,0,0,0,0,0,0
"University of Georgia, Terry College of Business",8193,0,0,0,0,0,0,0
Ferrero,8644,0,0,0,0,0,0,0
University of Oklahoma,7353,0,0,0,0,0,0,0
Lifeline Theatre,8620,0,0,0,0,0,0,0
R&S Mattress,8123,0,0,0,0,0,0,0
University of Florida College of Pharmacy,8108,0,0,0,0,0,0,0
GoRenter .com,8643,0,0,0,0,0,0,0
Cincinnati Ballet,8623,0,0,0,0,0,0,0
Loanbox.net,8195,0,0,0,0,0,0,0
Startapp inc.,8616,0,0,0,0,0,0,0
U.S. Department of Justice,8125,0,0,0,0,0,0,0
IndiaLD.com,8627,0,0,0,0,0,0,0
Reloaded Productions Inc.,6602,0,0,0,0,0,0,0
William Grant & Sons,7364,0,0,1,1,0,0,1
Born Free,8634,0,0,0,0,0,0,0
"Poggled, Inc.",7331,0,0,0,0,0,0,0
Garden of Eden San Fransisco,8121,1,0,0,1,1,0,0
California Public Utilities Commission,8109,0,0,0,0,0,0,0
Fundly,8645,0,0,0,0,0,0,0
Giant of Maryland,8617,0,0,1,1,0,0,1
Catania & Catania,7354,0,0,0,0,0,0,0
Brosive,8196,0,0,0,0,0,0,0
Hancock Bank and Whitney Bank,8659,0,0,0,0,0,0,0
Zacks Investment Research,8104,0,0,3,3,0,0,1
ZarCalRes Tempe,7343,0,0,0,0,0,0,0
Mt. Rose Ski Tahoe,8631,0,0,0,0,0,0,0
Jeff D'Ambrosio Auto Group,8661,0,0,0,0,0,0,0
onlineprofitmasterssystem,8655,0,0,0,0,0,0,0
U.S. Air Force ROTC,8192,0,0,2,2,0,0,1
Colonial Marble & Granite,8626,0,0,0,0,0,0,0
Designtaglessthreads.com,8446,0,0,0,0,0,0,0
Gunnebo Johnson Corporation,8652,0,0,0,0,0,0,0
CheapCruises.com,8635,0,0,0,0,0,0,0
GaelSong,8624,0,0,0,0,0,0,0
J.S. Hovnanian & Sons,8202,0,0,0,0,0,0,0
InnoCentive,8114,0,0,0,0,0,0,0
Marina District Development Company,8199,0,0,0,0,0,0,0
Table for Six,8439,0,0,0,0,0,0,0
All About Dance,8640,0,0,0,0,0,0,0
October Baby Movie,8803,0,0,0,0,0,0,0
Seidio Inc.,7366,0,0,0,0,0,0,0
Patricia & Arthur Modell Performing Arts Center,7371,0,0,0,0,0,0,0
"DerivActiv, LLC.",8127,0,0,0,0,0,0,0
LQ Management,8452,0,0,0,0,0,0,0
PersonalTrainingBelmont.com,8636,0,0,0,0,0,0,0
The Atlantic Media Company,8647,2,0,0,2,1,0,0
nCircle Network Security,7363,0,0,0,0,0,0,0
Scottsdale Area Chamber of Commerce,8725,0,0,0,0,0,0,0
M.S. Howells & Co.,8721,0,0,0,0,0,0,0
Home Dynamics,8660,0,0,1,1,0,0,1
Abbott Jewelry Systems,8726,0,0,0,0,0,0,0
hobbyKing.com,8681,0,0,0,0,0,0,0
"Nicalis, Inc.",8445,0,0,0,0,0,0,0
Szmanias,7379,0,0,0,0,0,0,0
make-mobile-money.com,8197,0,0,0,0,0,0,0
2ndSite Inc.,8638,16,0,1,17,0.941176471,0,0.058823529
Florida International University,8876,1,0,0,1,1,0,0
Neighborhood Reinvestment,8724,0,0,0,0,0,0,0
amazonabc International School,8134,0,0,0,0,0,0,0
Capital Automotive,8204,0,0,0,0,0,0,0
First Data Corporation,7384,0,0,0,0,0,0,0
HomeServicesQuotes.com,8642,0,0,0,0,0,0,0
Municipal Credit Union,8670,3,0,0,3,1,0,0
"C.H. Guenther & Son, Inc.",8954,0,0,0,0,0,0,0
Mental Health Center of Denver,8629,0,0,0,0,0,0,0
"Consumer Education Group, Inc.",8878,0,0,0,0,0,0,0
Longboat Key Club & Resort,8666,0,0,0,0,0,0,0
"The Raymond F. Kravis Center for the Performing Arts, Inc.",8730,0,0,0,0,0,0,0
ThoseShirts.com,8956,0,0,0,0,0,0,0
Charlotte Regional Visitors Authority,8132,0,0,0,0,0,0,0
Rainbow Light,8879,0,0,0,0,0,0,0
AAXA Technologies Inc.,8675,0,0,0,0,0,0,0
Citrus County Systems Management,8672,0,0,0,0,0,0,0
Innovation Norway,8664,0,0,0,0,0,0,0
Roilife,7383,0,0,0,0,0,0,0
St. Catherine University,8728,0,0,0,0,0,0,0
Siding-HomeQuote.com,8678,0,0,0,0,0,0,0
TherapyNotes,8727,0,0,0,0,0,0,0
Midway College,8885,1,0,0,1,1,0,0
Pittsburgh Symphony Orchestra,8734,0,0,0,0,0,0,0
RCI - Rogers Shared Services,8738,0,0,0,0,0,0,0
The Bump Network,8736,1,0,1,2,0.5,0,0.5
Lindon Farms,8887,0,0,0,0,0,0,0
Natural Resources Defense Council,8682,0,0,0,0,0,0,0
"Lyngso Garden Materials, Inc.",8955,0,0,0,0,0,0,0
Oregon Tourism Commission,8875,0,0,0,0,0,0,0
Three Stooges Movie,8667,0,0,0,0,0,0,0
The Bizarre Bazaar,8881,0,0,0,0,0,0,0
americansforgeorge.org,8877,0,0,0,0,0,0,0
"American Eagle Associates, Inc.",8946,0,0,0,0,0,0,0
CashAdvance.com,8735,0,0,0,0,0,0,0
Van Cliburn Foundation,9014,0,0,0,0,0,0,0
Cunningham Trading Systems,8953,0,0,0,0,0,0,0
CareFusion Corporation,9017,0,0,0,0,0,0,0
French Market Corporation,7326,0,0,0,0,0,0,0
SproutWatches.com,7344,0,0,0,0,0,0,0
GIGA-BYTE TECHNOLOGY CO.,8648,0,0,0,0,0,0,0
Texans Can!,8130,0,0,0,0,0,0,0
Adolf Jewelers,8444,0,0,0,0,0,0,0
"Ted's Montana Grill, Inc.",8662,0,0,0,0,0,0,0
Global Wine Company,8447,1,0,0,1,1,0,0
Closet Factory,7376,0,0,0,0,0,0,0
America's Life Insurance Industry,8665,0,0,0,0,0,0,0
Totes Isotoner Corporation,8880,0,0,0,0,0,0,0
Printable-Greetings.com,8947,0,0,0,0,0,0,0
"Speedway Motorsports, Inc.",9015,0,0,0,0,0,0,0
New Era Tickets,9016,0,0,0,0,0,0,0
AffiliateSystem.us,7327,0,0,0,0,0,0,0
TBDrecords.com,7328,0,0,0,0,0,0,0
PEI  Licensing,8110,3,0,0,3,1,0,0
Florida Classic Consortium / Florida Citrus Sports,8113,0,0,0,0,0,0,0
Algoma Kinniwabi Travel Association,7359,0,0,0,0,0,0,0
The Sunway Group,7360,0,0,0,0,0,0,0
Cape Cod Symphony Orchestra,8128,0,0,0,0,0,0,0
Nova Mining Corp.,8663,0,0,0,0,0,0,0
"The FairWeather Group, Inc.",8731,1,0,1,2,0.5,0,0.5
Barber Motorsports Park,8882,0,0,0,0,0,0,0
Encyclopædia Britannica,8188,1,0,0,1,1,0,0
DetergentTruth.net,6601,0,0,0,0,0,0,0
Greater Newport Physicians,8622,0,0,0,0,0,0,0
Cock and Bull Theatre,8120,0,0,0,0,0,0,0
Foxit,8656,0,0,0,0,0,0,0
A Plus Federal Credit Union,7369,0,0,0,0,0,0,0
LG&E and KU,8722,1,0,0,1,1,0,0
Empowered Media,8639,0,0,0,0,0,0,0
H.D. Buttercup,8135,0,0,0,0,0,0,0
Thompson Cigar Inc.,7355,1,0,0,1,1,0,0
The Stop & Shop Supermarket Company,8625,0,0,0,0,0,0,0
The Peabody Essex Museum,8200,0,0,0,0,0,0,0
Kean University,7362,0,0,1,1,0,0,1
City National Bank,8800,20,2,0,22,0.909090909,0.090909091,0
Hartford Stage Company,8802,0,0,0,0,0,0,0
Jewish Community Center of San Francisco,7339,0,0,0,0,0,0,0
CyberDefender Corp.,7346,0,0,0,0,0,0,0
Betteridge,7348,0,0,0,0,0,0,0
StandArt Solutions,8650,0,0,0,0,0,0,0
And They're Off Movie,7373,0,0,0,0,0,0,0
eSignal,8450,0,0,0,0,0,0,0
DermStore,7382,0,0,0,0,0,0,0
Blue Cross and Blue Shield MD,8686,0,0,0,0,0,0,0
Drug-Rehab.org,8943,0,0,0,0,0,0,0
lookoutmovies.com,9018,0,0,0,0,0,0,0
Bully Movie,9020,0,0,0,0,0,0,0
"Blue Cross Blue Shield of Tennessee, Inc.",7320,0,0,0,0,0,0,0
Loblaws Inc.,7335,0,0,0,0,0,0,0
Hello Music,8103,0,0,0,0,0,0,0
Big Sky Resort,8105,0,0,0,0,0,0,0
SquareTrade,7352,0,0,0,0,0,0,0
Donnelly for Indiana,7852,0,0,0,0,0,0,0
Decca Music Group Limited,8654,0,0,0,0,0,0,0
Miccosukee Tribe,8203,1,0,2,3,0.333333333,0,0.666666667
Liftopia,7367,0,0,0,0,0,0,0
"Saturn Systems, Inc.",8720,0,0,0,0,0,0,0
Blue Note Jazz Club,8737,0,0,0,0,0,0,0
"Robbins Research International, Inc.",8941,0,0,0,0,0,0,0
HumanEvents.com,8888,0,0,0,0,0,0,0
AirWatch,8658,2,0,0,2,1,0,0
Roots Canada,8126,0,0,0,0,0,0,0
Bombardier Inc.,8719,5,0,1,6,0.833333333,0,0.166666667
"School of the Legends, LLC",8801,0,0,0,0,0,0,0
Altius Education,8683,0,0,0,0,0,0,0
The Cabin in the Woods Movie,9012,0,0,0,0,0,0,0
"Exude, Inc.",8609,0,0,0,0,0,0,0
International Merchandising Corporation,7337,0,0,0,0,0,0,0
Lafayette Convention & Visitors Commission,8107,0,0,0,0,0,0,0
THE BASEMENT GUYS,8618,2,0,0,2,1,0,0
Good Sam Club,8441,0,0,0,0,0,0,0
Blue Saturn Media,7380,0,0,0,0,0,0,0
"Wet Seal, Inc.",8884,0,0,0,0,0,0,0
U.S. News Rankings & Reviews,8886,0,0,0,0,0,0,0
Audemars Piguet,8952,0,0,0,0,0,0,0
SCA Tissue,7347,0,0,0,0,0,0,0
Lincoln CityVisitor and Convention Bureau,8190,0,0,0,0,0,0,0
Mack-Cali Realty Corporation,8619,0,0,0,0,0,0,0
Clay Lacy Aviation,8651,0,0,0,0,0,0,0
Pittsburgh CLO,8201,0,0,0,0,0,0,0
"The County of Santa Clara, CA",8633,0,0,0,0,0,0,0
Primavera Sound,7365,0,0,0,0,0,0,0
The Toledo Walleye,8440,0,0,0,0,0,0,0
Roosevelt University,7372,0,0,0,0,0,0,0
Cutters Gloves,8133,0,0,0,0,0,0,0
"GLOGSTER EC, INC.",8669,0,0,1,1,0,0,1
Sodexo,8951,0,0,0,0,0,0,0
extrimvideoplayer.com,9019,0,0,0,0,0,0,0
Children's Miracle Network Hospitals,7325,0,0,0,0,0,0,0
Joslyn Art Museum,8615,0,0,0,0,0,0,0
Ramada Worldwide,8112,0,0,0,0,0,0,0
CRC Health Group Inc.,7358,0,0,0,0,0,0,0
The Dispatch Printing Company,7361,1,0,0,1,1,0,0
Vessel,8129,0,0,0,0,0,0,0
Leonard N. Stern School of Business,8679,0,0,0,0,0,0,0
QC Career School,8948,1,0,0,1,1,0,0
Bastyr Center for Natural Health,7338,0,0,0,0,0,0,0
Paste Media Group,8106,0,0,0,0,0,0,0
Opegi Holdings,8649,0,0,0,0,0,0,0
"Restore Our Future, Inc.",8117,0,0,0,0,0,0,0
mymariogames.com,7356,0,0,0,0,0,0,0
American Dairy Association Mideast,8124,1,0,1,2,0.5,0,0.5
The Sallie Mae Fund,8442,0,0,0,0,0,0,0
Synology Inc.,8131,0,0,0,0,0,0,0
Morton Buildings,7381,0,0,1,1,0,0,1
Xavier University,8674,0,0,0,0,0,0,0
Raisio Group,8685,0,0,0,0,0,0,0
Curata,8942,0,0,0,0,0,0,0
NRA (National Rifle Association),7400,1,0,0,1,1,0,0
ShoWare Center,7470,0,0,0,0,0,0,0
Better Business Bureau,6866,4,0,0,4,1,0,0
Teletrade,8454,0,0,0,0,0,0,0
University of Mary Washington,7534,0,0,0,0,0,0,0
"IncFile.com, LLC",7651,0,0,0,0,0,0,0
Art Gallery of Ontario,8690,0,0,0,0,0,0,0
Fitzpatrick Advertising,8460,0,0,0,0,0,0,0
NichePanda,7736,0,0,0,0,0,0,0
Schwabe  North America,8461,0,0,0,0,0,0,0
Princeton Vanguard LLC.,7887,0,0,2,2,0,0,1
National Ethics Association,8467,0,0,0,0,0,0,0
Mythical Gaming LLC,9029,0,0,0,0,0,0,0
"Dollar Tree, Inc.",7436,0,0,0,0,0,0,0
veryawesomeworld.com,9027,0,0,0,0,0,0,0
MyEdiscovery,8474,0,0,0,0,0,0,0
Blue Cross and Blue Shield of North Carolina,7217,0,0,0,0,0,0,0
LaCie USA,9030,0,0,0,0,0,0,0
Nestle Waters North America Inc.,9034,4,1,2,7,0.571428571,0.142857143,0.285714286
"Gamania Digital Entertainment Co., Ltd.",7819,0,0,0,0,0,0,0
Chicago the Musical,9033,0,0,0,0,0,0,0
Community Television of Southern California,7653,0,0,0,0,0,0,0
Delta Dental Plans Association,7904,0,0,1,1,0,0,1
G4Box Inc.,7821,0,0,0,0,0,0,0
Lions Eye Institute for Transplant & Research,8697,0,0,0,0,0,0,0
Jinfonet Software,7149,0,0,0,0,0,0,0
"Train Show, Inc",9023,0,0,0,0,0,0,0
WestBeth Entertainment,9041,0,0,0,0,0,0,0
National Fire Protection Association,8464,0,0,0,0,0,0,0
Allstate Sugar Bowl,8695,0,0,0,0,0,0,0
Levin Furniture,8699,0,0,0,0,0,0,0
Breitling SA,8827,0,0,1,1,0,0,1
MIGHTY FINE,9035,0,0,0,0,0,0,0
Clear Compass Media,8691,0,0,0,0,0,0,0
Diamond Nexus,8244,0,0,0,0,0,0,0
GunBroker.com,8323,0,0,1,1,0,0,1
Netlink Computer Inc,8472,0,0,0,0,0,0,0
OutdoorBunker.com,8249,0,0,0,0,0,0,0
Sennheiser Electronic Corporation,8478,3,0,0,3,1,0,0
Barona Valley Ranch Resort & Casino,8500,0,0,0,0,0,0,0
Cross-Cultural Solutions,8806,0,0,0,0,0,0,0
"ASAP Checks, Forms & Supplies",8465,0,0,0,0,0,0,0
ConcreteNetwork.com,8264,0,0,0,0,0,0,0
American Cheerleader Media,8477,0,0,0,0,0,0,0
"Charity Cars, Inc.",8260,0,0,0,0,0,0,0
"Chattem, Inc.",9038,0,0,0,0,0,0,0
Conduit,8693,0,0,0,0,0,0,0
"Horizon Services, Inc",8816,0,0,0,0,0,0,0
Harvard Eye Associates,8032,0,0,0,0,0,0,0
"Lumos Labs, Inc.",8255,104,2,2,108,0.962962963,0.018518519,0.018518519
Lennox International,8306,3,0,0,3,1,0,0
Van Metre Homes,8705,0,0,0,0,0,0,0
"Big Y Foods, Inc.",9061,0,0,0,0,0,0,0
ZQGame Inc.,8706,0,0,0,0,0,0,0
"Northside Hospital, Inc.",8468,0,0,1,1,0,0,1
New American Funding,9046,0,0,0,0,0,0,0
Carbis,8968,0,0,0,0,0,0,0
American Federation of Teachers,8702,0,0,0,0,0,0,0
Pacific Bioscience Laboratories Inc.,8487,6,1,0,7,0.857142857,0.142857143,0
icstars.org,8713,0,0,0,0,0,0,0
Clowes Memorial Hall,8694,0,0,0,0,0,0,0
"Steinhafels, Inc",8821,0,0,0,0,0,0,0
Federal Realty Investment Trust,8810,0,0,0,0,0,0,0
SOLON Energy,8266,0,0,0,0,0,0,0
Brown Shoe Company,8485,5,0,4,9,0.555555556,0,0.444444444
INTRUST Bank,8836,0,0,0,0,0,0,0
Delaware North Companies,9042,0,0,0,0,0,0,0
Wright Express Corporation,8823,0,0,0,0,0,0,0
The Table Group Inc.,8021,0,0,0,0,0,0,0
EMC Security,9037,0,0,1,1,0,0,1
"Britax Child Safety, Inc.",8709,0,0,0,0,0,0,0
LessLoss Audio,8486,0,0,0,0,0,0,0
William K Busch Brewing Company,8970,0,0,0,0,0,0,0
The University of Alabama in Huntsville,8479,0,0,0,0,0,0,0
Oilily,8825,0,0,0,0,0,0,0
Main Street Homes,9068,0,0,0,0,0,0,0
iGear USA,8261,0,0,0,0,0,0,0
Cobra Golf,8270,0,0,0,0,0,0,0
Vacationcruisesinfo.com,9093,0,0,0,0,0,0,0
"University of California, Riverside",9050,0,0,0,0,0,0,0
"Pugster, Inc.",8262,0,0,0,0,0,0,0
ProTrainings,8504,0,0,0,0,0,0,0
New Stone Remodeling,9100,0,0,0,0,0,0,0
"LoyaltyOne, Inc.",8313,0,0,0,0,0,0,0
Adelphi University,8488,0,0,0,0,0,0,0
Patek Philippe S.A.,8819,0,0,0,0,0,0,0
Tourism Hamilton Inc.,8246,0,0,0,0,0,0,0
"Silver Peak Systems, Inc.",8282,0,0,0,0,0,0,0
Search Mojo,8024,0,0,0,0,0,0,0
ArmaLite Inc,8036,0,0,2,2,0,0,1
The Smart Style Living,8321,0,0,0,0,0,0,0
AirportParkingReservations.com,8958,0,0,0,0,0,0,0
Vantage Properties,8495,0,0,0,0,0,0,0
Soho Press,8310,0,0,0,0,0,0,0
Ashworth College,9047,0,0,0,0,0,0,0
Mercury Marine,8742,0,0,0,0,0,0,0
Questa at Mountain House,9057,0,0,0,0,0,0,0
Montelucia Resort & Spa,8027,0,0,0,0,0,0,0
Killer Keyboards Made Simple,9056,0,0,0,0,0,0,0
Derzon-Menard,9051,0,0,0,0,0,0,0
The Iridium,8843,0,0,0,0,0,0,0
MAC Cosmetics,8028,0,0,2,2,0,0,1
Teltech Systems,8717,0,0,0,0,0,0,0
League of Conservation Voters,8025,0,0,0,0,0,0,0
SRI Shoe Warehouse,8506,0,0,0,0,0,0,0
Webvet,8031,0,0,0,0,0,0,0
Databazaar.com,8745,0,0,0,0,0,0,0
Newzoobles.com,9048,0,0,0,0,0,0,0
RICHARDSON.COM,8332,0,0,0,0,0,0,0
FaithfulMates.com,8753,0,0,0,0,0,0,0
StemCyte,8509,1,0,0,1,1,0,0
Sullivan University Inc.,8840,0,0,0,0,0,0,0
Children's Hospitals and Clinics of Minnesota,8334,0,0,0,0,0,0,0
The City of New York School of Professional Studies,8831,0,0,0,0,0,0,0
J. Choo Ltd,8852,0,0,0,0,0,0,0
CopierRepairMan.com,8972,0,0,0,0,0,0,0
Broad Financial,9053,0,0,0,0,0,0,0
"Wildfire Interactive, Inc.",8481,0,0,3,3,0,0,1
"Moet Hennessy USA, Inc.",9089,0,0,1,1,0,0,1
American Association for the Advancement of Science,8035,0,0,0,0,0,0,0
Keeney Manufacturing,8715,0,0,0,0,0,0,0
MadCap Software,8331,0,0,0,0,0,0,0
JW Desert Ridge Resort,9074,0,0,0,0,0,0,0
Memory Wellness Program,8499,0,0,0,0,0,0,0
"The American Society of Composers, Authors and Publishers",9070,0,0,0,0,0,0,0
Utah Office of Tourism,9064,5,0,6,11,0.454545455,0,0.545454545
buyCTbonds,8494,0,0,0,0,0,0,0
FastUpFront,8335,0,0,0,0,0,0,0
Premier Dermatology,9091,0,0,0,0,0,0,0
Think Like a Man Movie,9067,0,0,0,0,0,0,0
Maegica.com,8516,0,0,0,0,0,0,0
"Pandora Media, Inc.",8498,0,0,0,0,0,0,0
Dreambrides2011.com,8026,0,0,0,0,0,0,0
Kohler Co.,9164,0,0,0,0,0,0,0
Famous Artists Broadway,8962,0,0,0,0,0,0,0
World Food Programme,8263,0,0,0,0,0,0,0
Superb Internet Corp.,8329,0,0,0,0,0,0,0
Newark Museum,9118,0,0,0,0,0,0,0
"First Marblehead Education Resources, Inc.",8838,0,0,0,0,0,0,0
BRP,8849,0,0,0,0,0,0,0
Apple Orthodontix,9085,1,0,0,1,1,0,0
Single Trip Holiday Insurance and Cheap Single Trip Insurance,8971,0,0,0,0,0,0,0
Web Tires,9168,0,0,0,0,0,0,0
Brothers & Co.,8330,0,0,0,0,0,0,0
"Mad Anthonys, Inc.",8520,0,0,0,0,0,0,0
One&Only Resorts,9106,0,0,0,0,0,0,0
Diroddi,8833,0,0,0,0,0,0,0
hayabusafight.com,9167,0,0,0,0,0,0,0
Web2Carz.com,8510,0,0,0,0,0,0,0
CaliforniaDebtRelief.org,9078,0,0,0,0,0,0,0
VeriHull,8517,0,0,0,0,0,0,0
WD-40 Company,9081,0,0,0,0,0,0,0
The McClatchy Company,9099,4,0,4,8,0.5,0,0.5
Indexed Annuities Leadership Council,8853,0,0,0,0,0,0,0
xkcd.com,9108,1,0,0,1,1,0,0
Demys,9235,0,0,0,0,0,0,0
Marylhurst College,9110,0,0,0,0,0,0,0
Engolish.com,9095,0,0,0,0,0,0,0
YouFit,9117,0,0,0,0,0,0,0
RelativelySpeakingBroadway.com,9102,0,0,0,0,0,0,0
Lumiday,8501,0,0,0,0,0,0,0
Gulfstream Park,9104,0,0,0,0,0,0,0
Quick Hit,8333,0,0,0,0,0,0,0
Gotime.com,9049,0,0,0,0,0,0,0
Gooding Construction Company,8966,0,0,0,0,0,0,0
"Music Mastermind, Inc.",9121,0,0,0,0,0,0,0
Cape Cod Fitness Company,9069,0,0,0,0,0,0,0
T & L Enterprises,9123,0,0,0,0,0,0,0
ZeoBIT LLC,9119,0,0,0,0,0,0,0
BetterOffers.com,8281,0,0,0,0,0,0,0
SAMSUNG & Samsung Hope for Children,8746,0,0,0,0,0,0,0
Mazda Dealerships,8964,1,0,1,2,0.5,0,0.5
San Francisco Travel Association,9083,0,0,0,0,0,0,0
"Muroc Systems, Inc.",8846,0,0,0,0,0,0,0
Books-A-Million,8515,0,0,0,0,0,0,0
ResourceAdvisor.info,9115,0,0,0,0,0,0,0
Pacific College of Oriental Medicine,9163,0,0,0,0,0,0,0
QuickWebPlayer,8513,0,0,0,0,0,0,0
Banterit.com,9028,0,0,0,0,0,0,0
Greenleaf Book Group,8692,0,0,0,0,0,0,0
WatchIndia,8242,0,0,0,0,0,0,0
"Shoutlet, Inc.",8256,0,0,0,0,0,0,0
Sotheby's,8710,0,0,0,0,0,0,0
True Value Company,8267,11,0,0,11,1,0,0
WIND Mobile,8492,4,7,0,11,0.363636364,0.636363636,0
Polar Electro,8960,0,0,0,0,0,0,0
Ellery Homestyles,8828,0,0,0,0,0,0,0
Sands Casino Resort Bethlehem,8324,0,0,2,2,0,0,1
Holy Cross Hospital,9060,0,0,0,0,0,0,0
Advocate Health Care,8967,0,0,0,0,0,0,0
InterSport Inc.,8835,0,0,0,0,0,0,0
Charmingdate.com,8842,11,0,0,11,1,0,0
"DMB Associates, Inc",9160,0,0,0,0,0,0,0
Myfotosource.com,9092,0,0,0,0,0,0,0
The Free Lance-Star,9103,0,0,0,0,0,0,0
Spearmint Rhino Online,8475,0,0,1,1,0,0,1
Emerging Vision,8241,0,0,0,0,0,0,0
Pacific Columns,8243,0,0,0,0,0,0,0
University of Pittsburgh,8818,0,0,0,0,0,0,0
World of Decor Auctions,8484,1,0,0,1,1,0,0
America's Milk Processors,8307,0,0,0,0,0,0,0
"Goodwill Industries, Inc.",9045,1,0,0,1,1,0,0
RAISE YOUR VOICE,8316,0,0,0,0,0,0,0
Candlewick Press,9052,0,0,0,0,0,0,0
The Patrick Group,8841,0,0,0,0,0,0,0
EVERYBODY LOVES OUR TOWN,8845,0,0,0,0,0,0,0
Lake Chelan Chamber of Commerce,9086,0,0,0,0,0,0,0
JES Construction,9079,0,0,0,0,0,0,0
Billy.com,8518,1,0,0,1,1,0,0
Akoo Theatre at Rosemont,9120,0,0,0,0,0,0,0
All Mobile Future,8458,0,0,0,0,0,0,0
Shawnee State University,8469,0,0,0,0,0,0,0
BBB of Chicago & Northern Illinois,8240,0,0,0,0,0,0,0
Door County Chamber of Commerce,8476,0,0,0,0,0,0,0
"Florida Telecommunications Relay, Inc.",8483,0,0,0,0,0,0,0
"CK Franchising, Inc.",8258,11,0,1,12,0.916666667,0,0.083333333
Sono Bello,9044,2,0,0,2,1,0,0
Today's Patio,8826,0,0,0,0,0,0,0
"Clickatell, Inc.",8022,0,0,0,0,0,0,0
New World Symphony,8276,0,0,0,0,0,0,0
Cleveland Metroparks,8744,0,0,0,0,0,0,0
Chilean Avocado Importers Association,8326,0,0,0,0,0,0,0
Louisiana Seafood Board,8283,0,0,0,0,0,0,0
flvplayerpro.net,9062,0,0,0,0,0,0,0
Handi-Craft Company,8969,0,0,2,2,0,0,1
The Washington Times,9087,0,0,0,0,0,0,0
Employer Support of the Guard and Reserve,8851,0,0,0,0,0,0,0
Eastern Surf Magazine,9076,0,0,0,0,0,0,0
MG On The Halifax,9101,0,0,0,0,0,0,0
Market Place @ Factoria,9112,0,0,0,0,0,0,0
"Bissell Homecare, Inc.",8482,0,0,0,0,0,0,0
Burton Plumbing,9043,0,0,0,0,0,0,0
ConvertLibre,8820,0,0,0,0,0,0,0
Slumberland,8711,0,0,0,0,0,0,0
NCIX.com,8716,0,0,0,0,0,0,0
neogenis.com,8273,0,0,0,0,0,0,0
Kaspersky Lab ZAO,8741,5,0,0,5,1,0,0
The Cleveland Orchestra and the Musical Arts Association,8750,0,0,0,0,0,0,0
"City of Largo, Florida",8752,0,0,0,0,0,0,0
Queens University of Charlotte,8507,0,0,0,0,0,0,0
Learning Games For Kids,9084,1,0,0,1,1,0,0
Santa Clara Valley Water District,8850,0,0,0,0,0,0,0
a10.com,9075,0,0,0,0,0,0,0
news14channel.com,9077,0,0,0,0,0,0,0
"Profits Run, Inc.",9109,0,0,0,0,0,0,0
Gilroy Gardens,8698,1,0,0,1,1,0,0
Fortis College,8480,0,0,0,0,0,0,0
Santa Rosa Co. Tourist Development Council,8815,0,0,0,0,0,0,0
Callaway Gardens,8712,0,0,0,0,0,0,0
Disability Application Center,8312,0,0,0,0,0,0,0
Sauder Woodworking Co.,8279,0,0,0,0,0,0,0
Gimpdownloads.com,8280,0,0,0,0,0,0,0
The Developers Group,8830,0,0,0,0,0,0,0
Somae Health,8497,0,0,0,0,0,0,0
YMCA Twin Cities,8029,0,0,0,0,0,0,0
Vitas.com,8848,0,0,1,1,0,0,1
Ciena Corporation,9098,0,0,0,0,0,0,0
Mac Haik Auto Group,9233,0,0,0,0,0,0,0
"FORMULA HOLDINGS, Inc.",8311,6,0,1,7,0.857142857,0,0.142857143
League for Gamers,8747,0,0,0,0,0,0,0
Landmark Hotels Group,8965,0,0,0,0,0,0,0
MiniUstorage.com,9066,0,0,0,0,0,0,0
Travel Portland,8511,0,0,2,2,0,0,1
Community Choice Credit Union,8512,0,0,0,0,0,0,0
Grupo SOS,9165,0,0,0,0,0,0,0
PrizeLogic,9166,0,0,0,0,0,0,0
"Gainesville Coins, Inc.",9080,0,0,0,0,0,0,0
Oliviamaebeauty.com,9097,0,0,0,0,0,0,0
Roundy's Supermarkets Inc.,9116,0,0,0,0,0,0,0
Kittle's Home Furnishings,9024,0,0,0,0,0,0,0
Girl Scouts Council of Eastern Pennsylvania,8805,0,0,0,0,0,0,0
HomeShop18,8252,0,0,0,0,0,0,0
Direct Checks Unlimited Sales,8254,0,0,0,0,0,0,0
Ensemble Travel Group,8707,0,0,0,0,0,0,0
Yuna Software,9026,0,0,0,0,0,0,0
Zoro Tools,8808,0,0,0,0,0,0,0
Crafty Studios Game,8251,0,0,0,0,0,0,0
A.T. Still University,8701,0,0,0,0,0,0,0
Nikon Corporation,8033,0,0,0,0,0,0,0
DriverManager.com,8508,0,0,0,0,0,0,0
Triple Door,9169,0,0,0,0,0,0,0
Lodi-Woodbridge Winegrape Commission,9094,17,1,0,18,0.944444444,0.055555556,0
Subaru,8519,54,12,6,72,0.75,0.166666667,0.083333333
Bindertek,9237,0,0,0,0,0,0,0
IndieCharts.com,7151,0,0,0,0,0,0,0
MR Direct,7453,0,0,0,0,0,0,0
Volkswagen DriverGear,7953,0,0,0,0,0,0,0
GPLB.Com,9128,0,0,0,0,0,0,0
South Shore Hospital,8760,0,0,0,0,0,0,0
Barton Publishing,9135,0,0,0,0,0,0,0
Homecare.com,8763,0,0,0,0,0,0,0
Robertson-Brothers.com,9132,0,0,0,0,0,0,0
"International Information Systems Security Certification Consortium, Inc.",7302,0,0,0,0,0,0,0
car_provide-insurance.com,8759,0,0,0,0,0,0,0
stardot-tech.com,9138,0,0,0,0,0,0,0
New Orleans Opera,8766,0,0,0,0,0,0,0
Outrigger Hotels Hawaii,8337,2,0,0,2,1,0,0
Paige Denim,8338,0,0,0,0,0,0,0
PRIMARY ACCOUNTABILITY PAC,9140,0,0,0,0,0,0,0
ConsumerHeadlines.org,9141,0,0,0,0,0,0,0
Premiere Marquee Club,9129,0,0,0,0,0,0,0
"JAKKS Pacific, Inc.",7685,0,0,0,0,0,0,0
Targetjobs,8768,0,0,1,1,0,0,1
Cinema Village,9142,0,0,0,0,0,0,0
Palo Alto Networks,8345,0,0,0,0,0,0,0
"SonicWALL, Inc.",7485,0,0,0,0,0,0,0
JPS Labs,8346,1,0,0,1,1,0,0
"THOMPSON INVESTMENT MANAGEMENT, INC.",8890,0,0,0,0,0,0,0
Empire State College,8002,0,0,0,0,0,0,0
CAPITAL SAFETY,9146,0,0,0,0,0,0,0
"Lawn Doctor, Inc.",8356,0,0,0,0,0,0,0
Elk Grove Auto Mall,7487,0,0,0,0,0,0,0
Blues Guitar Unleashed,9149,0,0,0,0,0,0,0
The Indian Hotels Company Limited,9175,0,0,0,0,0,0,0
AutoEurope LLC,7834,0,0,0,0,0,0,0
Doral Golf Resort and Spa,8896,0,0,0,0,0,0,0
Evans-Brown Mortuary,9156,0,0,0,0,0,0,0
Audibel,8072,0,0,1,1,0,0,1
CouponCabin,8771,0,0,0,0,0,0,0
Columbia College Chicago,7987,0,0,0,0,0,0,0
QlikTech International AB,7502,0,0,0,0,0,0,0
Deal Fun Inc.,6566,0,0,0,0,0,0,0
Tampa Museum of Art,8085,0,0,0,0,0,0,0
Mira Lumen,9181,0,0,0,0,0,0,0
"SPIGEN, Inc",8353,0,0,0,0,0,0,0
Study Group,8900,0,0,0,0,0,0,0
"BedandBreakfast.com, Inc.",8905,1,0,0,1,1,0,0
IndiePix Unlimited,8892,0,0,0,0,0,0,0
ColRich Communities,8781,0,0,0,0,0,0,0
Bozeman Convention & Visitors Bureau,9155,0,0,0,0,0,0,0
IdealLaserExperts.com,9195,0,0,0,0,0,0,0
"Freedom Motors, Inc.",9157,0,0,0,0,0,0,0
Paragon Technologies,9324,0,0,0,0,0,0,0
Generation Mortgage Company,8899,0,0,0,0,0,0,0
Diamond Foods Inc.,8981,0,0,0,0,0,0,0
The Audiocom Group,9422,0,0,0,0,0,0,0
The Diocese of San Jose,9332,0,0,0,0,0,0,0
BlueStack,9134,0,0,0,0,0,0,0
Alfred Angelo,9178,0,0,2,2,0,0,1
Jarden Corporation,8138,7,0,2,9,0.777777778,0,0.222222222
Silver Dollar City,9151,0,0,0,0,0,0,0
"Alfresco Software, Inc.",8891,0,0,0,0,0,0,0
Brightwater Woodbridge Pacific Group,9310,0,0,0,0,0,0,0
The Art Institute of Chicago,8782,0,0,0,0,0,0,0
Barbizon Modeling,8341,0,0,0,0,0,0,0
Clackamas County,8894,0,0,0,0,0,0,0
VELUX Group,9329,0,0,0,0,0,0,0
Sylvie Collection,8780,1,0,0,1,1,0,0
Garrett Popcorn Shops,9317,2,0,0,2,1,0,0
Moss Adams,8359,0,0,0,0,0,0,0
J.B. Hunt Transport,8343,0,0,0,0,0,0,0
Custom Comfort Mattress,8785,0,0,0,0,0,0,0
Onebrooklyn.com,9185,0,0,0,0,0,0,0
Stock Specialists,9199,0,0,0,0,0,0,0
Geox,9321,0,0,0,0,0,0,0
Medela Inc.,8348,0,0,2,2,0,0,1
RemodelRepairReplace.com,8906,0,0,0,0,0,0,0
Global Gaming LSP,9315,0,0,0,0,0,0,0
Housatonic Community College,9421,1,0,0,1,1,0,0
RealDose Nutrition LLC,9152,0,0,0,0,0,0,0
Cornerstone Commercial Real Estate Services,8980,0,0,0,0,0,0,0
OurChildrenOurFuture2012.com,9205,0,0,0,0,0,0,0
AirInabottle.com,9174,0,0,0,0,0,0,0
Cotton Tail Offers C S,9198,0,0,0,0,0,0,0
The Laurel Highlands,8902,0,0,0,0,0,0,0
The Palace Theatre,8978,0,0,0,0,0,0,0
Carnegie Museums of Pittsburgh,9325,0,0,1,1,0,0,1
Allied Electronics,8799,0,0,0,0,0,0,0
Deutsche Grammophon & Decca Classics,9179,0,0,0,0,0,0,0
FORUM Credit Union,8861,1,0,0,1,1,0,0
"Forest Laboratories, Inc.",9208,0,0,0,0,0,0,0
Go Travelling,8775,0,0,0,0,0,0,0
Hudiburg Auto Group,9327,0,0,0,0,0,0,0
Firehouse Arts Center,9495,0,0,0,0,0,0,0
MOISSANITE.COM,9328,0,0,0,0,0,0,0
MLD Mortgage Inc.,9186,0,0,0,0,0,0,0
Tenneco Inc.,8904,0,0,0,0,0,0,0
Coalition to Protect Women's Health Care,8866,0,0,0,0,0,0,0
"ANE Productions, Inc.",8999,0,0,0,0,0,0,0
GreatCollections,8917,0,0,0,0,0,0,0
Lycos Inc.,8901,0,0,0,0,0,0,0
General Growth Properties,8139,0,0,0,0,0,0,0
foodinkcatering.com,9429,0,0,0,0,0,0,0
Potomac Funds,8992,0,0,1,1,0,0,1
RelayRides,8932,0,0,0,0,0,0,0
Xcel Energy Center,9209,0,0,0,0,0,0,0
Dallas/Fort Worth International Airport,8925,1,0,0,1,1,0,0
Deposit a Gift LLC,9631,0,0,0,0,0,0,0
Masco Cabinetry,8868,0,0,0,0,0,0,0
Keys Community Concert Band,8985,0,0,0,0,0,0,0
"Yaknow, Inc.",9632,0,0,0,0,0,0,0
Vanderbilt University Medical Center,8934,0,0,0,0,0,0,0
Chain Reaction Cycles & Export Technologies,9191,0,0,0,0,0,0,0
Modnique,9424,0,0,0,0,0,0,0
ConocoPhillips Company,8870,11,0,3,14,0.785714286,0,0.214285714
West Palm Beach Antiques Festival,9496,0,0,0,0,0,0,0
NECA/IBEW Local 48,9218,0,0,0,0,0,0,0
Huntington Hospital,8908,0,0,0,0,0,0,0
"Museum of Fine Arts, Boston",8922,1,0,0,1,1,0,0
"Genworth Financial, Inc.",8989,2,0,0,2,1,0,0
webSaver.ca,8928,2,0,2,4,0.5,0,0.5
Pergo,8993,0,0,0,0,0,0,0
Redirect LLC,9222,0,0,0,0,0,0,0
UNITEDTEXAS.COM,9210,0,0,0,0,0,0,0
LIttle Darlings San Francisco,8787,0,0,0,0,0,0,0
Ball Horticultural,9326,0,0,0,0,0,0,0
Little League,9636,0,0,0,0,0,0,0
Greater Pittsburgh Convention & Visitors Bureau,9635,0,0,1,1,0,0,1
Silent House Movie,9217,0,0,0,0,0,0,0
"Ferguson Enterprises, Inc.",9638,0,0,1,1,0,0,1
Altova,9003,0,0,0,0,0,0,0
Saint Peter's College,9647,0,0,0,0,0,0,0
"Mohawk Industries, INC.",8795,0,0,0,0,0,0,0
Forex Capital Markets,9671,0,0,0,0,0,0,0
Christie’s International Real Estate,9639,0,0,0,0,0,0,0
Consumer Opinion Center,9336,0,0,0,0,0,0,0
LifeProof,9661,18,0,1,19,0.947368421,0,0.052631579
pheromonereviewsite.com,9323,0,0,0,0,0,0,0
Find Your Publisher,8797,1,0,0,1,1,0,0
"CNH America, LLC",9654,1,0,0,1,1,0,0
MobileHelp,9641,0,0,0,0,0,0,0
Harvest Management Sub,8912,0,0,0,0,0,0,0
Olson Energy Service,9670,0,0,0,0,0,0,0
Chicago Public Library,9423,0,0,1,1,0,0,1
Orlando Repertory Theatre,9628,0,0,0,0,0,0,0
"Vitanergy, Inc.",9489,0,0,0,0,0,0,0
"St. Petersburg Kennel Club, Inc.",9656,0,0,0,0,0,0,0
Ministry Matter,9491,0,0,0,0,0,0,0
Bogus Basin Mountain Recreation Area,9493,0,0,0,0,0,0,0
Metal Blade Records Inc,8923,0,0,0,0,0,0,0
Miracle Method US Corp,9503,0,0,1,1,0,0,1
Touchstone Energy Cooperative,8991,0,0,0,0,0,0,0
Group CSE,9201,0,0,1,1,0,0,1
DudeIWantThat.com,9432,2,0,0,2,1,0,0
The New Museum,9660,0,0,0,0,0,0,0
Collins College,8862,0,0,0,0,0,0,0
Hillsdale College,8927,0,0,0,0,0,0,0
Ryan Gets Ripped,9440,0,0,0,0,0,0,0
Sincere Home Décor,8987,0,0,0,0,0,0,0
Currier Museum of Art,9219,0,0,0,0,0,0,0
Ohio Department of Natural Resources,9333,0,0,0,0,0,0,0
Union Leader Corp.,8996,0,0,0,0,0,0,0
lachicpetgrooming.com,9437,0,0,0,0,0,0,0
Stock Market Watch,9223,4,0,0,4,1,0,0
Corban Addison,9502,0,0,0,0,0,0,0
Caldwell College,9340,0,0,0,0,0,0,0
Crowne Plaza Times Square,9642,0,0,0,0,0,0,0
Mailehawaiiweddings.com,9001,0,0,0,0,0,0,0
Old Northeast Jewelers,9215,0,0,0,0,0,0,0
Moe's Cantina,8933,0,0,0,0,0,0,0
Popular Photography,9657,0,0,0,0,0,0,0
"Opportunity Village, Inc.",9499,0,0,0,0,0,0,0
The Cedar Cide Store,9630,0,0,0,0,0,0,0
7bidz LLC,9434,0,0,0,0,0,0,0
City of Lynnwood,9500,0,0,0,0,0,0,0
runcenter.com,9505,0,0,0,0,0,0,0
Bridgestone Golf,9659,0,0,0,0,0,0,0
Media Research Center,8929,1,0,0,1,1,0,0
Innovative Audio Video Showrooms,8931,0,0,0,0,0,0,0
Bryan University,9651,0,0,0,0,0,0,0
"Bazi, Inc",9637,0,0,0,0,0,0,0
Creaky Corpse Ltd,8320,2,0,0,2,1,0,0
Acer Inc.,8322,3,0,0,3,1,0,0
Callaway Golf Company,9054,0,0,0,0,0,0,0
Breville USA,8754,0,0,0,0,0,0,0
Douglas J Companies,8973,0,0,0,0,0,0,0
"RealPage, Inc.",9071,2,0,0,2,1,0,0
Cambridge Judge Business School,8854,0,0,1,1,0,0,1
iMotors.com,9171,1,0,0,1,1,0,0
"ORIGINAL WATERMEN, INC.",8856,0,0,0,0,0,0,0
Wrath of the Titans Movie,9105,0,0,0,0,0,0,0
Thought Equity Motion,8339,0,0,0,0,0,0,0
AdvaMed,8354,0,0,0,0,0,0,0
"Online Trip Insurance Services, Inc.",9190,0,0,0,0,0,0,0
"About Search Optics  Search Optics, Inc.",8788,0,0,0,0,0,0,0
Kansas Speedway,8988,0,0,0,0,0,0,0
Citec Sistemas,8871,0,0,0,0,0,0,0
Sacramento Municipal Utility District,9492,0,0,0,0,0,0,0
Covestor,8924,0,0,0,0,0,0,0
Dierbergs Markets,9341,0,0,0,0,0,0,0
CarMax,8937,8,0,3,11,0.727272727,0,0.272727273
Lutron Electronics Co.,9643,0,0,0,0,0,0,0
The Lucky One Movie,9658,0,0,0,0,0,0,0
Pac/West Communications,8767,0,0,0,0,0,0,0
Philips Oral Healthcare,8342,0,0,0,0,0,0,0
Georgia State University,8349,0,0,0,0,0,0,0
Browns,9153,0,0,0,0,0,0,0
"St. Augustine, Ponte Vedra, & The Beaches Visitors and Convention Bureau",8778,0,0,0,0,0,0,0
Obscenejeans.com,9192,0,0,0,0,0,0,0
TheHairStyler.com,8860,0,0,0,0,0,0,0
iStockphoto,8910,8,2,1,11,0.727272727,0.181818182,0.090909091
Central Kentucky Research Associates,9428,0,0,0,0,0,0,0
Asianmatchonline.com,8867,0,0,0,0,0,0,0
New Control,9221,0,0,0,0,0,0,0
"Sonic Electronix, Inc.",9435,0,0,0,0,0,0,0
The Chance Theater,8935,0,0,0,0,0,0,0
"Illinois Tool Works, Inc.",9646,1,1,3,5,0.2,0.2,0.6
Intelligent Content Corp.,9653,0,0,0,0,0,0,0
Nue Science,9148,0,0,0,0,0,0,0
CC Carpet,8898,0,0,1,1,0,0,1
Dermablend,8779,0,0,0,0,0,0,0
OPSM,9316,0,0,0,0,0,0,0
Wm. B. Eerdmans Publishing Company,9330,0,0,0,0,0,0,0
eBags,8915,0,0,0,0,0,0,0
British Tourist Authority International,8997,0,0,0,0,0,0,0
HVACQuotes.us,8998,3,0,0,3,1,0,0
Los Angeles Master Chorale,9498,0,0,0,0,0,0,0
"Teachers College, Columbia University",8930,0,0,0,0,0,0,0
Barrett-Jackson Auction Company,9501,0,0,0,0,0,0,0
"Southern Shows, Inc.",9633,1,0,1,2,0.5,0,0.5
Tyndale House Publishers,9634,0,0,0,0,0,0,0
Rivers Casino,8352,0,0,0,0,0,0,0
University of New Mexico,9313,0,0,0,0,0,0,0
OKI FURNITURE FAIR,8784,1,0,0,1,1,0,0
Penn Foster,9318,0,0,0,0,0,0,0
"UC4 Software, Inc.",9320,0,0,0,0,0,0,0
Pennington Seed Incorporated,8909,0,0,0,0,0,0,0
Bravada International,8986,0,0,0,0,0,0,0
Woodbridge Pacific Group,8911,0,0,0,0,0,0,0
Norfolk Southern,9211,0,0,1,1,0,0,1
Orchid Recovery Center,8920,0,0,0,0,0,0,0
Quality Benefits Inc.,9652,0,0,0,0,0,0,0
Sakrete,8769,0,0,0,0,0,0,0
Recess Networks LLC,9144,0,0,0,0,0,0,0
Walnut Street Theatre,8358,0,0,0,0,0,0,0
Jeffrey Finn Productions,9176,0,0,0,0,0,0,0
Millennium Hotels & Resorts,8776,0,0,0,0,0,0,0
Magic Number,8794,0,0,0,0,0,0,0
Jiminy Peak,8983,0,0,0,0,0,0,0
Ministers & Missionaries Benefit Board of American Baptist Church,9212,0,0,0,0,0,0,0
Desert Sun Tanning,8919,0,0,1,1,0,0,1
Xuba.com,8994,0,0,0,0,0,0,0
The Seattle Home Show,8926,0,0,0,0,0,0,0
Jersey City Economic Development Corporation,9655,0,0,0,0,0,0,0
Cordell & Cordell,9143,0,0,0,0,0,0,0
Star Real Estate,8350,0,0,0,0,0,0,0
geneME,9177,0,0,0,0,0,0,0
U.S. Tax Lien Association,9184,0,0,0,0,0,0,0
Canadian Train Vacations,9309,0,0,0,0,0,0,0
GroceryCouponNetwork.com,8975,0,0,0,0,0,0,0
Kennecott Land,9133,0,0,0,0,0,0,0
Sunrise Automotive Group,8344,0,0,0,0,0,0,0
MediResource Inc.,8347,0,0,0,0,0,0,0
Riverwind,9147,0,0,0,0,0,0,0
"Haband Company, LLC",8897,0,0,0,0,0,0,0
Harvard Vanguard Medical Associates,9180,0,0,0,0,0,0,0
Solutions - Y.O.L.S.,9183,0,0,0,0,0,0,0
Keck Medical Center of USC,8979,0,0,0,0,0,0,0
Platt College,8916,0,0,0,0,0,0,0
Wolf & Company,9216,0,0,0,0,0,0,0
Picture Mosaics,9433,0,0,0,0,0,0,0
TeleBlend,9497,0,0,0,0,0,0,0
mypaydaycashloan.com,9648,0,0,0,0,0,0,0
Health Media Ventures,9665,0,0,3,3,0,0,1
Amoro,8340,0,0,0,0,0,0,0
Navy Exchange Service Command,9187,0,0,0,0,0,0,0
Charlotte Local Organizing Committee,8976,0,0,0,0,0,0,0
The College Board,8858,0,0,0,0,0,0,0
American Advisors Group,9194,1,0,0,1,1,0,0
Lindblad Expeditions & National Geographic,9426,0,0,0,0,0,0,0
"Discovery Place, Inc.",9430,0,0,0,0,0,0,0
"CityPASS, Inc.",9337,0,0,0,0,0,0,0
TechforLess LLC,9644,0,0,0,0,0,0,0
COSE,9662,0,0,0,0,0,0,0
Currituck County Department of Travel and Tourism,8456,0,0,0,0,0,0,0
TRICO,9022,0,0,0,0,0,0,0
Lion Square Lodge,8807,0,0,0,0,0,0,0
Theatre League,9039,0,0,0,0,0,0,0
The Associated General Contractors (AGC) of America,8305,0,0,0,0,0,0,0
Washington Gas,8822,0,0,0,0,0,0,0
Software Marketing,8271,0,0,0,0,0,0,0
Seattle Public Theater,9058,0,0,0,0,0,0,0
CMJ Network Inc.,8756,0,0,0,0,0,0,0
KAO Brands Company,8505,0,0,1,1,0,0,1
IPEVO Inc.,8037,0,0,0,0,0,0,0
K. Hovnanian Companies,8522,0,0,1,1,0,0,1
"WonderWork, Inc.",9107,0,0,0,0,0,0,0
LocalsLobby.com,9122,0,0,0,0,0,0,0
Career Path Lifestyle,9124,0,0,0,0,0,0,0
Rhino Linings Corporation,9139,0,0,0,0,0,0,0
Creating Your Space,9307,0,0,0,0,0,0,0
Texas Children's Hospital,9158,0,0,0,0,0,0,0
"Diet Coaching, Inc.",9188,0,0,0,0,0,0,0
Telegraph Media Group Limited,8137,0,0,0,0,0,0,0
ChristianCinema.com,8790,0,0,0,0,0,0,0
Virginia Opera Association,8907,0,0,0,0,0,0,0
Allen West for Congress,8990,0,0,0,0,0,0,0
BroadwayBestShows,9224,0,0,0,0,0,0,0
TLConcepts,9339,0,0,0,0,0,0,0
Coolibar,9439,0,0,0,0,0,0,0
Meredith College,9441,0,0,0,0,0,0,0
Dr. Bott,8457,0,0,0,0,0,0,0
Groove Commerce,8459,0,0,0,0,0,0,0
University System of Maryland,9025,8,0,0,8,1,0,0
Grant Thornton LLP,8466,0,0,0,0,0,0,0
Crafts Americana Group,8700,0,0,0,0,0,0,0
"The Dwyer Group, Inc.",8257,0,0,0,0,0,0,0
ISOTX,8259,0,0,0,0,0,0,0
SECU,8491,0,0,0,0,0,0,0
"California State University, Long Beach",8959,0,0,0,0,0,0,0
Profound Beauty,8493,0,0,0,0,0,0,0
Garden Homes Mgt,8961,0,0,0,0,0,0,0
Farmer School of Business at Miami University,8834,0,0,0,0,0,0,0
Arizona RoomStore,8502,0,0,0,0,0,0,0
"Cinsay, Inc.",9161,0,0,0,0,0,0,0
Wisconsin Lottery,9170,0,0,0,0,0,0,0
SOLOSHOT,9234,0,0,0,0,0,0,0
Alabama Orthopaedic Surgeons,9127,0,0,0,0,0,0,0
Shippensburg University,8893,0,0,0,0,0,0,0
MerchMo,9193,0,0,0,0,0,0,0
Houseworks,8791,0,0,0,0,0,0,0
"Tauck, Inc.",8793,0,0,0,0,0,0,0
SRP,8859,0,0,0,0,0,0,0
Junk King,9202,0,0,0,0,0,0,0
Bethel University,9438,0,0,0,0,0,0,0
Jack Dunn,9000,0,0,0,0,0,0,0
SavingsAngel.com,9627,0,0,0,0,0,0,0
Richmond International Raceway,9629,0,0,0,0,0,0,0
John Carroll University,9504,0,0,0,0,0,0,0
WeightLossAgents,8936,0,0,0,0,0,0,0
Eugen Systems and Focus Home Interactive,9672,0,0,0,0,0,0,0
Saatva,9031,2,0,0,2,1,0,0
Prodege,8696,1,0,0,1,1,0,0
industry west,8245,0,0,0,0,0,0,0
The Trustees of the University of Pennsylvania,8813,2,0,0,2,1,0,0
Satellitedirect.com,8963,0,0,0,0,0,0,0
WGN Radio,8327,0,0,0,0,0,0,0
Group Golfer,8832,0,0,0,0,0,0,0
Hays Digital & Creative Services,8328,0,0,0,0,0,0,0
MOM Brands,9063,0,0,0,0,0,0,0
Trivantis Corporation,8514,0,0,0,0,0,0,0
William Paterson University,9082,0,0,0,0,0,0,0
Ackerman Security,9113,0,0,1,1,0,0,1
Southcoast Health System,8764,1,0,0,1,1,0,0
Conns,9131,0,0,0,0,0,0,0
xpedx,8982,0,0,0,0,0,0,0
marsh.net,9200,0,0,0,0,0,0,0
The Garden Patch,8796,0,0,0,0,0,0,0
Umpqua Bank,8914,0,0,0,0,0,0,0
Green Mill Restaurants,9213,0,0,0,0,0,0,0
Kauffman Tire Inc.,9214,0,0,0,0,0,0,0
Neumann University,9431,0,0,0,0,0,0,0
Cambridge College,9649,0,0,0,0,0,0,0
The Hockey News Corporation,9650,0,0,0,0,0,0,0
The Center for Medical Weight Loss,9664,1,0,0,1,1,0,0
"Advanced Micro Devices, Inc.",7768,0,0,1,1,0,0,1
Bristol-Myers Squibb,6583,0,0,0,0,0,0,0
Plus Preferred,8172,0,0,1,1,0,0,1
New York & Company,8387,0,0,0,0,0,0,0
CareOne,9008,0,0,0,0,0,0,0
Docstoc,8219,0,0,0,0,0,0,0
The Tao of Badass,9676,0,0,0,0,0,0,0
Liberty Hospital,9005,0,0,0,0,0,0,0
Aspensurgical.com,9677,0,0,0,0,0,0,0
Jesus.net,9678,0,0,0,0,0,0,0
Nashua Community College,9681,0,0,0,0,0,0,0
Wild Planet Foods Inc.,9682,0,0,0,0,0,0,0
Dirt Cheap,9700,0,0,0,0,0,0,0
SelectHealth,9703,0,0,3,3,0,0,1
Burning River Roller Girls,9011,0,0,0,0,0,0,0
Widen Enterprises,9685,0,0,0,0,0,0,0
Threatjournal.com,9702,0,0,0,0,0,0,0
"i-on interactive, inc.",9704,0,0,0,0,0,0,0
Haggar,9675,0,0,0,0,0,0,0
"JIBE, Inc",9687,0,0,0,0,0,0,0
Expressionery,9705,0,0,0,0,0,0,0
B.A.S.S. LLC,9683,0,0,0,0,0,0,0
Highpointe Properties,9009,0,0,0,0,0,0,0
TruGreen Limited,9679,0,0,0,0,0,0,0
June Ambrose,9246,0,0,0,0,0,0,0
Midsouth Shooters Supply Company,9252,0,0,0,0,0,0,0
giftcertificates.com,9253,0,0,0,0,0,0,0
Northwood University,9255,0,0,0,0,0,0,0
"Accolade, Inc.",9241,0,0,0,0,0,0,0
Seattle Pacific University,9256,0,0,0,0,0,0,0
Boyer Company,9249,0,0,0,0,0,0,0
ChinaFlix inc.,9250,0,0,2,2,0,0,1
The Flower Fields,9251,0,0,0,0,0,0,0
Five Towns College,8221,0,0,0,0,0,0,0
PAPYRUS,8389,0,0,0,0,0,0,0
Protus IP Solutions,8436,0,0,0,0,0,0,0
Brian Harris Direct,9226,0,0,0,0,0,0,0
Marquee Las Vegas,7587,0,0,0,0,0,0,0
Collegebound Network,9229,0,0,0,0,0,0,0
WhoCanHelp.com,9261,0,0,0,0,0,0,0
Dr. Mark Hyman,9231,0,0,0,0,0,0,0
VaporGenie.com,9230,0,0,1,1,0,0,1
Saskatoon and Region Home Builders Association,9232,0,0,0,0,0,0,0
Cosmos Corporation,9266,0,0,0,0,0,0,0
Interac Inc.,9263,0,0,0,0,0,0,0
National Association of Corporate Directors,7319,0,0,0,0,0,0,0
Baby Gourmet Foods Inc.,9264,0,0,0,0,0,0,0
Tavern On The Lake,9267,0,0,0,0,0,0,0
AFL,9697,0,0,0,0,0,0,0
Aramark Parks and Destinations,9782,0,0,0,0,0,0,0
Indiatimes.com,9779,0,0,0,0,0,0,0
Habitat for Humanity,8187,0,0,0,0,0,0,0
Acute Games,9778,1,0,1,2,0.5,0,0.5
Media General Inc.,9260,0,0,0,0,0,0,0
Citizen Snow Film Productions,7785,0,0,0,0,0,0,0
VETFRIENDS.COM,9271,5,0,0,5,1,0,0
Caucus Education Corporation,8604,0,0,0,0,0,0,0
Inland Northwest Health Services,9791,0,0,0,0,0,0,0
Priscilla of Boston,8102,0,0,0,0,0,0,0
FlyToAbroad.com,9789,0,0,0,0,0,0,0
Bonnier Corporation,6600,4,0,0,4,1,0,0
"PeopleAdmin, Inc.",9796,0,0,0,0,0,0,0
Christianity Today International,8189,0,0,1,1,0,0,1
The Evangelical Lutheran Good Samaritan Society,8049,0,0,0,0,0,0,0
Majesco Entertainment Company,7851,0,0,0,0,0,0,0
CALLOFROMA.COM,7351,0,0,0,0,0,0,0
HoneyBaked Ham Company,9346,0,0,0,0,0,0,0
Louisiana Economic Development,8653,0,0,0,0,0,0,0
HostBaby Inc.,9803,0,0,0,0,0,0,0
Merriam-Webster,8438,0,0,0,0,0,0,0
"Sinox Pharma, Inc.",9453,0,0,0,0,0,0,0
Winportal.com,7368,0,0,0,0,0,0,0
Marylhurst University,8410,0,0,2,2,0,0,1
SomaLife International Inc,9848,0,0,0,0,0,0,0
Hub Television Networks,8453,0,0,0,0,0,0,0
SOBOBA CASINO Gaming & Entertainment,9347,0,0,0,0,0,0,0
Hannaford Bros,9021,0,0,0,0,0,0,0
Formstack,9447,10,0,0,10,1,0,0
Dolby Laboratories,9695,0,0,0,0,0,0,0
"NewRetirement, Inc.",9792,0,0,0,0,0,0,0
Sorenson Development,9828,0,0,0,0,0,0,0
Mezza Luna,9343,0,0,0,0,0,0,0
Escort Inc.,8409,0,0,0,0,0,0,0
Jeep Dealerships,9820,34,15,0,49,0.693877551,0.306122449,0
Dealers United,9785,0,0,0,0,0,0,0
The Sherwin-Williams company,9270,0,0,0,0,0,0,0
"Universal Screen Arts, Inc.",9365,0,0,0,0,0,0,0
Baylor University,9853,0,0,0,0,0,0,0
Houston Community College,9810,1,0,0,1,1,0,0
SEMA,9806,0,0,0,0,0,0,0
NiteTours,9814,0,0,0,0,0,0,0
Hotel Valley Ho,9795,0,0,0,0,0,0,0
The Walker Group,8046,0,0,0,0,0,0,0
Dell,9366,27,0,7,34,0.794117647,0,0.205882353
United States Tennis Association,8052,0,0,0,0,0,0,0
The Caribe,8418,0,0,0,0,0,0,0
zieringmedical.com,8406,0,0,1,1,0,0,1
The Divide Movie,9821,0,0,0,0,0,0,0
"Global X Management Company, LLC",8057,0,0,0,0,0,0,0
The Experts Conference,9693,0,0,0,0,0,0,0
Badoo,9269,1,0,0,1,1,0,0
braziltour.com,9864,0,0,0,0,0,0,0
FreePeople.com,9834,0,0,0,0,0,0,0
SoftwareKing.com,8054,0,0,0,0,0,0,0
Anacapri Restaurant,9797,0,0,0,0,0,0,0
Mothers Against Drunk Driving,9357,0,0,0,0,0,0,0
The Stretching Institute,8424,0,0,0,0,0,0,0
Westfield Insurance Company,9920,0,0,1,1,0,0,1
WowSecrets.com,9787,0,0,0,0,0,0,0
"StartSampling, Inc.",9355,0,0,0,0,0,0,0
Cutting Edge Haunted House,9859,0,0,0,0,0,0,0
Scientific American,9356,0,0,0,0,0,0,0
Promised Land Dairy,8408,3,0,0,3,1,0,0
Georgia Institute of Technology,9799,0,0,0,0,0,0,0
VyStar Credit Union,8423,0,0,2,2,0,0,1
La Roche College,9823,0,0,0,0,0,0,0
Netmining,9350,2,0,0,2,1,0,0
"Continuum Health Partners, Inc.",9378,0,0,0,0,0,0,0
Alexa Internet,9368,0,0,0,0,0,0,0
bbairandheat.com,9825,0,0,0,0,0,0,0
Airoom Family Company,9358,0,0,0,0,0,0,0
Spirit Mountain Casino,9699,0,0,0,0,0,0,0
WhiteWave Foods Company,9871,0,0,0,0,0,0,0
Your Baby Can,9842,0,0,0,0,0,0,0
National Biodiesel Board,9858,0,0,0,0,0,0,0
9images.com,8045,0,0,0,0,0,0,0
Ledbury Inc.,9521,0,0,0,0,0,0,0
"Central Boiler, Inc.",9860,0,0,0,0,0,0,0
FreeCause Blog,9684,0,0,1,1,0,0,1
AmeriHealth HMO,9713,0,0,0,0,0,0,0
MSG Varsity,9824,0,0,0,0,0,0,0
Stop Special Interest Money Now,9781,0,0,0,0,0,0,0
Lambda Legal,9862,0,0,0,0,0,0,0
Grupo Bimbo,8422,0,0,0,0,0,0,0
Richmond Association of REALTORS,9692,0,0,0,0,0,0,0
"Ideal Internet, Inc.",9247,7,0,0,7,1,0,0
The Boots Company,9262,0,0,0,0,0,0,0
via.me,10008,0,0,0,0,0,0,0
Belcaro Group Inc.,9248,75,0,0,75,1,0,0
Rothman Institute,9007,0,0,0,0,0,0,0
pazo,9450,0,0,0,0,0,0,0
Business Roundtable,9694,0,0,0,0,0,0,0
Titanic Movie,9364,0,0,0,0,0,0,0
Johnson Brunetti,9784,0,0,0,0,0,0,0
"InsightExpress, LLC",9846,10,0,5,15,0.666666667,0,0.333333333
WorkplaceDynamics,10076,0,0,0,0,0,0,0
Milwaukee Art Museum,8066,0,0,0,0,0,0,0
Greenwood Heating and Air Conditioning,9258,0,0,0,0,0,0,0
General Dynamics C4 Systems,9777,0,0,0,0,0,0,0
Military Benefit Association,9826,0,0,0,0,0,0,0
The Big Picture Home Theater Co.,9680,0,0,0,0,0,0,0
Northworks Software GmbH,9714,0,0,2,2,0,0,1
Steve Martin,9701,0,0,0,0,0,0,0
Cayne's The Super Houseware Store,9344,0,0,0,0,0,0,0
Robbins-Madanes Training,9349,0,0,0,0,0,0,0
Icebreaker,9449,0,0,0,0,0,0,0
Clif Bar & Company,9686,0,0,0,0,0,0,0
Laws.com,9689,0,0,0,0,0,0,0
HellBoard Entertainment,9372,0,0,0,0,0,0,0
The Five-Year Engagement Movie,9800,0,0,0,0,0,0,0
Amon Carter Museum of American Art,9790,0,0,0,0,0,0,0
Career Education Corporation,9374,0,0,0,0,0,0,0
Sakura Con,9688,0,0,0,0,0,0,0
Anderson Erickson,9242,0,0,0,0,0,0,0
The Foreign Policy Group,9227,0,0,0,0,0,0,0
Downtown Tempe Foundation,9244,0,0,0,0,0,0,0
ImperialStructuredSettlements.com,10078,0,0,0,0,0,0,0
"MHI, LLC",9805,2,0,0,2,1,0,0
Airbnb,9817,24,1,0,25,0.96,0.04,0
HealthPlus of Michigan,8405,3,0,0,3,1,0,0
GEEFCU,9259,0,0,0,0,0,0,0
FrostWire.com,9243,0,0,0,0,0,0,0
solawerks.com,9780,0,0,0,0,0,0,0
Liberty Coin & Precious Metals,9514,0,0,0,0,0,0,0
Kalahari Development,9829,2,0,0,2,1,0,0
daniamarinefleamarket.com,10086,0,0,0,0,0,0,0
Trusouth Oil,10090,0,0,0,0,0,0,0
Oklahoma Tourism & Recreation Department,10096,0,0,0,0,0,0,0
Market Street Cinema,9265,0,0,0,0,0,0,0
WTOP,9268,0,0,0,0,0,0,0
Netop,9519,0,0,0,0,0,0,0
Digital Arts Online,9385,0,0,0,0,0,0,0
New York City Opera,8420,0,0,0,0,0,0,0
"Astrum Solar, Inc.",9849,0,0,0,0,0,0,0
PreviMedica,8040,0,0,0,0,0,0,0
Harbor East,8044,0,0,0,0,0,0,0
Bernard Hodes Group,9509,9,0,1,10,0.9,0,0.1
Apartment Therapy,9786,0,0,0,0,0,0,0
Rosedale Federal Savings and Loan Association,9798,0,0,0,0,0,0,0
Wisconsin Dells Visitor & Convention Bureau,10093,0,0,0,0,0,0,0
Collin Bank,9812,0,0,0,0,0,0,0
Tata Consultancy Services Limited,9843,0,0,0,0,0,0,0
Lucha VaVOOM,9818,0,0,0,0,0,0,0
GCS Federal Credit Union,9466,0,0,0,0,0,0,0
"Jeffersono Financial, Inc.",8421,0,0,0,0,0,0,0
"Phone.com, Inc.",9850,0,0,0,0,0,0,0
Wheels For Wishes,8939,0,0,0,0,0,0,0
SAFE Credit Union,8039,0,0,0,0,0,0,0
Children's Hospital of Orange County,9348,0,0,0,0,0,0,0
Beaufort Regional Chamber of Commerce Visitor & Convention Bureau,9802,0,0,0,0,0,0,0
Van Scoyoc Associates,10108,0,0,0,0,0,0,0
"Bee Window, Inc.",9804,0,0,0,0,0,0,0
Renewal By Andersen Corporation,8426,0,0,0,0,0,0,0
DFW Neuropathy,9710,0,0,0,0,0,0,0
ChicagoLand Wellness Centers for Holistic Health,9840,0,0,0,0,0,0,0
"McNeill Designs for Brighter Minds, INC.",8060,0,0,0,0,0,0,0
"Diageo Americas, Inc.",9526,1,0,5,6,0.166666667,0,0.833333333
Magento Inc,8058,0,0,0,0,0,0,0
"Solace International, Inc",9709,0,0,0,0,0,0,0
interFACE,10120,1,0,0,1,1,0,0
Cerra,10114,0,0,0,0,0,0,0
Steamboat Resorts,9359,0,0,0,0,0,0,0
Richmond Metropolitan Convention & Visitors Bureau,9869,0,0,0,0,0,0,0
"Cafe Enterprises, Inc",9456,0,0,0,0,0,0,0
Mikimoto,9525,3,0,0,3,1,0,0
PG Publishing Co.,9448,0,0,1,1,0,0,1
Bayside Advertising,9362,0,0,0,0,0,0,0
Manhattan Theatre Club,9517,0,0,0,0,0,0,0
Hungry I Club,8062,0,0,0,0,0,0,0
Vision Critical Canada Inc,9794,0,0,0,0,0,0,0
Infantino LLC.,10127,0,0,0,0,0,0,0
Sears Imported Autos,10121,0,0,0,0,0,0,0
Patriot Software,9245,0,0,0,0,0,0,0
Rancho Las Palmas Resort & Spa,8042,0,0,0,0,0,0,0
City of Fort Lauderdale,9458,0,0,0,0,0,0,0
Island Def Jam,8413,0,0,0,0,0,0,0
"DataStax, Inc.",8429,0,0,0,0,0,0,0
American Bullion Inc.,8063,7,0,0,7,1,0,0
RM Barry Publications,9541,0,0,0,0,0,0,0
Evolution World Wide,9353,0,0,0,0,0,0,0
Sylvan Learning,9921,1,0,0,1,1,0,0
Springfield Inc.,9384,0,0,0,0,0,0,0
BHLDN LLC,9467,0,0,0,0,0,0,0
Heritage Homes,9373,0,0,0,0,0,0,0
SOL REPUBLIC,9361,0,0,0,0,0,0,0
Mid-America Festivals,9996,0,0,0,0,0,0,0
MetaGeek,9918,0,0,0,0,0,0,0
Malvern Preparatory School,8940,0,0,0,0,0,0,0
GoGreenSmokelessOil.com,10060,0,0,0,0,0,0,0
Central New York Sales & Marketing Executives,8051,0,0,0,0,0,0,0
fungamesonlinegames.com,9844,0,0,0,0,0,0,0
Liberty Orchards Co.,9863,0,0,0,0,0,0,0
"Beren Shoes, Inc.",9375,0,0,0,0,0,0,0
Brunswick Automart,9788,0,0,0,0,0,0,0
Infinity Exhibits,9851,0,0,0,0,0,0,0
FSA Store,9387,0,0,0,0,0,0,0
Shrader and Associates,10066,0,0,0,0,0,0,0
TimeLine Theatre Company,8431,0,0,0,0,0,0,0
Xoxide,9360,0,0,0,0,0,0,0
AXS,9367,0,0,0,0,0,0,0
McAlister's Corporation,9389,0,0,0,0,0,0,0
Samaritan's Purse,9540,0,0,0,0,0,0,0
Fast Growing Trees Nursery,9455,0,0,0,0,0,0,0
RJO Futures,9354,0,0,0,0,0,0,0
Sun Taiyang Co.,10005,0,0,0,0,0,0,0
Sunstar Americas,9451,0,0,0,0,0,0,0
Vinovisit.com,9831,0,0,0,0,0,0,0
Custom Direct LLC,9371,0,0,0,0,0,0,0
Autry National Center,8041,0,0,0,0,0,0,0
The University of Alabama Supply Store,9855,0,0,1,1,0,0,1
PacifiCorp,9870,0,0,0,0,0,0,0
Jim Healthy,9723,0,0,0,0,0,0,0
Video-Buzz.com,10080,0,0,0,0,0,0,0
Marketing Profs,9852,0,0,0,0,0,0,0
Regenesis Wellness Center,8048,0,0,0,0,0,0,0
Chosen People Ministries,9536,0,0,0,0,0,0,0
Dream Ware Enterprise.com,10064,0,0,0,0,0,0,0
Harvest House Publishers,9512,0,0,0,0,0,0,0
Tampa Bay & Company,9363,0,0,0,0,0,0,0
"Orograin Bakeries Products, Inc.",8417,0,0,0,0,0,0,0
Achieva Credit Union,9345,0,0,0,0,0,0,0
National Cable Communications,10075,0,0,0,0,0,0,0
Zoho Corporation Pvt. Ltd.,9463,0,0,0,0,0,0,0
Beltone,10069,0,0,0,0,0,0,0
optionsresources.com,9813,0,0,0,0,0,0,0
Alexander & Catalano,9815,0,0,0,0,0,0,0
The Healthy Back Institute,8064,0,0,0,0,0,0,0
The Hun School of Princeton,9538,0,0,0,0,0,0,0
"Bag Borrow or Steal, Inc.",10124,0,0,0,0,0,0,0
St. Vincent's HealthCare,9443,0,0,0,0,0,0,0
Car-X Inc.,9819,0,0,0,0,0,0,0
NEW ENGLAND CABLE NEWS,9515,0,0,0,0,0,0,0
"James Henderson, Eric Mower and Associates",9445,0,0,0,0,0,0,0
Aurora Theatre Company,9531,0,0,0,0,0,0,0
jlrforms.com,10071,0,0,0,0,0,0,0
YWCA of Seattle - King County - Snohomish County,9516,0,0,0,0,0,0,0
Democratic Congressional Campaign Committee,8427,1,0,0,1,1,0,0
Myriad Genetic Laboratories,10061,0,0,0,0,0,0,0
DogTime Inc.,9454,0,0,0,0,0,0,0
Marina Bay Sands,9718,0,0,1,1,0,0,1
BMW Dealerships,9522,119,19,9,147,0.80952381,0.129251701,0.06122449
TRIUM Global Executive MBA,10091,0,0,1,1,0,0,1
"AdBrite, Inc.",9865,0,0,0,0,0,0,0
The Terminix International Company Limited Partnership,10102,0,0,0,0,0,0,0
Nicole Miller,9995,0,0,0,0,0,0,0
Vanity Fair Inc.,10063,0,0,0,0,0,0,0
PEX Card,8414,0,0,0,0,0,0,0
GlobalEyeglasses.com,10067,0,0,0,0,0,0,0
Living Senior,10129,0,0,0,0,0,0,0
FineStationery.com,9833,0,0,0,0,0,0,0
NC Department of Commerce,9832,0,0,0,0,0,0,0
South Florida Regional Transportation Agency,10099,0,0,0,0,0,0,0
Dungarees,8415,0,0,0,0,0,0,0
JASON MRAZ,10110,0,0,0,0,0,0,0
New Belgium Brewing Company,9352,0,0,2,2,0,0,1
EZTrader.com,9462,0,0,0,0,0,0,0
Metropolitan Improvement District,9460,0,0,0,0,0,0,0
NTS W USA LLC,9464,1,0,0,1,1,0,0
Window2India.com,9707,0,0,0,0,0,0,0
Bush Brothers & Company,9376,0,0,0,0,0,0,0
TATA Housing Development Company Limited,9811,1,0,0,1,1,0,0
Skipper's Smokehouse,9524,0,0,0,0,0,0,0
phoenix theatre,9532,0,0,0,0,0,0,0
Crohn's & Colitis Foundation of America,10100,0,0,0,0,0,0,0
GetCrazyTattoos.com,9867,0,0,0,0,0,0,0
Formica Corporation,9856,0,0,0,0,0,0,0
Freelancers Union,10128,0,0,0,0,0,0,0
Accounting Principals,9861,0,0,0,0,0,0,0
LÄRABAR,9511,0,0,0,0,0,0,0
American Senior Communities,9816,1,0,0,1,1,0,0
games-village.com,10004,0,0,0,0,0,0,0
Pointroll,9370,0,0,0,0,0,0,0
American Airlines Center,9452,0,0,0,0,0,0,0
Developer Express Inc.,9390,0,0,0,0,0,0,0
Braman Motorcars,10259,0,0,0,0,0,0,0
Institute of Audio Research,10006,0,0,0,0,0,0,0
Tourism Malaysia,9873,0,0,1,1,0,0,1
"Marriott International, Inc.",9868,8,0,15,23,0.347826087,0,0.652173913
Good Stuff World,10117,0,0,0,0,0,0,0
Visit Savannah,9924,0,0,0,0,0,0,0
TotalBankruptcy,9837,0,0,0,0,0,0,0
"OnLive, Inc.",9380,0,0,0,0,0,0,0
Cincinnati Center City Develpment Corp,9471,0,0,0,0,0,0,0
Finicity Corporation,9715,0,0,0,0,0,0,0
Just Develop It,10007,0,0,0,0,0,0,0
Alaska Housing Finance Corporation,9528,0,0,0,0,0,0,0
Modern Art Museum of Fort Worth,9513,1,0,0,1,1,0,0
ShoppersChoice.com,8428,0,0,0,0,0,0,0
"Lil Fats, Inc",10002,0,0,0,0,0,0,0
Tabares Entertainment,9535,0,0,0,0,0,0,0
Singapore Economic Development Board,9875,0,0,0,0,0,0,0
"Braintree Laboratories, Inc.",9469,0,0,0,0,0,0,0
Lincoln National Corporation,10141,0,0,0,0,0,0,0
Southern Baptist Theological Seminary,9539,0,0,1,1,0,0,1
McCormick Foundation,10084,1,0,0,1,1,0,0
First Credit Union,10009,0,0,0,0,0,0,0
isocket,10092,0,0,0,0,0,0,0
Footloose Movie,10095,0,0,0,0,0,0,0
Swiss International Air Lines Ltd.,9712,0,1,3,4,0,0.25,0.75
Camelback Ranch,9721,0,0,0,0,0,0,0
HCR ManorCare,8407,0,0,0,0,0,0,0
Stanford Hospital & Clinics,9923,0,0,0,0,0,0,0
"BKD, LLP.",8416,0,0,0,0,0,0,0
Videobash,10097,0,0,0,0,0,0,0
Milanj Diamonds,9719,0,0,0,0,0,0,0
Toyota Dealerships,9461,56,2,8,66,0.848484848,0.03030303,0.121212121
Acai Berry Select,10131,0,0,0,0,0,0,0
Free Online Games,9854,0,0,0,0,0,0,0
"New Chapter, Inc.",9822,0,0,1,1,0,0,1
"AdKeeper, Inc.",10094,0,0,0,0,0,0,0
"Securian Financial Group, Inc",9381,0,0,1,1,0,0,1
ArcadeCandy,10003,9,0,0,9,1,0,0
AmeriMark Direct,9518,0,0,0,0,0,0,0
Del Monte Corporation,10139,1,0,3,4,0.25,0,0.75
NYDailyNews.com,8425,0,0,0,0,0,0,0
Meadow Ridge,10109,0,0,0,0,0,0,0
Local.com Corporation,9377,0,0,0,0,0,0,0
Herman Street,10111,0,0,0,0,0,0,0
Chicago Luxury Leader,9382,0,0,0,0,0,0,0
Wide Angle Software,9836,2,0,0,2,1,0,0
"WellPoint, Inc.",9520,0,0,0,0,0,0,0
Public Advocate of the United States,9388,0,0,0,0,0,0,0
Spark Energy Gas & Electric,9922,0,0,0,0,0,0,0
The Finmeccanica Group,10126,0,0,0,0,0,0,0
"Henri Bendel, Inc.",9720,0,0,0,0,0,0,0
Olympic Peninsula Wineries,9722,0,0,0,0,0,0,0
visitaguayaquil.com,10081,0,0,0,0,0,0,0
Seattle Seahawks,8411,0,0,0,0,0,0,0
ART TECHNOLOGY LIMITED,10101,0,0,0,0,0,0,0
"Dredging Supply Company, Inc.",9717,0,0,0,0,0,0,0
"Online Buddies, Inc.",8412,0,0,0,0,0,0,0
Freedom Debt Relief,9866,0,0,0,0,0,0,0
Hamline University,10133,0,0,0,0,0,0,0
The Official HCG Diet Plan Online Store,9999,0,0,0,0,0,0,0
UMass Boston,9465,0,0,0,0,0,0,0
Womens Expo Management,9838,0,0,0,0,0,0,0
Yum! Brands,10000,27,3,1,31,0.870967742,0.096774194,0.032258065
"International Cruise & Excursions, Inc.",10089,0,0,0,0,0,0,0
Travel Alberta,10068,0,0,0,0,0,0,0
National Louis University,8430,0,0,0,0,0,0,0
The Voice of the Martyrs,10082,0,0,1,1,0,0,1
Virsto,9383,0,0,0,0,0,0,0
badcapcitynews.org,10085,0,0,0,0,0,0,0
Recreational Boating & Fishing Foundation(RBFF),10103,1,0,0,1,1,0,0
Commerzbank AG,9915,0,0,0,0,0,0,0
The New Orleans Museum of Art (NOMA),10118,0,0,0,0,0,0,0
City of Tacoma,10136,0,0,0,0,0,0,0
LPC Survival,9379,0,0,0,0,0,0,0
CarSafe,9468,0,0,0,0,0,0,0
Workforce Fairness Institute,9470,0,0,0,0,0,0,0
Oklahoma City Convention & Visitors Bureau,9919,0,0,0,0,0,0,0
Easter Seals,9845,0,0,0,0,0,0,0
George Street Photo & Video,9534,0,0,0,0,0,0,0
GAF,9386,0,0,0,0,0,0,0
Select Penny Stock,9530,0,0,0,0,0,0,0
Metroland Media Group,9716,0,0,0,0,0,0,0
The Film Transfer Company,10088,0,0,0,0,0,0,0
Buy Doors Direct,9537,0,0,0,0,0,0,0
"Harland Financial Solutions, Inc.",10119,0,0,0,0,0,0,0
Westport Country Playhouse,9997,0,0,0,0,0,0,0
Charter College Online,10113,0,0,0,0,0,0,0
Cohen Media Group,10115,0,0,0,0,0,0,0
Ambir Technology Inc.,10065,0,0,0,0,0,0,0
MediaTakeOut,10070,0,0,0,0,0,0,0
Eli Lilly and Company,10106,2,0,15,17,0.117647059,0,0.882352941
City of Hollywood,9998,0,0,0,0,0,0,0
Sea Crest Beach Hotel,10137,0,0,0,0,0,0,0
Gabriella-psychic.com,10087,0,0,0,0,0,0,0
Alabama High School Athletic Association (AHSAA),10123,0,0,0,0,0,0,0
Chan Luu,8687,1,0,1,2,0.5,0,0.5
"One Technologies, L.P.",8689,2,0,0,2,1,0,0
iDashboards,9474,0,0,1,1,0,0,1
Villa d’ Este,9473,0,0,0,0,0,0,0
Greater Phoenix Chamber of Commerce,9273,0,0,0,0,0,0,0
Bohemia Design,8238,0,0,0,0,0,0,0
St. Joseph Medical Center,9275,0,0,0,0,0,0,0
Bozzuto,9475,1,1,2,4,0.25,0.25,0.5
Getwarm.ky,9277,0,0,1,1,0,0,1
dealdash.com,9477,0,0,0,0,0,0,0
"Integrity Staffing Solutions, Inc.",9479,2,0,1,3,0.666666667,0,0.333333333
BlueSky Breckenridge Mountain Lodge,9279,0,0,0,0,0,0,0
Middlebury Monterey Language Academy,9284,0,0,0,0,0,0,0
Minnesota Wild Hockey Club,9476,0,0,0,0,0,0,0
"Agri-Cover, Inc.",9481,0,0,0,0,0,0,0
MillerCoors LLC,9287,2,0,4,6,0.333333333,0,0.666666667
Maggiestiefvater.com,9282,0,0,0,0,0,0,0
FanVision Entertainment,9281,0,0,0,0,0,0,0
Reitmans,8804,0,0,0,0,0,0,0
Georgia Lottery Corporation,9482,0,0,0,0,0,0,0
eNotes.com,9483,0,0,0,0,0,0,0
CCH,9285,0,0,0,0,0,0,0
Opteck.com,9393,0,0,0,0,0,0,0
The Community College of Baltimore County,9397,0,0,0,0,0,0,0
Entertainment Publications,9392,0,0,0,0,0,0,0
Milwaukee Downtown BID #21,9478,0,0,0,0,0,0,0
Tim Hortons,9398,0,0,1,1,0,0,1
YMT Vacations,9488,0,0,0,0,0,0,0
Centris Federal Credit Union,9278,0,0,0,0,0,0,0
Contemporary Jewish Museum,9290,0,0,0,0,0,0,0
Edline,9288,0,0,0,0,0,0,0
Wood Cabinet Factory,9402,0,0,0,0,0,0,0
Gift Registry 360,9409,0,0,0,0,0,0,0
mindSHIFT Technologies,9405,0,0,0,0,0,0,0
Ignition Entertainment Ltd,9485,0,0,0,0,0,0,0
Telecominvesting.com,9276,0,0,0,0,0,0,0
The Little Guys,9404,0,0,0,0,0,0,0
Princeton University,9399,0,0,0,0,0,0,0
America's Finest Carpet,9396,0,0,0,0,0,0,0
Mentor Worldwide,9400,0,0,0,0,0,0,0
iPadCity.co.uk,10334,0,0,0,0,0,0,0
Card Approvals UK,10335,0,0,0,0,0,0,0
Singapore GP,9487,0,0,0,0,0,0,0
"Government of Ras Al Khaimah, Rak Investment Authority",9484,0,0,0,0,0,0,0
homeeverything.com,9416,0,0,0,0,0,0,0
Commerce Payment Systems,9394,0,0,0,0,0,0,0
Horwitz Horwitz & Associates,9406,0,0,0,0,0,0,0
"P.F. Chang's China Bistro, Inc.",9401,2,0,3,5,0.4,0,0.6
Stemilt Growers,9412,0,0,0,0,0,0,0
Drop Down Deals,2186,0,0,0,0,0,0,0
Consumer Source Inc.,10407,1,0,2,3,0.333333333,0,0.666666667
New England Sports Network,2185,0,0,1,1,0,0,1
Jack Williams Tire,9286,0,0,0,0,0,0,0
Rosetta Stone,2184,1,1,1,3,0.333333333,0.333333333,0.333333333
Auto Parts Warehouse,2172,2,0,1,3,0.666666667,0,0.333333333
1-800-PetMeds,2177,11,5,1,17,0.647058824,0.294117647,0.058823529
adaptu LLC,10408,0,0,0,0,0,0,0
Circularhub.com,10409,0,0,0,0,0,0,0
bookit.com,2175,4,1,0,5,0.8,0.2,0
Cancer Research UK,10336,0,0,0,0,0,0,0
OverApps,2174,0,0,0,0,0,0,0
Sainsbury's Bank plc,10338,0,0,0,0,0,0,0
International Fellowship of Christians and Jews,2183,0,0,3,3,0,0,1
RIAS plc,10340,0,0,0,0,0,0,0
Cirque Du Soleil,2180,7,0,0,7,1,0,0
Mental Floss,10337,0,0,1,1,0,0,1
First Merchants Corporation,9410,0,0,0,0,0,0,0
shutterstock,2176,0,0,1,1,0,0,1
Service Employees International Union (SEIU),10339,0,0,0,0,0,0,0
FashionPlaytes,9417,0,0,0,0,0,0,0
Boticca.com,9486,0,0,0,0,0,0,0
Larry H. Miller Used Car Supermarket,9411,0,0,0,0,0,0,0
Crozer-Keystone Health System,9413,0,0,0,0,0,0,0
Fanatic U,9418,0,0,0,0,0,0,0
Chartered Financial Analyst (CFA) Institute,2179,0,0,0,0,0,0,0
VHA,8304,0,0,0,0,0,0,0
Battleship Movie,9040,0,0,0,0,0,0,0
Bergdorf Goodman,2476,5,0,0,5,1,0,0
Nuclear Energy Institute,8704,1,0,0,1,1,0,0
gamigo AG,2473,3,0,0,3,1,0,0
Ivy Bridge College,10411,0,0,0,0,0,0,0
POLITICO LLC,2474,1,0,0,1,1,0,0
Unitrin Direct,2479,0,0,0,0,0,0,0
Huron Valley-Sinai,10412,0,0,0,0,0,0,0
"Provide Commerce, Inc.",2480,1,2,2,5,0.2,0.4,0.4
Modasuite Corporation Inc.,10413,1,0,0,1,1,0,0
Janovic,10417,0,0,0,0,0,0,0
Arizona Rattlers,10415,0,0,0,0,0,0,0
FixBee,10013,0,0,0,0,0,0,0
Yerba Buena Center for the Arts,8957,0,0,0,0,0,0,0
Casa Palmera Treatment Facility,2486,0,0,0,0,0,0,0
NBC Universal Parks & Resorts,2478,15,1,3,19,0.789473684,0.052631579,0.157894737
Anthem Blue Cross,2484,0,0,0,0,0,0,0
Sport-emotions.com,10012,0,0,0,0,0,0,0
eSalon LLC,10419,0,0,0,0,0,0,0
juicypark.com,2488,0,0,0,0,0,0,0
"Europe Entertainment, S.R.L.",10421,0,0,0,0,0,0,0
eBuddy,10423,0,0,0,0,0,0,0
"Kabam, Inc.",2481,36,0,4,40,0.9,0,0.1
Jordan Brand Classic,10015,0,0,0,0,0,0,0
Ed Martin Automotive Group,10422,1,0,0,1,1,0,0
Great Falls International Airport,10420,0,0,0,0,0,0,0
Santa Cruz County Conference and Visitors Council,10011,0,0,0,0,0,0,0
"Unrivaled Media Group, LLC.",10019,0,0,0,0,0,0,0
"H.BLOOM, Inc",8019,0,0,0,0,0,0,0
ibario.com,10014,0,0,0,0,0,0,0
Tourism Corporation of Gujarat Limited,10018,0,0,0,0,0,0,0
INVISTA North America,10020,0,0,0,0,0,0,0
Monterey Bay Aquarium Foundation,10017,0,0,0,0,0,0,0
Quenchonline.com,10016,0,0,0,0,0,0,0
The Marine Mammal Center,10022,0,0,0,0,0,0,0
Lockheed Martin,2273,0,0,5,5,0,0,1
Concorde Career College,10427,0,0,0,0,0,0,0
MaxPro Software,2278,0,0,0,0,0,0,0
Mirror UK (MGN Ltd),10426,0,0,0,0,0,0,0
The Snoring Center,10424,0,0,0,0,0,0,0
inrdx.com,10024,0,0,0,0,0,0,0
"Drexel e-Learning, Inc.",10434,0,0,0,0,0,0,0
Oldemark LLC.,4110,0,0,1,1,0,0,1
Kay Jewelers,2286,0,0,1,1,0,0,1
Sportswear Inc,2276,0,0,0,0,0,0,0
"DeskToolsSoft, Inc.",2489,0,0,0,0,0,0,0
Wizard World,8740,0,0,0,0,0,0,0
InterContinental Hotels Group,2283,6,1,2,9,0.666666667,0.111111111,0.222222222
Simon Property Group,2274,9,1,14,24,0.375,0.041666667,0.583333333
Moviehuts.com,10416,0,0,0,0,0,0,0
Orient Express Hotels,2277,0,0,0,0,0,0,0
Hawaii Tourism Authority,2296,10,0,3,13,0.769230769,0,0.230769231
Accenture,2483,0,0,1,1,0,0,1
"Old Dominion Freight Line, Inc.",9728,0,0,0,0,0,0,0
MBO Partners,10435,0,0,0,0,0,0,0
AVG Technologies,2285,14,1,0,15,0.933333333,0.066666667,0
Palm Beach County Convention and Visitors Bureau,10414,12,0,3,15,0.8,0,0.2
University of St. Francis,10023,0,0,0,0,0,0,0
AdvisorWorld.com,10438,0,0,0,0,0,0,0
"Boundary, Inc.",10430,0,0,0,0,0,0,0
Salem Communications Corporation,2309,3,0,1,4,0.75,0,0.25
Carbonite,2298,9,0,0,9,1,0,0
Ice.com,2300,0,0,0,0,0,0,0
Restore Vision Centers,9736,0,0,0,0,0,0,0
CBC/RADIO-CANADA,2314,1,0,1,2,0.5,0,0.5
National Guitar Workshop,10437,0,0,0,0,0,0,0
"Office of the Governor, Economic Development and Tourism",2475,1,0,1,2,0.5,0,0.5
"ShopJimmy.com, LLC.",10555,0,0,0,0,0,0,0
Receivables Exchange,2280,0,0,0,0,0,0,0
Royal Caribbean,2477,9,4,8,21,0.428571429,0.19047619,0.380952381
Franco's Fine Clothier,10497,0,0,0,0,0,0,0
Questar Gas Company,10479,0,0,0,0,0,0,0
Birch Gold Group,10429,0,0,0,0,0,0,0
Safecount,2304,21,2,8,31,0.677419355,0.064516129,0.258064516
VF Corporation,2288,28,1,12,41,0.682926829,0.024390244,0.292682927
Blue Nile,2292,243,16,0,259,0.938223938,0.061776062,0
Sacred Heart University,10504,2,0,0,2,1,0,0
Conestoga Bank,10499,0,0,0,0,0,0,0
surveyprizebox.com,10483,0,0,0,0,0,0,0
"Flowers Today, Inc.",10480,0,0,0,0,0,0,0
"WS-ORP Development, LLC",9726,0,0,0,0,0,0,0
Eat Healthy Secrets,4111,0,0,0,0,0,0,0
"M Resort, LLC.",10439,0,0,0,0,0,0,0
Boone Homes,10428,0,0,0,0,0,0,0
PCC Natural Markets,9732,0,0,0,0,0,0,0
Personal Career Management,10508,0,0,0,0,0,0,0
Pitney Bowes,2297,2,1,0,3,0.666666667,0.333333333,0
ServerBeach Dedicated Servers,9734,0,0,0,0,0,0,0
St. George’s University,2291,2,0,1,3,0.666666667,0,0.333333333
The Austin American-Statesman,10482,0,0,0,0,0,0,0
Daytona Beach Area Convention & Visitors Bureau,10443,0,0,0,0,0,0,0
Alexander Company,10511,0,0,0,0,0,0,0
"AdBacker, Inc.",10500,0,0,0,0,0,0,0
Ohio Department of Taxation,10442,0,0,0,0,0,0,0
"MySavings, Inc.",2308,0,0,1,1,0,0,1
CoolGelSolutions.com,9730,0,0,0,0,0,0,0
NARFE,10529,0,0,0,0,0,0,0
Healthline Networks,2294,1,0,0,1,1,0,0
Sharon Riley's,9747,0,0,0,0,0,0,0
CCS Direct LLC.,10433,0,0,0,0,0,0,0
Lincoln Educational Services Corporation,2302,0,0,0,0,0,0,0
"Caesars License Company, LLC.",10507,6,0,3,9,0.666666667,0,0.333333333
CLIO Awards,10487,0,0,0,0,0,0,0
MassDevelopment,10501,0,0,0,0,0,0,0
NBRI,10492,0,0,0,0,0,0,0
SEPTA,10510,0,0,0,0,0,0,0
"PMG Research, Inc.",10575,0,0,0,0,0,0,0
Ringside Collectibles Inc.,10503,0,0,0,0,0,0,0
MyCashNow,10478,0,0,0,0,0,0,0
"ArenaNet, Inc.",10496,0,0,0,0,0,0,0
Arc Quest Co. Ltd.,10490,0,0,0,0,0,0,0
The Executive MBA Council,10549,0,0,0,0,0,0,0
CreditCardColumn,10531,0,0,0,0,0,0,0
River Spirit Casino,10485,0,0,0,0,0,0,0
Bryan Pearson,10431,0,0,0,0,0,0,0
Marble Falls/Lake LBJ Chamber of Commerce,10551,0,0,0,0,0,0,0
The RCS Network,10514,0,0,0,0,0,0,0
Medical Guardian LLC,10512,0,0,0,0,0,0,0
Resurgens P.C.,9762,0,0,0,0,0,0,0
BuyerZone.com,2305,7,0,0,7,1,0,0
IntelliChoice Source Interlink Media,9737,0,0,0,0,0,0,0
Egypt Tourism,10441,0,0,0,0,0,0,0
SF Film Society,10572,0,0,0,0,0,0,0
RedStateJobs.com,10542,0,0,0,0,0,0,0
EducationGrant.com,10440,0,0,0,0,0,0,0
Central Iowa Tobacco-free Partnership,9770,0,0,0,0,0,0,0
"Roger Cleveland Golf Company, Inc.",10493,0,0,0,0,0,0,0
Bahia Principe,10521,0,0,0,0,0,0,0
Wagner College,10495,0,0,0,0,0,0,0
GoHealthInsurance.com,10538,0,0,0,0,0,0,0
Tyco,9729,0,0,0,0,0,0,0
shopcrossroadsplaza.com,9735,0,0,0,0,0,0,0
"Harpo, Inc.",2310,1,0,1,2,0.5,0,0.5
Stone Bridge Homes,10532,0,0,0,0,0,0,0
KeyPoint Credit Union,10491,0,0,0,0,0,0,0
New Sterling Resorts,9749,0,0,0,0,0,0,0
Livestream,2315,0,0,0,0,0,0,0
Just The Story,9740,0,0,0,0,0,0,0
St. Petersburg College,10518,0,0,0,0,0,0,0
New York Jets,10498,1,0,0,1,1,0,0
Sentry Select Capital Corp,9772,0,0,0,0,0,0,0
The University of Utah,10481,0,0,0,0,0,0,0
Tampa Bay Radiation Oncology,9750,0,0,1,1,0,0,1
Crescent City Fitness Foundation,9744,0,0,0,0,0,0,0
"Sulaiman Law Group, LTD",9742,0,0,0,0,0,0,0
SpotProperty,10567,0,0,0,0,0,0,0
Auto-InsuranceChoices.com,9766,0,0,0,0,0,0,0
West Coast Unversity,9738,0,0,0,0,0,0,0
Play Turtle LLC,10568,0,0,0,0,0,0,0
"National Shooting Sports Foundation, Inc.",10488,0,0,0,0,0,0,0
Institute of 21st Century Energy,10516,0,0,0,0,0,0,0
Kia Dealerships,10506,15,0,1,16,0.9375,0,0.0625
Hot Shot Media,10553,0,0,0,0,0,0,0
Open Door Mission,10535,0,0,0,0,0,0,0
RELYmedia,10517,0,0,0,0,0,0,0
"The Performing Arts Center, SUNY",10536,0,0,1,1,0,0,1
NJ TRANSIT,9767,0,0,0,0,0,0,0
CIRI Alaska Tourism Corporation,9761,0,0,0,0,0,0,0
"Montgomery Inn, Inc.",10619,0,0,0,0,0,0,0
Epiphone Guitar Corp.,10541,0,0,0,0,0,0,0
SmartAutoSavings.com,9763,0,0,0,0,0,0,0
Glassdoor,10623,0,0,0,0,0,0,0
"ShopLocal, LLC.",10559,3,0,5,8,0.375,0,0.625
OpenX,10533,1,0,0,1,1,0,0
Melrose Credit Union,10525,0,0,0,0,0,0,0
Imperial College London,10561,0,0,1,1,0,0,1
Southern Methodist University,10527,0,2,0,2,0,1,0
Green Century Capital Management,9753,0,0,0,0,0,0,0
BusinessQuest,10612,0,0,0,0,0,0,0
Char-Broil,10625,0,0,0,0,0,0,0
Siber Systems,9764,0,0,0,0,0,0,0
"eDirectPublishing, Inc.",10620,1,0,1,2,0.5,0,0.5
"Global Value Add, Inc.",9771,0,0,0,0,0,0,0
Feld Entertainment,10547,0,0,1,1,0,0,1
Korea Tourism Organization,10621,3,0,0,3,1,0,0
HiFX Plc,10513,0,0,0,0,0,0,0
Nepal Tourism Board,9752,0,0,0,0,0,0,0
"Joshua Tree Financial, Inc.",10554,0,0,0,0,0,0,0
NuVo Technologies,9754,0,0,0,0,0,0,0
"Chuck Hafner's Farmers Market & Garden Center, Inc.",10622,0,0,0,0,0,0,0
Fulton Financial Corporation,10505,0,0,0,0,0,0,0
"Smith Debnam Narron Drake Saintsing & Myers, LLP",10548,0,0,0,0,0,0,0
Duff & Phelps Corp,10566,0,0,0,0,0,0,0
Nature America Inc,10530,0,0,0,0,0,0,0
"Johnson & Johnson Vision Care, Inc. (JJVCI)",10573,0,0,0,0,0,0,0
Community Prevention Resources,10616,0,0,0,0,0,0,0
"America, Inc.",9748,0,0,0,0,0,0,0
"Weebly, Inc.",9751,2,1,0,3,0.666666667,0.333333333,0
SpiceJet,10494,0,0,0,0,0,0,0
Mount Ida College,9741,0,0,0,0,0,0,0
Ourbookofliquidgold.com,9756,0,0,0,0,0,0,0
Calipercorp.com,9760,0,0,0,0,0,0,0
Camden Military Academy,10560,0,0,0,0,0,0,0
Emedco,10526,0,0,0,0,0,0,0
The Greater Fort Lauderdale Convention & Visitors Bureau,10528,0,0,0,0,0,0,0
Thisis50 Store,10626,1,0,0,1,1,0,0
CowBoom,9758,0,0,0,0,0,0,0
Young Automotive Group,10543,0,0,0,0,0,0,0
"Travel Leaders Group, LLC.",10484,0,0,0,0,0,0,0
Go-Downloads.com,2313,0,0,0,0,0,0,0
Forza Communications,9733,0,0,0,0,0,0,0
"Tamron USA, Inc.",10502,2,0,2,4,0.5,0,0.5
Lollapalooza,10520,0,0,0,0,0,0,0
Tammy Baldwin for Senate,9765,0,0,0,0,0,0,0
Florida Department of Health,10570,0,0,0,0,0,0,0
Genie Bra,10021,0,0,0,0,0,0,0
Quantcast,2290,0,0,3,3,0,0,1
Jeff Who Lives at Home Movie,9746,0,0,0,0,0,0,0
"Chesapeake Midstream Partners, L.P.",10557,0,0,0,0,0,0,0
"Hydroxatone, LLC",10564,0,0,0,0,0,0,0
CORSET DEAL,10539,0,0,0,0,0,0,0
Century 21 Real Estate LLC,10614,1,0,0,1,1,0,0
LaughStub,10486,0,0,0,0,0,0,0
MedicAlert Foundation,10550,0,0,0,0,0,0,0
Turnberry Towers,10617,0,0,0,0,0,0,0
News Group Newspapers Limited,10565,0,0,0,0,0,0,0
Force Movement,10574,0,0,0,0,0,0,0
"P.J. Fitzpatrick, Inc.",10540,0,0,0,0,0,0,0
Secured Gold Buyers,10519,0,0,0,0,0,0,0
Interwetten,10534,0,0,0,0,0,0,0
Mr Roof,10537,0,0,0,0,0,0,0
MB Financial Bank,10613,0,0,0,0,0,0,0
Amprobe,10615,0,0,0,0,0,0,0
State of Florida,9745,0,0,0,0,0,0,0
mophie inc.,10515,0,0,7,7,0,0,1
Expanscience Laboratories,10556,0,0,3,3,0,0,1
Raycom Media Station,10558,0,0,0,0,0,0,0
The Webby Awards,10522,0,0,0,0,0,0,0
GigeNET,10624,0,0,0,0,0,0,0
Goode Company,8319,0,0,0,0,0,0,0
obeyyourbody.ie,9055,0,0,0,0,0,0,0
What Katie Did,8757,0,0,0,0,0,0,0
Scottsdale Cultural Council,9125,0,0,0,0,0,0,0
"LifeScan, Inc.",8336,0,0,1,1,0,0,1
Belz Enterprises,8889,0,0,0,0,0,0,0
Taubman Centers,9172,0,0,0,0,0,0,0
Broadway in Richmond,9880,0,0,0,0,0,0,0
remilitary.com,10144,0,0,0,0,0,0,0
Agilent,8526,0,0,0,0,0,0,0
"Channellock, Inc.",10459,0,0,2,2,0,0,1
Pacific Sunwear of California Inc.,10143,4,0,0,4,1,0,0
PinnacleHealth,10453,0,0,0,0,0,0,0
"Growthink, Inc.",8524,1,0,0,1,1,0,0
"Palomar Medical Technologies, Inc.",10448,0,0,0,0,0,0,0
Terremark Worldwide,8525,0,1,0,1,0,1,0
"Unbounce Marketing Solutions, Inc.",9890,0,0,0,0,0,0,0
Kiplinger’s Personal Finance,9879,0,0,0,0,0,0,0
Arch Chemicals,8534,0,0,0,0,0,0,0
Gemological Institute of America Inc.,9564,0,0,0,0,0,0,0
Piedmont Park Conservancy,9570,0,0,0,0,0,0,0
The Help Movie,8530,0,0,0,0,0,0,0
"Extremetix, Inc.",10268,0,0,0,0,0,0,0
Kettle Foods,8539,0,0,0,0,0,0,0
Park Square Homes,10265,0,0,0,0,0,0,0
"Hair Cubed, LLC.",8545,0,0,0,0,0,0,0
Connecticut Science Center,9888,0,0,0,0,0,0,0
EVA Airways Corp,8532,0,0,0,0,0,0,0
Supporthermancain.com,8553,0,0,0,0,0,0,0
"Entrust, Inc.",10467,0,0,0,0,0,0,0
Gunggo Co Ltd,10710,0,0,0,0,0,0,0
Austrian Airlines,8554,0,0,0,0,0,0,0
Middlesex County Regional Chamber of Commerce,10474,0,0,0,0,0,0,0
"Roxann Taylor & Associates, Realtors",9559,0,0,0,0,0,0,0
Olivet Nazarene University,10712,0,0,0,0,0,0,0
Clarins,10446,0,0,0,0,0,0,0
Shoppers Drug Mart Inc,9882,0,0,0,0,0,0,0
Steward Health Care,10353,0,0,0,0,0,0,0
Eurostar Group,10699,1,4,1,6,0.166666667,0.666666667,0.166666667
Intacct Corporation,10153,1,0,0,1,1,0,0
Century Tile,10704,0,0,0,0,0,0,0
"GARDNER, REALTORS",10263,0,0,0,0,0,0,0
Prism Hypnosis,10450,0,0,0,0,0,0,0
DiWine,9571,0,0,0,0,0,0,0
Cooper Tire & Rubber Company,10148,0,0,0,0,0,0,0
"Shiseido, Co.",10457,4,0,1,5,0.8,0,0.2
Land Rover Dealerships,9565,2,0,3,5,0.4,0,0.6
"Celebrity Series of Boston, Inc.",10275,0,0,0,0,0,0,0
Beech-Nut Nutrition Corporation,10151,0,0,0,0,0,0,0
The SBA,10709,0,0,0,0,0,0,0
Carl H. Lindner College of Business,8531,0,0,0,0,0,0,0
The Telegraph,10463,0,0,0,0,0,0,0
Patelco Credit Union,8541,0,0,0,0,0,0,0
Aspen Central Reservation & Snowmass Central Reservations,9885,0,0,0,0,0,0,0
"New Video Group, Inc.",10155,0,0,0,0,0,0,0
Gourme Food Company LLC.,10152,0,0,0,0,0,0,0
Paul Stuart,8547,0,0,0,0,0,0,0
MindTouch,8544,0,0,0,0,0,0,0
VIVICA A. FOX HAIR COLLECTION,10147,0,0,0,0,0,0,0
DailyConsumerAlert.org,10351,0,0,1,1,0,0,1
Audioconsultants.com,10702,0,0,0,0,0,0,0
Sage 50,10718,3,0,0,3,1,0,0
San Jose Medical Group,10711,0,0,0,0,0,0,0
Integrate,10465,0,0,0,0,0,0,0
Downtown Cleveland Alliance,8536,0,0,0,0,0,0,0
Pacific Place,10347,0,0,0,0,0,0,0
Iron Horse Holdings,8551,1,0,0,1,1,0,0
RebateGiant.com,10472,0,0,0,0,0,0,0
Looki Publishing,10344,0,0,0,0,0,0,0
"Prestige Care, Inc.",8550,0,0,0,0,0,0,0
Nest Labs,10356,4,0,1,5,0.8,0,0.2
Northwestern Memorial Hospital,10157,0,0,0,0,0,0,0
Sport Chalet,10461,3,0,0,3,1,0,0
GiANT Impact,10706,0,0,0,0,0,0,0
AbsoluteWealth.com,10690,0,0,0,0,0,0,0
Exotic Driving Experience,10719,0,0,0,0,0,0,0
"Cornerstone OnDemand, Inc.",10722,0,0,0,0,0,0,0
Areaware,10466,0,0,0,0,0,0,0
Sony Mobile Communications,10473,0,0,0,0,0,0,0
Ashley Furniture Industries Inc.,10691,7,0,1,8,0.875,0,0.125
Pierre Money Mart,10346,0,0,0,0,0,0,0
Social Grocery,8549,0,0,0,0,0,0,0
Southeast Steel,10464,1,0,1,2,0.5,0,0.5
Playality Limited,10274,0,0,0,0,0,0,0
United Auburn Indian Community,10471,0,0,0,0,0,0,0
"FLIR Systems, Inc.",10271,6,0,0,6,1,0,0
Methodist Health System,10700,0,0,0,0,0,0,0
Trappist Caskets,10707,0,0,1,1,0,0,1
"Carter Healthcare, Inc.",10714,0,0,0,0,0,0,0
Real Estate One,10725,0,0,0,0,0,0,0
St. Mary's Medical Center,10695,0,0,0,0,0,0,0
International Exposition Center,10727,0,0,0,0,0,0,0
FM Global,9886,0,0,1,1,0,0,1
Vision Direct,10349,0,0,0,0,0,0,0
Atlanta Food & Wine Festival,9878,0,0,0,0,0,0,0
"WorldPay US, Inc.",10146,0,0,0,0,0,0,0
Happybidday.com,9560,0,0,0,0,0,0,0
"Full Sail, LLC.",10264,3,0,0,3,1,0,0
Randolph-Brooks Federal Credit Union,8535,0,0,0,0,0,0,0
Missouri Botanical Garden,10689,0,0,0,0,0,0,0
"Natura Pet Products, Inc.",8528,0,0,2,2,0,0,1
Insane Home Fat Loss,10149,2,0,0,2,1,0,0
Super Health Systems,9567,0,0,0,0,0,0,0
UK Trade & Investment (UKTI),10267,0,0,0,0,0,0,0
Intermedia,8546,0,0,0,0,0,0,0
Children's Hospital Boston,10717,0,0,0,0,0,0,0
"Health Grades, Inc.",10721,2,0,0,2,1,0,0
Miracle Castle Limited,9883,0,0,0,0,0,0,0
The Klein Company,10451,0,0,0,0,0,0,0
Cambridge Healthtech Institute,10452,0,0,0,0,0,0,0
Brafton,9884,0,0,0,0,0,0,0
"Bluestar, LLC (Brownlee Jewelers)",9566,1,0,1,2,0.5,0,0.5
"Lendgo, Inc.",10352,0,0,0,0,0,0,0
Dining Out For Life International,10469,0,0,0,0,0,0,0
"Miami Rescue Mission, Inc.",10470,0,0,0,0,0,0,0
"eos Products, LLC",10720,0,0,0,0,0,0,0
Carmel Symphony Orchestra,9881,0,0,0,0,0,0,0
Chicago Opera Theater,10145,0,0,0,0,0,0,0
David DeAngelo Marketing Inc.,10454,0,0,0,0,0,0,0
The Los Angeles Film School,10456,0,0,0,0,0,0,0
Pace University,10154,0,0,0,0,0,0,0
"Charles Schwab & Co., Inc.",10156,3,1,22,26,0.115384615,0.038461538,0.846153846
Mulberry Company,8552,0,0,0,0,0,0,0
ChiroAppointment.com,10354,0,0,0,0,0,0,0
US.Animationschools.us.com,10713,12,0,0,12,1,0,0
The Nasher Foundation,10724,0,0,0,0,0,0,0
Hispavista,9877,0,0,0,0,0,0,0
"ATP Tour, Inc.",10445,0,0,0,0,0,0,0
AHAlife,9558,0,0,0,0,0,0,0
The Inn at Perry Cabin,10458,0,0,0,0,0,0,0
IMS LLC,10343,0,0,0,0,0,0,0
Reynolds Consumer Products Inc.,10460,0,0,0,0,0,0,0
Governor Finance Limited,10345,0,0,0,0,0,0,0
Peter and the Starcatcher,10475,0,0,0,0,0,0,0
"Silicon Mechanics, Inc",10694,0,0,0,0,0,0,0
OneHourTranslation,10728,0,0,0,0,0,0,0
First Team Real Estate,8533,0,0,1,1,0,0,1
Convergys,9887,4,0,0,4,1,0,0
QuitNet.com,10355,0,0,0,0,0,0,0
The Zaremba Management Company,10698,0,0,2,2,0,0,1
"Rosenberry Rooms, LLC.",10269,0,0,0,0,0,0,0
Granville Island Hotel,10701,0,0,0,0,0,0,0
Penny Stock Heroes,9562,0,0,0,0,0,0,0
Patrick Henry College,9569,0,0,0,0,0,0,0
Wicked the Musical,10273,0,0,0,0,0,0,0
Central Garden & Pet Company,10705,0,0,0,0,0,0,0
Coushatta Casino Resort,10716,2,0,0,2,1,0,0
"American Properties Realty, Inc.",10723,0,0,0,0,0,0,0
SINGAPORE PROMISE,8527,0,0,0,0,0,0,0
Silence NY Limited Partnership,9572,0,0,0,0,0,0,0
"Schiff Nutrition Group, Inc.",10270,0,0,1,1,0,0,1
"PowerReviews, Inc.",10272,0,0,0,0,0,0,0
United States Fund for Unicef,10697,0,0,0,0,0,0,0
"Carole Smith, Realtor",10708,0,0,0,0,0,0,0
Tucows Inc,9573,0,0,0,0,0,0,0
FRAM Group,10158,0,0,0,0,0,0,0
Capitol Corridor Joint Powers Authority,10477,0,0,0,0,0,0,0
Erickson Living,10726,0,0,0,0,0,0,0
Emerson Electric Co.,8770,0,0,0,0,0,0,0
Performance Health,8974,0,0,0,0,0,0,0
Orange County Regional History Center,8774,0,0,0,0,0,0,0
"Check Into Cash, Inc.",10026,0,0,1,1,0,0,1
Direct Results Marketing Group,10028,0,0,0,0,0,0,0
American Friends of Meir Panim,8136,0,0,1,1,0,0,1
STD Test Express,10029,0,0,0,0,0,0,0
Charlie Hales for Mayor,10027,0,0,0,0,0,0,0
FlightNetwork,10030,0,0,0,0,0,0,0
Q1 LLC,10284,0,0,0,0,0,0,0
ALEXANDRIA MUIR'S PTY LTD ACN,9189,0,0,0,0,0,0,0
FusionCharts,10032,0,0,0,0,0,0,0
Missourians for a Balanced Energy Future (MBEF),10279,0,0,0,0,0,0,0
Buncombe County Tourism Development Authority,10278,0,0,0,0,0,0,0
Pro Football Hall of Fame,10034,0,0,0,0,0,0,0
Salt Lake Tribune,10285,0,0,0,0,0,0,0
Sybase Inc.,10281,0,0,0,0,0,0,0
Ecopharma LLC.,10286,0,0,0,0,0,0,0
Best Friends Animal Society,8857,0,0,0,0,0,0,0
Gnomon Inc.,9294,0,0,1,1,0,0,1
Tucson Chapter of the American Marketing Assoc.,8872,0,0,0,0,0,0,0
eSpatial Solutions,10036,0,0,0,0,0,0,0
FastCut CNC Inc.,9298,0,0,0,0,0,0,0
Britishnewsdaily.com,9299,0,0,0,0,0,0,0
SHAKESPEARE THEATERE COMPANY,9304,0,0,0,0,0,0,0
Infinity Concept,9300,0,0,0,0,0,0,0
Simple Menu,8921,0,0,0,0,0,0,0
The Sol Group Corp.,9896,0,0,0,0,0,0,0
NMTW Community Credit Union,8874,0,0,0,0,0,0,0
Rainey Construction,10040,0,0,0,0,0,0,0
Erie Indemnity Co,9927,0,0,0,0,0,0,0
CommissionBreakthrough.com,9302,0,0,0,0,0,0,0
Grove City College,9580,0,0,0,0,0,0,0
Gaiam Americas,9908,0,0,0,0,0,0,0
Meemi,9899,0,0,0,0,0,0,0
New Orleans Jazz & Heritage Festival & Foundation,9306,0,0,0,0,0,0,0
Simmons Browder Gianaris Angelides & Barnerd,9901,0,0,1,1,0,0,1
Ordway Center for the Performing Arts,9582,0,0,0,0,0,0,0
Madison Marquette,9928,0,0,0,0,0,0,0
DL1961.com,10167,4,0,0,4,1,0,0
CaringBridge,9904,0,0,0,0,0,0,0
Owen Media Partners Inc.,9586,0,0,0,0,0,0,0
PConverter.com,10185,0,0,0,0,0,0,0
"Pacific Foods of Oregon, Inc.",9576,0,0,0,0,0,0,0
Hennepin Theatre Trust,9912,0,0,0,0,0,0,0
Henkel AG & Company,10039,0,1,2,3,0,0.333333333,0.666666667
Karako Suits,9929,0,0,0,0,0,0,0
Tori Richard Ltd.,10184,0,0,0,0,0,0,0
Koyote-Lab Inc.,10200,4,0,0,4,1,0,0
"TriAd Media Solutions, Inc.",10201,9,0,1,10,0.9,0,0.1
ResumeCompanion.com,10186,0,0,0,0,0,0,0
Progressive Change Campaign Committee PAC,10165,0,0,0,0,0,0,0
Harrington College of Design,10041,0,0,0,0,0,0,0
Foundations.com,9906,0,0,0,0,0,0,0
St. Thomas University,9303,1,0,0,1,1,0,0
Jayport,10170,0,0,0,0,0,0,0
"Lifetime Brands, Inc.",10193,0,0,0,0,0,0,0
Tropfest,9597,0,0,0,0,0,0,0
Shure Incorporated,10179,0,0,0,0,0,0,0
The Resort Collection of Panama City Beach,9596,0,0,1,1,0,0,1
"Enterasys Networks, Inc.",9938,0,0,0,0,0,0,0
California Association of Realtors,10192,0,0,0,0,0,0,0
Jack Schwartz Shoes Inc.,10199,0,0,0,0,0,0,0
W. Atlee Burpee & Co.,10188,1,0,0,1,1,0,0
STATS LLC,10172,0,0,0,0,0,0,0
Freddie Mac,9903,0,0,0,0,0,0,0
International Association of Fire Fighters,10173,0,0,0,0,0,0,0
ExpertHub.com,10204,0,0,0,0,0,0,0
EverydayFamily.com,10759,0,0,0,0,0,0,0
"United States Nutrition, Inc.",9602,0,0,0,0,0,0,0
"HomeAway.com, Inc.",9605,4,0,0,4,1,0,0
Private Label By G,10203,0,0,0,0,0,0,0
Fine Arts Museums of San Francisco,9939,0,0,0,0,0,0,0
Brown Hand Center,10171,0,0,0,0,0,0,0
Newedge Group,9604,0,0,0,0,0,0,0
Community Financial Members Federal Credit Union,9589,0,0,0,0,0,0,0
Landmark Theatres,10197,1,0,0,1,1,0,0
Free-Choices.com,10206,2,0,0,2,1,0,0
DePuy Companies,10174,0,0,0,0,0,0,0
Utah Commission on Marriage,10207,0,0,0,0,0,0,0
Scottsdale Bullion and Coin,10180,0,0,0,0,0,0,0
"Zyrion, Inc.",9606,0,0,0,0,0,0,0
Profinity,10208,0,0,0,0,0,0,0
Sierra RV Sales,9892,0,0,0,0,0,0,0
Global Event Forum,9575,0,0,0,0,0,0,0
Harvard Pilgrim Health Care,10175,2,0,3,5,0.4,0,0.6
The Fix,10177,0,0,0,0,0,0,0
Milwaukee Admirals,10194,0,0,0,0,0,0,0
"Ace Ticket Worldwide, Inc.",10828,0,0,0,0,0,0,0
YMCA of Southern Nevada,10209,0,0,0,0,0,0,0
Regis University College,10288,5,0,4,9,0.555555556,0,0.444444444
Working America,9579,0,0,0,0,0,0,0
Richard Paul Evans Publishing,9911,0,0,0,0,0,0,0
S.M. Entertainment,9296,0,0,0,0,0,0,0
Pittsburgh Public Theater,9585,0,0,0,0,0,0,0
Jamestown-Yorktown Foundation,10164,0,0,0,0,0,0,0
San Antonio Convention & Visitors Bureau,9603,0,0,0,0,0,0,0
Sonora Mills,10178,0,0,0,0,0,0,0
Get Rent To Own Corp,10182,0,1,0,1,0,1,0
Hass Avocado Board,9914,0,0,0,0,0,0,0
clubtix.com,10196,0,0,0,0,0,0,0
Irwin Naturals,9900,0,0,0,0,0,0,0
Santa Anita Park,9581,0,0,0,0,0,0,0
Mercer County Community College,9932,0,0,0,0,0,0,0
Dataversity,9599,0,0,0,0,0,0,0
Milwaukee Beer Week,10283,0,0,0,0,0,0,0
HostMySite,9898,0,0,0,0,0,0,0
"Transitions Optical, Inc.",10166,0,0,0,0,0,0,0
Inyo Pool Products Inc.,9598,0,0,0,0,0,0,0
Liberty Bank,10202,0,0,0,0,0,0,0
BBC Worldwide Ltd,10290,1,0,0,1,1,0,0
Mach 1 Mud Run,9577,0,0,0,0,0,0,0
Miami Home and Outdoor Living Show,9588,0,0,0,0,0,0,0
Sebastian Professional,9913,0,0,0,0,0,0,0
SchoolsFirst FCU,10181,0,0,0,0,0,0,0
Center REPertory Company,10287,0,0,0,0,0,0,0
Harman-stoves.com,10037,0,0,0,0,0,0,0
Healthy Page,9301,0,0,0,0,0,0,0
Creekstone Farms,9894,0,0,0,0,0,0,0
St. Louis Rams,10162,0,0,0,0,0,0,0
London & Partners,9905,0,0,0,0,0,0,0
"Milbon USA, Inc.",9594,0,0,0,0,0,0,0
The Pirates! Movie,10198,0,0,0,0,0,0,0
FGL Sports Ltd.,10205,18,0,1,19,0.947368421,0,0.052631579
Le Cordon Bleu College of Culinary Arts,10033,30,1,0,31,0.967741935,0.032258065,0
Home Security Video Surveillance System,9297,0,0,0,0,0,0,0
The Cleaning Authority,9902,0,0,0,0,0,0,0
College in Colorado,9583,0,0,0,0,0,0,0
NBC Universal Television (nbc.com),10169,0,0,12,12,0,0,1
vindicosuite.com,9933,0,0,0,0,0,0,0
Rush University Medical Center,10183,0,0,0,0,0,0,0
Volvo Dealerships,9930,0,0,2,2,0,0,1
Paradyme,9937,0,0,0,0,0,0,0
Idaho Fish and Game,10187,0,0,0,0,0,0,0
GamesTotal.com,10031,0,0,0,0,0,0,0
Goodpickle.com,9293,0,0,0,0,0,0,0
Profiles Theatre,9897,0,0,0,0,0,0,0
GreatFlorida Insurance Holdings Corp.,10163,0,0,0,0,0,0,0
Small Business Association of Michigan,9931,0,0,0,0,0,0,0
XO Group Inc,9593,16,8,0,24,0.666666667,0.333333333,0
American Laser Centers,9595,0,0,0,0,0,0,0
API,10195,0,0,0,0,0,0,0
"salesforce.com, inc.",10277,10,0,10,20,0.5,0,0.5
Vo!ce of the Region,10160,0,0,0,0,0,0,0
"Open Road Integrated Media, Inc.",10043,0,0,0,0,0,0,0
Camp Jam,9305,0,0,0,0,0,0,0
Pittsburgh Post-Gazette,9926,0,0,1,1,0,0,1
CommVault,9592,0,0,0,0,0,0,0
The Toledo Times,9907,0,0,0,0,0,0,0
Correios,9909,0,0,0,0,0,0,0
CAP,9004,3,1,0,4,0.75,0.25,0
FINDITHERE.COM,9238,0,0,0,0,0,0,0
Medina Auto Mall,9006,0,0,0,0,0,0,0
Brake Movie,9674,0,0,0,0,0,0,0
CosmaLite,9942,0,0,0,0,0,0,0
Chicago Comic & Entertainment Expo,9240,0,0,0,0,0,0,0
The Bradford Exchange Online,10635,1,0,0,1,1,0,0
American Chemical Society,9946,0,0,0,0,0,0,0
Wine & Dine Wisconsin,9949,0,0,0,0,0,0,0
coolpdfreader.com,9225,1,0,0,1,1,0,0
vplayerhd.com,10368,0,0,0,0,0,0,0
LA Weight Loss,10371,0,0,0,0,0,0,0
AltoAdige,9257,0,0,0,0,0,0,0
Toyo Tires,9691,0,0,0,0,0,0,0
United Therapeutics Corporation,9776,0,0,0,0,0,0,0
Scottish Development International,8038,0,0,0,0,0,0,0
South Metro Human Services,9959,0,0,0,0,0,0,0
Workers Compensation Fund,9342,0,0,0,0,0,0,0
Motivators Inc.,9442,0,0,0,0,0,0,0
kindnesstampabay.com,9951,0,0,0,0,0,0,0
Devcon Security Systems Inc.,8404,0,0,0,0,0,0,0
id Software,9808,0,0,0,0,0,0,0
RUG Ltd.,10837,0,0,0,0,0,0,0
NextCare Urgent Care,8053,0,0,0,0,0,0,0
Venture 3 Systems LLC.,10378,1,0,0,1,1,0,0
VacationRoost.com,9508,0,0,0,0,0,0,0
"Budget Blinds, Inc.",9457,0,0,0,0,0,0,0
New England Aquarium,9459,0,0,0,0,0,0,0
King Brand Healthcare Products,8938,1,0,0,1,1,0,0
nursing-schools.us.com,9623,0,0,0,0,0,0,0
Seton Hill University,9545,0,0,0,0,0,0,0
Marqui Solutions Inc,10831,0,0,0,0,0,0,0
Conservation.com,9948,0,0,0,0,0,0,0
Zodiac International,10365,0,0,0,0,0,0,0
Evergreen Realty,9549,0,0,0,0,0,0,0
License Dashboard Limited,9551,0,0,0,0,0,0,0
Apassionata.com,10379,0,0,0,0,0,0,0
Fence Outlet,10833,0,0,1,1,0,0,1
99designs,9957,0,0,0,0,0,0,0
Skyhawks,10051,0,0,0,0,0,0,0
"Wikia, Inc.",10849,0,0,0,0,0,0,0
"Nobel Learning Communities, Inc.",10852,0,0,0,0,0,0,0
Husqvarna AB,10386,0,0,0,0,0,0,0
Indianapolis Museum of Art,10636,0,0,0,0,0,0,0
WhyMarvin.com,10373,0,0,0,0,0,0,0
LA PLACE USA INTERIORS,10859,0,0,0,0,0,0,0
Internet Brands,10737,0,0,1,1,0,0,1
"MAADA, Inc.",10049,0,0,0,0,0,0,0
The Independent Film Channel LLC,10376,0,0,0,0,0,0,0
Twiddy.com,9620,0,0,0,0,0,0,0
The Gambrinus Company,10364,0,0,0,0,0,0,0
Champion Nutrition U.S.A.,10372,0,0,0,0,0,0,0
HelpRx.info,9960,0,0,0,0,0,0,0
Y of Central Maryland,10844,0,0,0,0,0,0,0
Joe for Congress 2012,10638,0,0,0,0,0,0,0
The Shops at Prudential Center,10978,0,0,0,0,0,0,0
Michael Jordan's Steak House,10840,0,0,0,0,0,0,0
Bank of Texas,10050,0,0,0,0,0,0,0
Trafalgar,10390,0,0,0,0,0,0,0
JRTUX.COM,10733,0,0,0,0,0,0,0
Partners for Mental Health,10736,0,0,0,0,0,0,0
Zoostores.com,10835,0,0,0,0,0,0,0
Bankruptcy Home,9961,0,0,0,0,0,0,0
Province of New Brunswick,10856,0,0,0,0,0,0,0
The Woodlands Development Company,9982,0,0,0,0,0,0,0
San Diego Natural History Museum,9983,0,0,0,0,0,0,0
ActionAid,10731,0,0,0,0,0,0,0
Brookfield Engineering,9978,0,0,0,0,0,0,0
RiverView,10867,0,0,0,0,0,0,0
YourFutureRide.com,10740,0,0,0,0,0,0,0
Grounds For Sculpture,9967,0,0,0,0,0,0,0
FireHost Inc.,8557,0,0,0,0,0,0,0
Hangout Music Fest,10391,0,0,0,0,0,0,0
Online Car Stereo,11095,0,0,0,0,0,0,0
Wikihow Inc.,10375,0,0,0,0,0,0,0
Intelliworks,9964,0,0,0,0,0,0,0
NC State University,10654,0,0,0,0,0,0,0
United Way of Metropolitan Chicago,10377,0,0,0,0,0,0,0
ExOfficio LLC,10404,3,0,0,3,1,0,0
Official Yosemite/Mariposa County Tourism Bureau,9546,1,0,0,1,1,0,0
"ExakTime Innovations, Inc.",10836,0,0,0,0,0,0,0
Ewald Automotive Group,10897,0,0,0,0,0,0,0
Madbid,10229,0,0,0,0,0,0,0
United States Marine Corps,9943,0,0,0,0,0,0,0
VPS.net,9945,0,0,0,0,0,0,0
"CarDomain Network, Inc.",10732,0,0,0,0,0,0,0
MERS/Missouri Goodwill Industries,10899,0,0,0,0,0,0,0
Expos2,10393,0,0,0,0,0,0,0
LocalVets.com,10631,0,0,0,0,0,0,0
Köppen North America,9944,0,0,0,0,0,0,0
Revel Entertainment Group,10056,0,0,0,0,0,0,0
Stanforddrivingschool.com,9956,0,0,0,0,0,0,0
"Current USA, Inc.",9962,0,0,0,0,0,0,0
"Saucony, Inc.",10218,1,0,2,3,0.333333333,0,0.666666667
Cornish College of the Arts,10850,0,0,0,0,0,0,0
The Stress Factory,10857,0,0,0,0,0,0,0
Johns Hopkins Bloomberg School of Public Health,9543,0,0,0,0,0,0,0
Carpenter Realtors,11178,0,0,0,0,0,0,0
"Original Appalachian Artworks, Inc.",9969,0,0,0,0,0,0,0
"Huntington Mark, LLC",10667,0,0,0,0,0,0,0
European Union Delegation to the US,10640,0,0,0,0,0,0,0
MOAC Mall Holdings LLC,10630,0,0,0,0,0,0,0
EmblemHealth,10645,103,105,2,210,0.49047619,0.5,0.00952381
EquityLock Solutions,9968,0,0,0,0,0,0,0
intensitynow.com,9553,0,0,0,0,0,0,0
"Rowman & Littlefield Publishing Group, Inc.",10848,0,0,0,0,0,0,0
Uppost,10392,0,0,0,0,0,0,0
ElectionMall Inc.,10385,0,0,0,0,0,0,0
McGrath RentCorp,10402,0,0,0,0,0,0,0
g-r-a-n-t-s.com,10381,0,0,0,0,0,0,0
Lozier Heating & Cooling,10634,0,0,0,0,0,0,0
PayWhere Pte,10053,0,0,0,0,0,0,0
Mark-Taylor Residential Inc.,10641,0,0,0,0,0,0,0
"RSVP Vacations, LLC",10396,0,0,0,0,0,0,0
Dymatize Enterprises LLC.,10213,0,0,0,0,0,0,0
Super Micro Computer,10235,0,0,0,0,0,0,0
Lake Erie Shores & Islands,10841,0,0,0,0,0,0,0
Indiana University of Pennsylvania,10366,0,0,0,0,0,0,0
TrustDale,9613,0,0,0,0,0,0,0
Navarre Beach,9941,0,0,0,0,0,0,0
Koram Game Entertainment Corp.,10649,0,0,0,0,0,0,0
1st Class Medical,9963,0,0,0,0,0,0,0
Loyola University Maryland,9550,0,0,0,0,0,0,0
"Toll Brothers, Inc.",10834,47,2,10,59,0.796610169,0.033898305,0.169491525
EXPERIENCE LEARNING COMMUNITY,10869,0,0,0,0,0,0,0
Vera Bradley Sales,9552,0,0,1,1,0,0,1
Napleton Northlake Auto Park,10678,0,0,0,0,0,0,0
Mount Gay Distilleries,10057,0,0,0,0,0,0,0
"Nature's Bounty, Inc.",10986,0,0,0,0,0,0,0
1E Ltd.,10730,0,0,0,0,0,0,0
American Blue Ribbon Holdings,8560,0,0,0,0,0,0,0
James B. Nutter & Co.,10360,0,0,0,0,0,0,0
"Foreside Fund Services, LLC.",10906,0,0,0,0,0,0,0
"YOU TECHNOLOGY BRAND SERVICES, Inc.",10362,0,0,0,0,0,0,0
SenatryWar,9547,0,0,0,0,0,0,0
KSI Kitchen and Bath,9953,0,0,0,0,0,0,0
smartphonebetatest.com,9609,0,0,0,0,0,0,0
ForAmerica.org,10394,0,0,0,0,0,0,0
FAO Schwarz,10912,0,0,0,0,0,0,0
Best-Offer.org,10637,0,0,0,0,0,0,0
Jonathan Kellerman,10842,0,0,0,0,0,0,0
"Front Row Productions, Inc.",9955,0,0,0,0,0,0,0
Moe Norman Golf,9548,2,0,0,2,1,0,0
Education Votes,10388,0,0,0,0,0,0,0
Scotiabank,10672,0,0,0,0,0,0,0
The Savings Bank Life Insurance Company of Massachusetts,10735,0,0,0,0,0,0,0
Hudson's Furniture,10843,0,0,0,0,0,0,0
Hyland's Inc.,10832,1,0,0,1,1,0,0
"The Saul Zaentz Company, dba Middle-earth Enterprises",10369,0,0,2,2,0,0,1
Caregiverlist,10048,0,0,0,0,0,0,0
"CommonKindness, Inc.",10741,0,0,0,0,0,0,0
Robbins Bros,9611,0,0,0,0,0,0,0
West Edmonton Mall Property Inc.,9554,0,0,0,0,0,0,0
Springfield Armory,9614,0,0,1,1,0,0,1
STAR INDIA PVT. LTD.,10845,0,0,0,0,0,0,0
Cambridge Savings Bank,10674,0,0,0,0,0,0,0
"DentaQuest, LLC",10387,0,0,0,0,0,0,0
Burlington Coat Factory,9977,1,0,2,3,0.333333333,0,0.666666667
Mazopiya,10874,0,0,0,0,0,0,0
Novamex,11244,0,0,0,0,0,0,0
Infinisource,10045,0,0,0,0,0,0,0
Guidance Residential,9975,0,0,0,0,0,0,0
"Kenneth S. Nugent, P.C.",9989,0,0,0,0,0,0,0
Ciao GmbH,10059,0,0,0,0,0,0,0
Prince Resorts Hawaii,9970,4,0,0,4,1,0,0
Penny Stock Wizard,9619,0,0,0,0,0,0,0
Crushcalculatorapp.com,9612,0,0,0,0,0,0,0
"Pinnacle Ridge Holdings, LLC.",10384,0,0,0,0,0,0,0
Nashville Predators,10639,0,0,0,0,0,0,0
myactoslawyer.com,9622,0,0,0,0,0,0,0
Northwest Trek Wildlife Park,9624,0,0,0,0,0,0,0
Seattle University,10974,0,0,0,0,0,0,0
House of Music,10860,0,0,0,0,0,0,0
OkeanosHotels.co.il,10657,0,0,0,0,0,0,0
Tee Bar Corp,9993,0,0,0,0,0,0,0
"Clean Power Finance, Inc.",11171,0,0,0,0,0,0,0
Paramount New Homes,10646,0,0,0,0,0,0,0
Bel Inc,9973,0,0,0,0,0,0,0
The Puyallup Fair,10211,0,0,0,0,0,0,0
VerticalScope Inc.,10839,0,0,0,0,0,0,0
"Kindred Healthcare, Inc.",10665,0,0,0,0,0,0,0
Manuel Auto Group,10370,0,0,0,0,0,0,0
"Upromise, Inc.",10648,10,3,0,13,0.769230769,0.230769231,0
ThuleCargo.com,10659,0,0,0,0,0,0,0
sneakpeeq.com,11172,0,0,0,0,0,0,0
Minetta Lane Theatre,10902,0,0,0,0,0,0,0
Darlington Raceway,10656,0,0,0,0,0,0,0
Quattro,11176,0,0,0,0,0,0,0
Modus Man,10862,0,0,0,0,0,0,0
Global Broadcast News Ltd,9555,0,0,0,0,0,0,0
Ohio Mulch,10864,0,0,0,0,0,0,0
Lakeside-Milam Recovery Centers Inc.,10054,0,0,0,0,0,0,0
StamChocolate.com,11331,0,0,0,0,0,0,0
Kuoni Travel,10232,0,0,0,0,0,0,0
Knology Inc.,10838,0,0,0,0,0,0,0
Neowiz Games,10225,0,0,0,0,0,0,0
"Living Essentials, LLC",10855,0,0,0,0,0,0,0
JobAlertsUSA.com,11236,0,0,0,0,0,0,0
Diesel,10670,0,0,1,1,0,0,1
Clean Air NY,10222,0,0,0,0,0,0,0
Timberland Bank,10398,0,0,0,0,0,0,0
Il Fornaio,9617,0,0,0,0,0,0,0
THECOVEATLANTIS.COM,9626,0,0,0,0,0,0,0
MusicSkins,9610,0,0,0,0,0,0,0
Barrett's Technology Solutions,10055,0,0,0,0,0,0,0
"The Irvine Company, LLC",10653,11,0,1,12,0.916666667,0,0.083333333
Manor College,10643,0,0,0,0,0,0,0
Doe Run Furniture,10047,0,0,0,0,0,0,0
Air-Purifiers-America.com,10655,0,0,0,0,0,0,0
Santander UK plc,10234,0,0,0,0,0,0,0
National Association of Manufacturers,10221,0,0,0,0,0,0,0
aestages.org,10662,0,0,0,0,0,0,0
LiveCareer Ltd,10058,4,0,1,5,0.8,0,0.2
WriterAccess.com,10866,0,0,0,0,0,0,0
The Patriot-News Co.,9618,0,0,0,0,0,0,0
No on 29,10224,0,0,0,0,0,0,0
OnNet USA Inc.,10875,0,0,0,0,0,0,0
ADVFN PLC,10382,0,0,0,0,0,0,0
Forshaw,11344,0,0,0,0,0,0,0
Awards Network,11164,0,0,0,0,0,0,0
"NeoStrata Company, Inc.",10661,0,0,0,0,0,0,0
Sartorius AG,10212,0,0,0,0,0,0,0
"Planned Parenthood Action Fund, Inc.",10685,0,0,0,0,0,0,0
Airtel India,11092,0,0,0,0,0,0,0
"Monster, LLC.",10933,4,0,3,7,0.571428571,0,0.428571429
The Training Network,9987,0,0,0,0,0,0,0
Planet Data Solutions Inc.,10215,0,0,0,0,0,0,0
Humana Inc.,9965,4,1,3,8,0.5,0.125,0.375
Chicago Auto Trade Association,9980,0,0,0,0,0,0,0
ehc.com,9981,0,0,0,0,0,0,0
Bam Bam Martial Arts & Fightin Strong Video,9966,0,0,0,0,0,0,0
Elmira Stove Works,10405,0,0,0,0,0,0,0
"Naples, Marco Island, Everglades Convention & Visitors Bureau",11169,0,0,0,0,0,0,0
"Niche.com, Inc.",11308,0,0,0,0,0,0,0
Like Crazy Movie,8556,0,0,0,0,0,0,0
Farfetch.com Limited,10975,0,0,0,0,0,0,0
OANDA Corporation,8558,0,1,2,3,0,0.333333333,0.666666667
UKTV,10231,0,0,0,0,0,0,0
Defend My Dividend,10239,0,0,0,0,0,0,0
Everest Nutrition Corp.,10880,0,0,0,0,0,0,0
"Fossil Oil Company, LLC.",10921,0,0,0,0,0,0,0
Mediacom Communications Corporation,11093,0,0,0,0,0,0,0
The Art of Acting Studio,9972,0,0,0,0,0,0,0
"MSD Consumer Care, Inc.",10981,0,0,2,2,0,0,1
Private Equity Growth Capital Council,10223,0,0,0,0,0,0,0
Harveys Furniture,10226,0,0,0,0,0,0,0
Bath Fitter,10900,0,0,0,0,0,0,0
NATPE,9971,0,0,0,0,0,0,0
Dana Goldberg MD,10898,0,0,0,0,0,0,0
Highland Garden,10896,0,0,0,0,0,0,0
Dunk & Bright,10878,0,0,0,0,0,0,0
Bonnie Plants,10397,0,0,0,0,0,0,0
Tungstenworld.com,10847,0,0,0,0,0,0,0
Roccat Studios,10988,0,0,0,0,0,0,0
FOREX BULLDOG,11365,0,0,0,0,0,0,0
"Miami New Times, LLC",10982,0,0,1,1,0,0,1
Ted Cruz for Senate,11091,0,0,0,0,0,0,0
Massachusetts Mutual Life Insurance Company,10389,0,0,0,0,0,0,0
Exe Games Inc.,10973,0,0,0,0,0,0,0
"Protect America, Inc.",10406,0,0,0,0,0,0,0
Cornell Lab of Ornithology,10399,0,0,1,1,0,0,1
Austin Peay State University,10851,0,0,0,0,0,0,0
42nd Street Moon,10647,0,0,0,0,0,0,0
Potomac Homes,10977,0,0,0,0,0,0,0
Turn-Page,10888,0,0,0,0,0,0,0
Americans For Job Security,10237,0,0,0,0,0,0,0
Professional Surveys Inc.,9994,0,0,0,0,0,0,0
Fox's Gem Shop,10909,0,0,0,0,0,0,0
Santa Barbara Contemporary Arts Forum,10853,0,0,0,0,0,0,0
My Way Movie,10383,0,0,0,0,0,0,0
Southwest Gas,8559,0,0,0,0,0,0,0
United Business Media LLC,10217,0,0,0,0,0,0,0
Psych Central,10879,0,0,0,0,0,0,0
TasksEveryDay,10228,0,0,0,0,0,0,0
"KBR, Inc.",10979,0,0,0,0,0,0,0
ERIE DRIVE,11173,0,0,0,0,0,0,0
Innotas,10854,0,0,0,0,0,0,0
"KITN Media USA, Inc.",9615,3,0,0,3,1,0,0
Middlesex Savings Bank,10865,0,0,0,0,0,0,0
Santa Rosa Gardens,10883,0,0,0,0,0,0,0
Low Book Sales & Leasing Inc,10658,0,0,0,0,0,0,0
Connecticut Department of Transportation,10734,0,0,0,0,0,0,0
Breakthrough Learning Institute,10972,0,0,0,0,0,0,0
Evangelical Homes of Michigan,9985,1,0,0,1,1,0,0
Sunbeam Products,9621,0,0,0,0,0,0,0
New York Institute of Technology,11096,0,0,0,0,0,0,0
The Zondervan Corporation LLC,10992,0,0,0,0,0,0,0
The Ohio State University Wexner Medical Center,11165,1,0,0,1,1,0,0
gi-israel.info,11238,0,0,0,0,0,0,0
Americans for Herman Cain,10400,0,0,0,0,0,0,0
DailyConsumerAlerts.com,10991,0,0,0,0,0,0,0
Mountain Creek,10891,0,0,0,0,0,0,0
Michigan Live LLC.,10671,0,0,1,1,0,0,1
Krasnow Enterprises,10739,0,0,0,0,0,0,0
Laureate Online Education,11163,0,0,0,0,0,0,0
Hunter Mountain,11174,0,0,0,0,0,0,0
Online Capital Markets Ltd,10920,0,0,1,1,0,0,1
Children's of Alabama,10682,0,0,0,0,0,0,0
Informatica Corporation,10673,1,0,0,1,1,0,0
"Insight Pharmaceuticals, LLC.",10663,0,0,0,0,0,0,0
"Craftmaster Homes, Inc.",11309,0,0,0,0,0,0,0
Quadra-Fire,10907,0,0,0,0,0,0,0
SKINS International Trading AG,10858,0,0,0,0,0,0,0
The CV Centre Limited,11240,0,0,0,0,0,0,0
Cinghiale,10683,0,0,0,0,0,0,0
Parade Publications,10983,2,0,0,2,1,0,0
Bellingrath Gardens and Home,11094,0,0,0,0,0,0,0
"Fanatics, Inc.",10868,21,8,2,31,0.677419355,0.258064516,0.064516129
"American Century Investment Services, Inc.",10882,0,0,0,0,0,0,0
American College of Radiology,10220,0,0,0,0,0,0,0
Raymour & Flanigan Furniture,10910,0,0,9,9,0,0,1
Toronto Chapter of the American Marketing Assoc.,11177,0,0,0,0,0,0,0
Castor & Pollux Natural Petworks,11392,0,0,0,0,0,0,0
Fresh Produce Sportswear,10677,0,0,0,0,0,0,0
"BOB Trailers, Inc",11305,0,0,0,0,0,0,0
vax9.com,11355,0,0,0,0,0,0,0
Diageo Chateau & Estate Wines Company,11243,0,0,0,0,0,0,0
Mission Impossible Ghost Protocol Movie,10403,0,0,0,0,0,0,0
Marks and Spencer plc,11316,8,13,0,21,0.380952381,0.619047619,0
My Love Group Corporation,10214,0,0,0,0,0,0,0
Fantastic Sams,11167,0,0,0,0,0,0,0
Mallfinder Network,11242,0,0,0,0,0,0,0
Raytheon Company,11306,0,0,0,0,0,0,0
Martin LLC.,10881,0,0,0,0,0,0,0
FooPets.com,10679,0,0,0,0,0,0,0
"TPI Holdings, Inc.",10914,0,0,0,0,0,0,0
Wireless Catalog,10676,0,0,0,0,0,0,0
Reborn Cabinets Inc.,10927,0,0,0,0,0,0,0
IE Business School,11179,0,0,0,0,0,0,0
Avigilon Corporation,10743,0,0,0,0,0,0,0
"Mattel, Inc.",10877,5,0,5,10,0.5,0,0.5
Dream2Travel,10908,0,0,0,0,0,0,0
"Copper Mountain, Inc.",8561,0,0,1,1,0,0,1
Gym Source,11301,0,0,0,0,0,0,0
Anywhere Speakers Limited,11245,0,0,0,0,0,0,0
"USADATA, Inc.",10668,0,0,0,0,0,0,0
Geology.com,10940,0,0,0,0,0,0,0
"Telltale, Inc.",10990,0,0,0,0,0,0,0
Passages Malibu,11359,0,0,0,0,0,0,0
Selftrade,10230,0,0,0,0,0,0,0
"NutriBullet, LLC.",11310,34,5,0,39,0.871794872,0.128205128,0
"SignMeUp, Inc.",10929,0,0,0,0,0,0,0
Momslovetrollbeads.com,11381,0,0,0,0,0,0,0
"Registration Systems, Inc.",11089,0,0,0,0,0,0,0
Baton Rouge Area Convention & Visitors Bureau,10401,0,0,0,0,0,0,0
Susan Cain,11311,1,0,0,1,1,0,0
Energy Citizens,10219,0,0,0,0,0,0,0
"Nelson Media, Inc.",10985,0,0,0,0,0,0,0
"ViX SWIMWEAR, INC.",10942,0,0,0,0,0,0,0
GableGotwals,10892,0,0,0,0,0,0,0
"Viumbe, LLC",10681,0,0,1,1,0,0,1
Stanford School of Medicine,10905,0,0,0,0,0,0,0
Precept Ministries International,10943,0,0,0,0,0,0,0
"Global Alphabet, Inc.",11333,0,0,0,0,0,0,0
New Jersey Wines,11345,0,0,0,0,0,0,0
Abraham Lincoln Presidential Museum,10870,0,0,0,0,0,0,0
"Quickpro Gear, LLC",11300,0,0,0,0,0,0,0
"PGA Tour, Inc.",10885,1,0,0,1,1,0,0
St. Rose Dominican Hospitals,11088,0,0,0,0,0,0,0
The Old Globe,10911,0,0,0,0,0,0,0
Richline Group,11393,0,0,0,0,0,0,0
The Dallas Opera,10052,0,0,0,0,0,0,0
Museum of Latin American Art,10901,0,0,0,0,0,0,0
"Hicks Paving, LLC.",10922,0,0,0,0,0,0,0
ssense.com,10675,1,0,0,1,1,0,0
New York Writes Itself (NYWI),11241,0,0,0,0,0,0,0
Veterans United Home Loans,10233,35,2,3,40,0.875,0.05,0.075
The Orvis Company Inc.,11335,14,12,0,26,0.538461538,0.461538462,0
Edgewood Properties,10913,0,0,0,0,0,0,0
Marathon Oil,11327,0,0,0,0,0,0,0
Info Edge (India) Ltd.,11385,0,0,0,0,0,0,0
Paul Masse Auto,11351,0,0,0,0,0,0,0
Ryobi Limited,11379,0,0,0,0,0,0,0
DeCare Dental,11340,0,0,0,0,0,0,0
Kalmbach Publishing Co.,10886,1,1,0,2,0.5,0.5,0
HappyBirthdayToYou.com,11329,0,0,0,0,0,0,0
Western Health Advantage,11328,0,0,0,0,0,0,0
City Furniture,11332,0,0,0,0,0,0,0
SunStream Hotels & Resorts,10871,1,0,0,1,1,0,0
Weber-Stephen Products LLC,11313,0,0,0,0,0,0,0
Metromix LLC,10889,0,0,0,0,0,0,0
"IGC, Inc.",11373,0,0,0,0,0,0,0
United States Department of Agriculture,11343,0,0,0,0,0,0,0
ONE Industries,11360,0,0,0,0,0,0,0
scienceofimitationmilk.com,11367,0,0,0,0,0,0,0
The Richard Stockton College of New Jersey,10984,0,0,0,0,0,0,0
Potratz Automotive Advertising,10890,0,0,0,0,0,0,0
Rounder Records,10939,0,0,0,0,0,0,0
The Cash Store,11362,0,0,0,0,0,0,0
ChristianSteven Software,10925,0,0,0,0,0,0,0
Lloyd Center Ice Rink,11235,0,0,0,0,0,0,0
PostcardMania,10680,0,0,0,0,0,0,0
"Dow Jones & Company, Inc.",11239,7,0,0,7,1,0,0
Investopedia ULC.,11364,1,0,0,1,1,0,0
Granite Transformations,11394,0,0,0,0,0,0,0
Seattle Chocolates,11357,0,0,0,0,0,0,0
The Away Network,10915,0,0,0,0,0,0,0
"PlayCore, Inc.",10916,0,0,0,0,0,0,0
resonate,10236,0,0,0,0,0,0,0
Fashion-DesignSchools.com,11361,0,0,0,0,0,0,0
"Mark Group, Inc.",10923,0,0,0,0,0,0,0
Golf Smart Solutions Inc.,11303,0,0,0,0,0,0,0
Brazilian Body Now,11377,0,0,0,0,0,0,0
"NYCE Payments Network, LLC",10932,0,0,0,0,0,0,0
Fundraising Innovations Ltd,11330,0,0,0,0,0,0,0
Phix,11317,0,0,0,0,0,0,0
Stanley Gibbons Ltd.,11389,0,0,0,0,0,0,0
Wellness Concepts LLC.,10917,0,0,0,0,0,0,0
RI-CAN,11324,0,0,0,0,0,0,0
Southern Community Bank,11363,0,0,0,0,0,0,0
Top Hoops,11336,0,0,0,0,0,0,0
Present Millionaire Society,11318,0,0,0,0,0,0,0
City of Shaker Heights,11347,0,0,1,1,0,0,1
"Hy-Vee, Inc.",11349,0,0,0,0,0,0,0
"Camping World, Inc.",11391,0,0,0,0,0,0,0
HISTORIC GRANBURY MERCHANTS ASSOCIATION,10918,0,0,0,0,0,0,0
Stanton Optical,11325,0,0,0,0,0,0,0
"W.W. Grainger, Inc.",10941,69,36,1,106,0.650943396,0.339622642,0.009433962
CarolinaTix,10935,0,0,0,0,0,0,0
"Froday Interactive, LLC",10930,0,0,0,0,0,0,0
Arizona Department of Economic Security,11372,0,0,0,0,0,0,0
Freedom Mortgage Corporation,11382,0,0,0,0,0,0,0
PIER 39,11339,0,0,0,0,0,0,0
"Experius, LLC.",11350,0,0,0,0,0,0,0
The Pioneer Woman,11353,0,0,0,0,0,0,0
River Island,11348,0,0,0,0,0,0,0
Connecticut Network,11368,0,0,0,0,0,0,0
ShopPlasticland.com,10987,0,0,0,0,0,0,0
National Academy of Sports Medicine,11375,3,1,0,4,0.75,0.25,0
KHN Solutions Inc.,10884,0,0,0,0,0,0,0
Statoil,11354,5,0,5,10,0.5,0,0.5
Qlipso Media Networks Ltd.,10934,0,0,0,0,0,0,0
Donnerwood Media,11384,0,0,0,0,0,0,0
"SouthWest Bullion, Inc.",10887,0,0,0,0,0,0,0
Stamps.com Inc.,10652,10,0,1,11,0.909090909,0,0.090909091
Northeast Utilities,11371,0,0,0,0,0,0,0
"Zaxbys Franchising, Inc.",11323,1,0,0,1,1,0,0
"All Web Leads, Inc.",10684,0,0,0,0,0,0,0
SYNNEX Corporation,10216,0,0,0,0,0,0,0
Chase-Park Plaza Cinemas,8562,0,0,0,0,0,0,0
"TastingRoom.com, Inc.",11334,0,0,0,0,0,0,0
Black Oak Casino,11237,0,0,0,0,0,0,0
Winmark Corporation,10688,1,0,0,1,1,0,0
Montrose Travel,11366,0,0,0,0,0,0,0
World Airline Entertainment Association,11302,0,0,0,0,0,0,0
Terrapinn Holdings Ltd.,10937,1,0,0,1,1,0,0
Andrew Marc E-Commerce,10687,0,0,0,0,0,0,0
Mindjet,11320,0,0,0,0,0,0,0
Boar's Head Brand,11352,0,0,0,0,0,0,0
Carrier Corporation,11370,0,0,0,0,0,0,0
Eowyn Ivey,10924,0,0,0,0,0,0,0
Micro Motion Inc.,10938,0,0,0,0,0,0,0
Design Science,11341,1,0,0,1,1,0,0
Lyme Academy College of Fine Arts,11315,0,0,0,0,0,0,0
The Greenbrier,11319,0,0,0,0,0,0,0
"Lingo, Inc.",11358,0,0,0,0,0,0,0
University of Maine,11337,0,0,0,0,0,0,0
Guinness & Co,9706,0,0,3,3,0,0,1
Pure Yoga,9523,2,0,0,2,1,0,0
Garrett County Chamber of Commerce,11453,0,0,0,0,0,0,0
Procter & Gamble,11454,63,9,85,157,0.401273885,0.057324841,0.541401274
Waters Edge,11456,0,0,0,0,0,0,0
1-800LoanMart,11455,0,0,3,3,0,0,1
"SC Johnson & Son, Inc",11457,13,1,2,16,0.8125,0.0625,0.125
Stem Cell Face Lift,11462,0,0,0,0,0,0,0
Wheels,11452,0,0,0,0,0,0,0
"Invisible Fence, Inc.",11458,0,0,0,0,0,0,0
Air America Air Conditioning,11464,0,0,0,0,0,0,0
Gala Coral Group Limited,11459,0,0,0,0,0,0,0
"LifeLink Foundation, Inc.",11463,0,0,0,0,0,0,0
"Johns Manville, Inc.",3208,0,0,0,0,0,0,0
Volaris,9708,0,0,0,0,0,0,0
Seattle Theatre Group,3213,1,0,0,1,1,0,0
Devil's Playground Movie,3207,0,0,0,0,0,0,0
SRI SPORTS LIMITED,11471,0,0,0,0,0,0,0
"Giant Food Stores, LLC.",11468,0,0,0,0,0,0,0
"Omega Events, Inc.",11469,0,0,0,0,0,0,0
"Franklin Templeton Distributors, Inc.",3214,0,0,4,4,0,0,1
Securranty,3212,0,0,0,0,0,0,0
Trident University International,3206,8,1,3,12,0.666666667,0.083333333,0.25
Salisbury Post,11470,0,0,0,0,0,0,0
HMV UK Limited,11465,0,0,0,0,0,0,0
Life Line Screening of America,11473,0,3,0,3,0,1,0
"Mouser Electronics, Inc.",11467,1,0,0,1,1,0,0
EGYPTAIR,11474,0,0,0,0,0,0,0
Pacific Finance Group LLC,11475,0,0,0,0,0,0,0
Regis Corporation,3211,2,0,1,3,0.666666667,0,0.333333333
"UStream, Inc.",3219,0,0,1,1,0,0,1
Vitacost.com,3220,10,13,0,23,0.434782609,0.565217391,0
SPD Swiss Precision Diagnostic,3215,0,0,3,3,0,0,1
Sony Computer Entertainment,11472,44,18,30,92,0.47826087,0.195652174,0.326086957
The Container Store Inc.,3222,0,0,0,0,0,0,0
Iowa Speedway,11250,0,0,0,0,0,0,0
"Livescribe, Inc.",3216,1,6,1,8,0.125,0.75,0.125
"Public Bikes, Inc.",11477,0,0,0,0,0,0,0
Federal Trade Commission,9874,1,0,10,11,0.090909091,0,0.909090909
"The Wharton School, University of Pennsylvania",3218,0,0,0,0,0,0,0
Theater Wit,11247,0,0,0,0,0,0,0
Sesame Workshop,11251,0,0,0,0,0,0,0
Megaplayerupdate.com,3225,0,0,0,0,0,0,0
CatholicMatch,3224,0,0,1,1,0,0,1
The Open University,11476,0,0,0,0,0,0,0
Capitol Federal Savings Bank,11252,0,0,0,0,0,0,0
Whirlpool,3226,65,21,7,93,0.698924731,0.225806452,0.075268817
Harkins Administrative Services,3228,0,0,0,0,0,0,0
Texas Mutual Insurance Company,11257,0,0,0,0,0,0,0
North American Fishing Club,1943,0,0,0,0,0,0,0
Nintendo,1941,18,1,12,31,0.580645161,0.032258065,0.387096774
Page Law,11264,0,0,0,0,0,0,0
DirectoryCentral.com,11248,0,0,0,0,0,0,0
Regent Education Inc.,3237,0,0,0,0,0,0,0
Vertical Communications,1937,0,0,0,0,0,0,0
"Parkinson's Disease Foundation, Inc.",11275,0,0,0,0,0,0,0
"Citigroup, Inc.",3232,70,12,18,100,0.7,0.12,0.18
"Children's Network, LLC",3227,0,0,2,2,0,0,1
"Reliant Energy Retail Holdings, LLC.",1947,0,0,0,0,0,0,0
The Eagle Movie,3223,0,0,0,0,0,0,0
Bloomfield Hills Schools,11274,0,0,0,0,0,0,0
Lonely Place for Dying Movie,1955,0,0,0,0,0,0,0
Cooking Club of America,1942,0,0,0,0,0,0,0
"The Professional Basketball Club, LLC",11266,0,0,0,0,0,0,0
"Resort Rental, LLC.",11273,0,0,0,0,0,0,0
Glad Products Company,1940,16,1,9,26,0.615384615,0.038461538,0.346153846
Royal Mail Group Ltd,11278,0,0,0,0,0,0,0
Riverbed Technologies,11261,0,0,0,0,0,0,0
Wisteria,11466,0,0,0,0,0,0,0
Morgan Gold,1945,0,0,0,0,0,0,0
Peak Life,1936,0,0,1,1,0,0,1
"Smart & Final, Inc.",11269,0,0,0,0,0,0,0
"First Watch Restaurants, Inc.",11254,0,0,0,0,0,0,0
Harley Davidson,1949,7,4,6,17,0.411764706,0.235294118,0.352941176
Framingham Municipal FCU,11255,0,0,0,0,0,0,0
StandUp2Cancer,1939,0,0,0,0,0,0,0
Williams and Williams,1946,0,0,0,0,0,0,0
Mayo Foundation for Medical Education and Research,3229,1,0,9,10,0.1,0,0.9
Fresno Water Division,1938,0,0,0,0,0,0,0
Aljazeera Network,11271,1,0,1,2,0.5,0,0.5
teaching-colleges.net,11272,0,0,0,0,0,0,0
Patten University,11277,0,0,0,0,0,0,0
Trinity Health,11265,0,0,0,0,0,0,0
RAID Incorporated,11263,0,0,0,0,0,0,0
"Education.com, Inc.",3210,0,0,0,0,0,0,0
Miller Motorsports Park,11258,0,0,0,0,0,0,0
PacketVideo Corporation,11256,0,0,0,0,0,0,0
Partners HealthCare,11279,0,0,0,0,0,0,0
Mountain America Credit Union,11267,0,0,0,0,0,0,0
"Bill Me Later, Inc.",11529,0,0,0,0,0,0,0
Club for Growth,11268,0,0,0,0,0,0,0
Emory University,3234,1,0,0,1,1,0,0
virtuwell,11262,0,0,0,0,0,0,0
TireBuyer.com,1950,2,0,0,2,1,0,0
Tshirtgang.com,11527,0,0,0,0,0,0,0
Allegiant Travel Company,11259,0,0,0,0,0,0,0
National Geographic Games,11528,6,0,0,6,1,0,0
Revlon,1953,8,2,12,22,0.363636364,0.090909091,0.545454545
School of International and Public Affairs,11530,0,0,0,0,0,0,0
Liberty Mutual Insurance Company,3230,33,10,4,47,0.70212766,0.212765957,0.085106383
MySpace,1944,1,0,0,1,1,0,0
Pasco Regional Medical Center,11260,0,0,0,0,0,0,0
Tampa Bay Buccaneers,3236,0,0,0,0,0,0,0
"LogMeIn, Inc.",3238,34,0,6,40,0.85,0,0.15
citycenterofcitynorth.com,11526,0,0,0,0,0,0,0
Toy State Industrial,9472,1,0,2,3,0.333333333,0,0.666666667
"The Bid Spot, LLC",11182,0,0,0,0,0,0,0
ECHO INCORPORATED,11181,0,0,0,0,0,0,0
NHL Enterprises,11183,1,0,1,2,0.5,0,0.5
Auto Alliance,11184,0,0,0,0,0,0,0
"Global IntelliSystems, LLC",9272,0,0,0,0,0,0,0
Ultralase,10307,0,0,0,0,0,0,0
Circle Furniture,10301,1,0,0,1,1,0,0
GamesGiant.net,10302,0,0,0,0,0,0,0
Boyd Gaming Corporation,10292,1,0,1,2,0.5,0,0.5
gocompare.com,10315,0,0,0,0,0,0,0
The Kelley School of Business,10299,9,0,2,11,0.818181818,0,0.181818182
CooperVision,10308,0,0,0,0,0,0,0
British Gas,10318,0,0,0,0,0,0,0
Fletcher Jones Motorcars,11189,0,0,0,0,0,0,0
Ashford Designer Outlet,10320,0,0,0,0,0,0,0
"Kumho Tire U.S.A., Inc.",10295,0,0,0,0,0,0,0
"Inadco, Inc.",11194,0,0,0,0,0,0,0
Triodos Bank,10311,0,0,0,0,0,0,0
"Dreyer's Grand Ice Cream, Inc.",10304,0,0,0,0,0,0,0
ROOF on theWit,10293,0,0,0,0,0,0,0
Aspiranet.org,11185,0,0,0,0,0,0,0
Court Appointed Special Advocates of Los Angeles,10310,7,1,0,8,0.875,0.125,0
steveberry.org,10303,0,0,0,0,0,0,0
Sliderobes,10317,0,0,0,0,0,0,0
QTS Research Ltd.,11188,0,0,0,0,0,0,0
TalkTalk,10319,0,0,0,0,0,0,0
Condusiv Technologies Corporation,11190,0,0,0,0,0,0,0
National Health Service,10313,0,0,0,0,0,0,0
StocksDigest,10324,0,0,0,0,0,0,0
Centrica Plc,11192,6,2,0,8,0.75,0.25,0
TV Licensing,10322,0,0,0,0,0,0,0
Donatos,11191,2,0,0,2,1,0,0
1bog.org,11193,0,0,0,0,0,0,0
SoftCom Inc.,10296,0,0,0,0,0,0,0
University of California San Francisco Medical Center,10297,0,0,0,0,0,0,0
Americas Road & Travel Club,10309,0,0,0,0,0,0,0
"Nuttall,Brown, & Coutts.",10326,0,0,0,0,0,0,0
Nancy Batchelor,10294,0,0,0,0,0,0,0
Virtua,10298,0,0,0,0,0,0,0
Ecotech Institute Environmental Training,10305,0,0,0,0,0,0,0
Shangri-La International Hotel Management,10323,0,0,0,0,0,0,0
"SandRidge Energy, Inc.",9391,0,0,0,0,0,0,0
Mr. Skin,2171,0,0,0,0,0,0,0
Chasing Fireflies,11281,0,0,0,0,0,0,0
"OppenheimerFunds, Inc.",2471,3,0,3,6,0.5,0,0.5
CreditCards.com,10410,0,0,0,0,0,0,0
The Little Tikes Company,10763,0,0,0,0,0,0,0
AXA Sun Life Direct,11290,0,0,0,0,0,0,0
Go Mohu,10764,0,0,0,0,0,0,0
Pikolinos.com,10765,0,0,0,0,0,0,0
The Magnolia Hotel & Spa,11292,0,0,0,0,0,0,0
Rising Media,10010,0,0,0,0,0,0,0
"ShopIgniter, Inc.",10246,0,0,0,0,0,0,0
Smart Car,2271,1,0,6,7,0.142857143,0,0.857142857
MichaelSavage.com,11286,0,0,0,0,0,0,0
Socialworkerschools.net,10247,1,1,0,2,0.5,0.5,0
"Media Two, Inc.",11293,0,0,0,0,0,0,0
"Biomet, Inc.",10772,0,0,0,0,0,0,0
Underworld Awakening Movie,4109,0,0,0,0,0,0,0
"ExactTarget, Inc.",10747,0,0,0,0,0,0,0
"American Airlines, Inc.",11289,13,0,8,21,0.619047619,0,0.380952381
Vermont Law School,9725,1,0,0,1,1,0,0
Ventura County Lodging Association,10768,6,0,1,7,0.857142857,0,0.142857143
Fresh & Easy Neighborhood Market Inc.,9876,0,0,0,0,0,0,0
Philharmonia Baroque,10771,0,0,0,0,0,0,0
The Grain Foods Foundation,10444,0,0,0,0,0,0,0
WTAE-TV,10249,0,0,0,0,0,0,0
CEIBS,8523,0,0,0,0,0,0,0
Canadian Living,10253,1,0,0,1,1,0,0
Condor Flugdienst GmbH,10142,0,0,0,0,0,0,0
Centennial Fine Wine and Spirits.,9557,0,0,0,0,0,0,0
Penn Medicine,10261,0,0,0,0,0,0,0
Matinée Group,10342,0,0,0,0,0,0,0
"Death and Taxes Media, LLC",10025,0,0,0,0,0,0,0
German National Tourist Board,10276,0,0,0,0,0,0,0
Healthy Beverage,10159,0,0,0,0,0,0,0
Premsig.com,9291,0,0,0,0,0,0,0
"Gravity Interactive, Inc.",9891,0,0,0,0,0,0,0
"Central Computer Systems, Inc",10042,0,0,0,0,0,0,0
"Autodesk, Inc.",9925,3,0,0,3,1,0,0
"O.M.G., Inc.",9574,0,0,0,0,0,0,0
University of Florida Proton Therapy Institute,10161,0,0,0,0,0,0,0
MASN,11294,0,0,0,0,0,0,0
FieldOne Systems,9940,0,0,0,0,0,0,0
GotTalentNow,10627,0,0,0,0,0,0,0
Lydecker & CO.,11296,0,0,0,0,0,0,0
Canada Post Corporation,10359,3,0,0,3,1,0,0
ForSaleByOwner.com,10258,1,0,0,1,1,0,0
"See More Travel, Inc.",10829,0,0,0,0,0,0,0
MeUndies.com,10796,0,0,0,0,0,0,0
"National Electronics Warranty, LLC",11282,0,0,0,0,0,0,0
"SeatAdvisor, Inc.",11615,0,0,0,0,0,0,0
1 Rector Park,10775,0,0,0,0,0,0,0
"Snail Games USA, Inc.",11106,0,0,0,0,0,0,0
TVRepairMan.com,10750,1,0,0,1,1,0,0
British Broadcasting Corporation,10994,0,0,0,0,0,0,0
What to Expect When You're Expecting Movie,10780,0,0,0,0,0,0,0
Charles Duhigg,10782,0,0,0,0,0,0,0
CatalpaNYC.com,11295,0,0,0,0,0,0,0
Bertuccis Corporation,10252,2,0,1,3,0.666666667,0,0.333333333
Bearskin Lodge,11603,0,0,0,0,0,0,0
Bellevue Rare Coins,10785,0,0,0,0,0,0,0
Jimmy Jacobs Custom Homes,11678,0,0,0,0,0,0,0
Prattstore,10774,0,0,0,0,0,0,0
"Nuesoft Technologies, Inc.",11411,0,0,0,0,0,0,0
Park University,10753,0,0,0,0,0,0,0
Corpus Christi CVB,11600,0,0,0,0,0,0,0
The Road Movie,11099,0,0,0,0,0,0,0
"Greater Boston Radio, Inc.",11604,0,0,0,0,0,0,0
Xperteaseny.com,11105,0,0,0,0,0,0,0
Alibaba.com,11100,10,1,0,11,0.909090909,0.090909091,0
Allegheny Conference,10755,0,0,0,0,0,0,0
Stage Door Theatre Co.,10804,0,0,0,0,0,0,0
Washington Court Hotel,10776,0,0,0,0,0,0,0
Los Angeles Modern Auctions,11104,0,0,0,0,0,0,0
Wikipedia.org,11121,0,0,0,0,0,0,0
"Consumers Union of U.S., Inc.",11601,1,2,2,5,0.2,0.4,0.4
EL AL LTD.,11297,0,0,0,0,0,0,0
JD's Fish n' Grill,11704,0,0,0,0,0,0,0
Tustin Auto Center,11692,0,0,0,0,0,0,0
extrimdownloadmanager.com,11400,0,0,0,0,0,0,0
Funmoods,10806,0,0,0,0,0,0,0
Red Frog Events,10803,0,0,0,0,0,0,0
"Stanley Black & Decker, Inc.",11674,1,0,2,3,0.333333333,0,0.666666667
"Beauty.com, inc.",11614,0,0,0,0,0,0,0
"TV Fan Online, Inc.",11628,0,0,0,0,0,0,0
SMSC Gaming Enterprise,11124,0,0,0,0,0,0,0
"Schrader & Robertson Commercial Auctioneers, LLC",11098,0,0,0,0,0,0,0
"BPS Direct, L.L.C.",11112,12,11,0,23,0.52173913,0.47826087,0
"Lexar Media, Inc.",11403,0,0,0,0,0,0,0
AutoGlassSearch.com,11011,0,0,0,0,0,0,0
"The Charles Machine Works, Inc.",11013,0,0,0,0,0,0,0
Platinum League,11196,0,0,0,0,0,0,0
Aapka Colors,11713,0,0,0,0,0,0,0
Valley Christian Schools,11602,0,0,0,0,0,0,0
"Centerfield Baseball & Softball Academy, Inc.",11607,0,0,0,0,0,0,0
Alyeska Resort,11771,0,0,0,0,0,0,0
Coldwell Banker Residential Brokerage,10807,0,0,0,0,0,0,0
"Qqest Software Systems, Inc.",11107,0,0,0,0,0,0,0
"GetListed.org, Inc.",11654,0,0,0,0,0,0,0
freedownloaders.net,11408,0,0,0,0,0,0,0
CityLips,11402,0,0,0,0,0,0,0
"TakePart, LLC",11015,0,0,0,0,0,0,0
Oregon Lottery,10778,0,0,0,0,0,0,0
LOOP LLC.,11682,0,0,0,0,0,0,0
Woodland Motors,11410,0,0,0,0,0,0,0
Geberit AG,10793,0,0,0,0,0,0,0
"New Jersey Cafes, Inc.",11109,0,0,0,0,0,0,0
Beth Israel Deaconess Medical Center,11754,0,0,0,0,0,0,0
Advantis Credit Union,11625,0,0,0,0,0,0,0
BankUnited,11114,0,0,0,0,0,0,0
The Atlanta Journal-Constitution,11135,0,0,0,0,0,0,0
Stride Rite Children's Group LLC,10816,0,0,0,0,0,0,0
Pinnacle Medical,11147,0,0,0,0,0,0,0
Piercey Automotive Group,10814,0,0,0,0,0,0,0
Malvern Federal Savings Bank,11003,0,0,0,0,0,0,0
"Barracuda Networks, Inc.",11409,0,0,0,0,0,0,0
i'm SpA,10333,0,0,0,0,0,0,0
Healthy Weight Commitment Foundation,11407,0,0,1,1,0,0,1
DogTrekker.com,10997,0,0,0,0,0,0,0
FareStart,11680,0,0,0,0,0,0,0
Sundays Blue Box Tanning Resort,11755,0,0,0,0,0,0,0
Conner Homes Company,11399,0,0,0,0,0,0,0
Meskaki Bingo Casino Hotel,10999,0,0,0,0,0,0,0
Colorado State University,11017,0,0,0,0,0,0,0
Hallmark Health System,11000,0,0,0,0,0,0,0
"American Media, Inc.",11022,0,0,0,0,0,0,0
Lawrence Technological University,11110,0,0,0,0,0,0,0
The Philadelphia Orchestra Association,10998,0,0,0,0,0,0,0
Substance Abuse & Mental Health Services Administration,11632,0,0,0,0,0,0,0
"ArtCarved.com, Inc.",11213,0,0,0,0,0,0,0
HangzhouViews.com,11699,0,0,0,0,0,0,0
University of Pittsburgh at Greensburg,11004,0,0,0,0,0,0,0
CopperEgg Corporation,10799,0,0,0,0,0,0,0
CNI College,11629,0,0,0,0,0,0,0
"Harris Teeter, Inc.",11693,0,0,1,1,0,0,1
Anthem Entertainment,11608,0,0,0,0,0,0,0
"CUnet, LLC",10823,0,0,0,0,0,0,0
"SunTrust Banks, Inc.",10812,32,5,0,37,0.864864865,0.135135135,0
Finis,11697,0,0,0,0,0,0,0
"Vangura Surfacing Products, Inc.",11133,0,0,0,0,0,0,0
Planned Parenthood Federation of America,11123,2,0,0,2,1,0,0
"VENUS ON BROADWAY, LLC.",11024,0,0,0,0,0,0,0
"Brownells, Inc.",11001,0,0,0,0,0,0,0
"ANSYS, Inc.",11639,0,0,0,0,0,0,0
Papa New Guinea Tourism Promotion Authority,11007,0,0,0,0,0,0,0
South Point Hotel and Casino,11002,1,0,1,2,0.5,0,0.5
Hyperion,11125,0,0,0,0,0,0,0
American Historic Society,11847,0,0,0,0,0,0,0
"DAK Industries, Inc.",11009,0,0,0,0,0,0,0
Columbia Gas of Virginia,11199,0,0,0,0,0,0,0
"Aetrex Worldwide, Inc.",11700,0,0,0,0,0,0,0
BetOnline.net,11425,0,0,0,0,0,0,0
SF Zoo,11140,0,0,0,0,0,0,0
digitalconsumerpro.com,11012,0,0,0,0,0,0,0
onlinehealthdaily.com,11676,0,0,0,0,0,0,0
Academy of Art University,11414,1,0,0,1,1,0,0
ardium Therapeutics,11648,0,0,0,0,0,0,0
Idle Media Inc.,11401,0,0,0,0,0,0,0
Safe Kids Worldwide,11421,0,0,0,0,0,0,0
loyalarmy.com,11025,0,0,0,0,0,0,0
Eye Doctors of Washington,11610,0,0,0,0,0,0,0
Ziinga,11703,0,0,0,0,0,0,0
SG Interactive,11831,0,0,0,0,0,0,0
Hammerheadbikes.com,11108,0,0,0,0,0,0,0
Stanbridge College,11643,0,0,0,0,0,0,0
Massachusetts Association of REALTORS,11197,0,0,0,0,0,0,0
Community Shelter Board,11008,0,0,0,0,0,0,0
Ursuline Sisters,11200,0,0,0,0,0,0,0
"WBNS-TV, Inc",11201,0,0,1,1,0,0,1
Coty LLC,11230,0,0,1,1,0,0,1
Puget Sound Bariatric,11661,0,0,0,0,0,0,0
Gonzaga University Online Programs,11036,0,0,0,0,0,0,0
Weil Lifestyle Custom Pak,11783,0,0,0,0,0,0,0
"Waste Management, Inc.",11420,5,0,0,5,1,0,0
Fred Hutchinson Cancer Research Center,11711,0,0,0,0,0,0,0
LordsSouthBeach.com,11798,0,0,0,0,0,0,0
"bforex, LTD",11785,0,0,0,0,0,0,0
Get In Shape For Women,11709,0,0,0,0,0,0,0
TradingAuthority.com,11019,0,0,0,0,0,0,0
"Bitpipe, Inc.",11143,0,0,0,0,0,0,0
Baxter Auto Parts,11429,0,0,0,0,0,0,0
"Parent Media Group, Inc.",11834,0,0,0,0,0,0,0
The Alliance of Automobile Manufacturers,11207,0,0,0,0,0,0,0
FlirtCrowd.com,11724,0,0,0,0,0,0,0
The Seattle Foundation,11018,0,0,0,0,0,0,0
North Lake Tahoe Visitors' Bureaus,11138,0,0,0,0,0,0,0
Alwaysintheweb.com,11217,0,0,0,0,0,0,0
"Houston Press, LP,",11701,0,0,0,0,0,0,0
Experiencias Xcaret S.A. de C.V.,11672,0,0,0,0,0,0,0
Beth Israel Deaconess Hospital-Milton,11726,0,0,0,0,0,0,0
Bike Nashbar,11035,0,0,0,0,0,0,0
"SuperGlued, LLC.",11763,0,0,0,0,0,0,0
"Goya Foods, Inc.",11721,9,2,10,21,0.428571429,0.095238095,0.476190476
curatorsf.com,11742,0,0,0,0,0,0,0
DMC Worldwide,11198,0,0,0,0,0,0,0
ultimatesurvivalplan.com,11663,0,0,0,0,0,0,0
Engage America,11139,0,0,0,0,0,0,0
The University of New Orleans,11439,0,0,0,0,0,0,0
Big Girls' Bras,11773,0,0,0,0,0,0,0
Brimmer and May,11079,0,0,0,0,0,0,0
Associated Newspapers Limited,11790,0,0,0,0,0,0,0
Forzieri,11154,0,0,0,0,0,0,0
GROU.PS Inc.,11665,0,0,0,0,0,0,0
Operation Homefront,11718,0,0,0,0,0,0,0
The Gilpin Casino,11780,0,0,0,0,0,0,0
"Stokely - Van Camp, Inc",11221,0,0,0,0,0,0,0
"Collis Roofing, Inc.",11774,0,0,0,0,0,0,0
Panda Kitchen & Bath Expo Center,11782,1,0,0,1,1,0,0
"AccuWeather, Inc.",2689,0,0,0,0,0,0,0
Cybercast News Service,11039,0,0,1,1,0,0,1
Sobha Developers Ltd.,11854,0,0,0,0,0,0,0
"BodyMedia, Inc.",11158,0,0,0,0,0,0,0
Ric-Lee Corp.,11725,1,0,0,1,1,0,0
Hiller Museum,11214,0,0,0,0,0,0,0
Healthy Places,11659,0,0,0,0,0,0,0
Funcom Gmbh,11744,1,0,0,1,1,0,0
"HomeFinder.com, LLC",11848,0,0,0,0,0,0,0
Fremont Bank,11838,0,0,0,0,0,0,0
photography-colleges.com,11233,0,0,0,0,0,0,0
"Proven Winners, LLC.",11776,0,0,0,0,0,0,0
Burpee,10767,0,0,0,0,0,0,0
Comfort Systems USA Intermountain.,11051,0,0,0,0,0,0,0
The South Australian Tourism Commission,10781,0,0,0,0,0,0,0
BagThat Trading Ltd,11285,0,0,0,0,0,0,0
"LivingSocial, Inc.",12032,0,0,0,0,0,0,0
The Valspar Corporation,11437,0,0,0,0,0,0,0
"National Vision, Inc.",11789,0,0,0,0,0,0,0
Technion American Medical School,10762,0,0,0,0,0,0,0
"Giordanos, LLC.",11065,0,0,0,0,0,0,0
"Micoley.com, LLC",10745,8,0,4,12,0.666666667,0,0.333333333
"Learning House, Inc.",10788,0,0,0,0,0,0,0
"CarGroup Holdings, LLC",11050,0,0,0,0,0,0,0
The Dictator Movie,11786,0,0,0,0,0,0,0
BalletMet,11222,0,0,0,0,0,0,0
"Lester E. Kabacoff School of Hotel, Restaurant & Tourism Admininstration",10789,0,0,0,0,0,0,0
Altare Publishing,12083,0,0,0,0,0,0,0
"Interbank FX, LLC",11146,0,0,0,0,0,0,0
JC Licht | Epco,10248,0,0,0,0,0,0,0
Laacke & Joys,10756,0,0,0,0,0,0,0
Metro Transit (Minneapolis),10254,0,0,0,0,0,0,0
Citi Habitats,11068,0,0,0,0,0,0,0
People's United Bank,11053,0,0,0,0,0,0,0
New World Hotels,11801,0,0,0,0,0,0,0
Rock Island Auction Company,11444,0,0,0,0,0,0,0
"Point Ruston, LLC.",10783,0,0,0,0,0,0,0
"Focus Technology Co., Ltd.",11071,0,0,0,0,0,0,0
Albuquerque Convention & Visitors Bureau,10777,0,0,0,0,0,0,0
Lucky Star Casino,11853,0,0,0,0,0,0,0
"Essex Software, LLC.",11206,0,0,0,0,0,0,0
Illinois Holocaust Museum & Education Center,11446,0,0,0,0,0,0,0
City of Walnut Creek,11793,0,0,0,0,0,0,0
LuxuryGiftHouse.com,12249,0,0,0,0,0,0,0
CommonWealth Central Credit Union,10784,0,0,0,0,0,0,0
Ceramiche Tile & Stone,11675,0,0,0,0,0,0,0
Mediawebconnect,10790,0,0,0,0,0,0,0
Mac It Faster,10794,0,0,0,0,0,0,0
Alvernia University,10813,0,0,0,0,0,0,0
Orfalea College of Business,11609,0,0,0,0,0,0,0
Jerry Seiner Dealerships & Christopher Imports,11716,0,0,0,0,0,0,0
"Akvinta USA, Inc.",11778,0,0,0,0,0,0,0
"Law School Admission Council, Inc.",11448,0,0,0,0,0,0,0
finewineandgoodspirits.com,11161,0,0,0,0,0,0,0
"Hopstop.com, Inc.",11225,0,0,0,0,0,0,0
Capitol Acceptance Corporation,12381,0,0,0,0,0,0,0
Magnolia Audio Video,2681,1,0,0,1,1,0,0
Zagat,2684,0,0,0,0,0,0,0
FINDFRED,11072,0,0,0,0,0,0,0
StraighterLine,2697,6,1,0,7,0.857142857,0.142857143,0
Regional Coalition for Clean Rivers and Streams,11299,0,0,0,0,0,0,0
Trackdays.co.uk,11148,0,0,0,0,0,0,0
"Investment Seminars, Inc.",11224,0,0,0,0,0,0,0
Jungle Island Miami Zoological Park,11842,0,0,0,0,0,0,0
knowyourdose.org,11064,0,0,1,1,0,0,1
Green Carat LC,11102,0,0,0,0,0,0,0
MediaMind Technologies Inc.,11288,2,0,0,2,1,0,0
Colorful Images,11627,0,0,0,0,0,0,0
Private JetMD,12021,0,0,0,0,0,0,0
Presta Holdings LLC,11212,0,0,0,0,0,0,0
Flash Seats LLC,11048,0,0,0,0,0,0,0
"CBL & Associates Properties, Inc.",11850,0,0,0,0,0,0,0
"Stripe, Inc",11284,0,0,0,0,0,0,0
Charles P. Rogers,2676,1,0,0,1,1,0,0
RAC LIMITED,11227,0,0,0,0,0,0,0
State of Missouri,10769,0,0,0,0,0,0,0
Eastwood Dental Office,11766,0,0,0,0,0,0,0
CINDY WOLF'S CHARLESTON,11878,0,0,0,0,0,0,0
Flybe,12039,0,0,0,0,0,0,0
People for the American Way,10779,0,0,0,0,0,0,0
Utah Used Auto Outlet,10758,0,0,0,0,0,0,0
Gannett Co. Inc.,11115,18,8,5,31,0.580645161,0.258064516,0.161290323
Talladega Superspeedway,11232,0,0,0,0,0,0,0
American Career College,11056,0,0,0,0,0,0,0
"Verengo, Inc.",11667,16,1,0,17,0.941176471,0.058823529,0
Jerry Seiner Bountiful,11950,0,0,0,0,0,0,0
Con-way Inc.,11702,0,0,0,0,0,0,0
Tacoma Symphony Orchestra,11874,0,0,0,0,0,0,0
THE PATRÓN SPIRITS CO.,2686,0,0,0,0,0,0,0
Savages Movie,12090,0,0,0,0,0,0,0
EXPERT DIAGNOSIS,11617,0,0,0,0,0,0,0
Milwaukee Symphony Orchestra,10817,0,0,0,0,0,0,0
Thoughtout.biz,10801,0,0,0,0,0,0,0
Des Moines Arts Festival,10770,0,0,0,0,0,0,0
Anchorage Inn,11652,0,0,0,0,0,0,0
"AnchorFree, Inc.",10808,0,0,2,2,0,0,1
Windsor Foods,11229,0,0,0,0,0,0,0
Hendrick's Gin,10894,0,0,0,0,0,0,0
Chicago Shakespeare Theater,11863,0,0,0,0,0,0,0
Mayo Clinic,2682,1,0,1,2,0.5,0,0.5
"Sparkart Group, Inc.",12447,0,0,0,0,0,0,0
Gateway Clipper Fleet,12033,0,0,0,0,0,0,0
Empire Paintball,11804,0,0,0,0,0,0,0
"Career Step, LLC.",11404,1,0,0,1,1,0,0
SweetSurprise.com,11415,0,0,0,0,0,0,0
Golden State Warriors Team Store,11633,0,0,0,0,0,0,0
Buffalo.com,11451,0,0,0,0,0,0,0
The Drees Company,11440,0,0,0,0,0,0,0
PrepareUs-Emergency Preparedness.,11078,0,0,0,0,0,0,0
GarantiBank,11961,0,0,0,0,0,0,0
British United Provident Association Limited,10332,0,0,0,0,0,0,0
Transworld RideBMX,11619,0,0,0,0,0,0,0
"ATHLETIC PROPULSION LABS, INC.",11023,0,0,0,0,0,0,0
giffgaff,10328,0,0,0,0,0,0,0
Los Angeles Mission,11651,0,0,0,0,0,0,0
Sugar Sands Realty & Management,11841,0,0,0,0,0,0,0
OneTravel,2702,0,0,0,0,0,0,0
Labatt USA,11800,0,0,0,0,0,0,0
farmbureauinsurance-mi.com,11442,0,0,0,0,0,0,0
AlarmForce Industries Inc,11869,0,0,0,0,0,0,0
Helipal.com Corporation,11946,0,0,0,0,0,0,0
Cato Institute,12025,0,0,0,0,0,0,0
"ALTENLOH, BRINCK & CO. U.S., INC.",12069,0,0,0,0,0,0,0
Dover Motorsports Inc.,11957,0,0,0,0,0,0,0
StatPro Ltd.,12057,0,0,0,0,0,0,0
AV Homes,11846,0,0,0,0,0,0,0
liveatsanctuary.com,11159,0,0,0,0,0,0,0
Cinerama,11958,0,0,0,0,0,0,0
The Society of the Four Arts,11209,0,0,0,0,0,0,0
drhorton2.tru-m.com,11618,0,0,0,0,0,0,0
Mount Hood,12093,0,0,0,0,0,0,0
Ruby Peck Foundation,12088,0,0,0,0,0,0,0
The Carolina Panthers,12078,0,0,0,0,0,0,0
Perich Eye Center,11426,0,0,0,0,0,0,0
Atlanta Botanical Garden,11635,0,0,0,0,0,0,0
"Geeknet, Inc.",11784,0,0,1,1,0,0,1
TheBlaze LLC,11791,0,0,0,0,0,0,0
Shelter Mutual Insurance Company,12051,0,0,0,0,0,0,0
We Bought a Zoo Movie,11868,0,0,0,0,0,0,0
U.S. Bancorp,11396,0,0,0,0,0,0,0
National Jewish Health,12061,11,6,0,17,0.647058824,0.352941176,0
brand-server.com,12105,0,0,0,0,0,0,0
Delaware Racing Association,11685,0,0,0,0,0,0,0
Georgia Renaissance Festival,11686,0,0,0,0,0,0,0
gowildgadgets.com,11046,0,0,0,0,0,0,0
Aqua Turf Club,11216,0,0,0,0,0,0,0
"Pepperidge Farm, Incorporated",11870,0,0,0,0,0,0,0
MUVICO,11611,0,0,0,0,0,0,0
priceside.net,11753,0,0,0,0,0,0,0
"DollarDays International, Inc.",11636,0,0,0,0,0,0,0
TATTLER Reusable Canning Lids,11074,0,0,0,0,0,0,0
"Izenda, LLC",11727,0,0,0,0,0,0,0
"SF Weekly, LP",12242,0,0,0,0,0,0,0
VRL International Ltd.,12058,0,0,0,0,0,0,0
Tax Relief USA,11729,0,0,0,0,0,0,0
NeedNotGreed.org,11291,0,0,0,0,0,0,0
Cornerstone Chemical Company,10815,0,0,0,0,0,0,0
El Paseo Limousine,11418,0,0,0,0,0,0,0
johnnybrendas.com,11852,0,0,0,0,0,0,0
Comcast Corporation,11810,212,10,68,290,0.731034483,0.034482759,0.234482759
Conard-Pyle,12099,0,0,0,0,0,0,0
DicksAutoGroup.com,11073,1,0,0,1,1,0,0
meccabingo.com,11658,0,0,0,0,0,0,0
Moore & Van Allen PLLC,12312,0,0,0,0,0,0,0
Democratic Senatorial Campaign Committee,11731,0,0,0,0,0,0,0
Boxcar Theatre,12107,0,0,0,0,0,0,0
Road Show Company,12106,0,0,0,0,0,0,0
"BareWeb, Inc.",12060,0,0,0,0,0,0,0
"Sephora USA, Inc.",11734,0,0,0,0,0,0,0
"Rasmussen, Inc.",10802,1,0,0,1,1,0,0
"AAG Health, LLC",10809,0,0,0,0,0,0,0
Wixpress Ltd.,12072,0,0,1,1,0,0,1
"Old World Industries, LLC",11014,0,0,0,0,0,0,0
Buzzdock LLC,12108,0,0,0,0,0,0,0
The Royal Bank of Scotland Group Plc,11660,0,0,0,0,0,0,0
Serino Coyne,11621,0,0,0,0,0,0,0
Chinatown Optical Group,11613,0,0,0,0,0,0,0
Auto-Owners Insurance,12063,0,0,0,0,0,0,0
"California Pizza Kitchen, Inc.",11876,0,0,0,0,0,0,0
Autoridad de Turismo de Panamá,12389,0,0,0,0,0,0,0
Direxion Shares,2692,0,0,0,0,0,0,0
UNC Kenan-Flagler Business School,11061,0,0,0,0,0,0,0
Trinity Evangelical Divinity School,11768,0,0,0,0,0,0,0
Freudenberg Simrit,12379,0,0,0,0,0,0,0
Gay Ad Network,12055,0,0,0,0,0,0,0
The Hertz Corporation,12062,455,29,7,491,0.926680244,0.059063136,0.014256619
"Panda Restaurant Group, Inc.",10251,0,0,0,0,0,0,0
Espetus Churrascaria,11719,0,0,0,0,0,0,0
Willow Tree Farm,11952,0,0,0,0,0,0,0
"Seth Neubardt, M.D. & Jack Stern, M.D., Ph.D.",11063,0,0,0,0,0,0,0
Geisinger System Services,11117,0,0,0,0,0,0,0
"Stoke, Inc.",11132,0,0,0,0,0,0,0
Insure Catholic,11151,0,0,0,0,0,0,0
Anheuser-Busch,12065,3,0,11,14,0.214285714,0,0.785714286
"THEFASHIONSPOT, LLC.",11959,0,0,0,0,0,0,0
BodyLogicMD,12067,0,0,0,0,0,0,0
The World to Come,11624,0,0,0,0,0,0,0
Galmarley Ltd.,11741,0,0,0,0,0,0,0
"BEBE STORES, INC.",11836,0,0,0,0,0,0,0
Grand Canyon University,12162,21,0,0,21,1,0,0
Investment Allocation International Inc.,12080,0,0,0,0,0,0,0
Crooked Arrows Movie,12102,0,0,0,0,0,0,0
Lakeside Shopping Center,11075,0,0,0,0,0,0,0
Hästens worldwide,11032,3,0,0,3,1,0,0
squidlord.com,12244,2,0,0,2,1,0,0
californiasurrogacy.org,11642,0,0,0,0,0,0,0
HOWARD GORDON,11215,0,0,0,0,0,0,0
Andrea and Charles Bronfman Philanthropies,11626,0,0,0,0,0,0,0
Scarecrow Video,11843,0,0,0,0,0,0,0
Artez Interactive Inc,11630,0,0,0,0,0,0,0
Comprehensive Cancer Centers of Nevada,12052,0,0,0,0,0,0,0
Florida Atlantic University,12310,0,0,0,0,0,0,0
"Connor Sport Court International, Inc.",12238,0,0,0,0,0,0,0
"NeoFill, LLC",12071,0,0,0,0,0,0,0
Subaru Dealerships,11866,172,6,3,181,0.950276243,0.033149171,0.016574586
Grandex LLC.,11767,0,0,0,0,0,0,0
Coalition for a Drug-Free Greater Cincinnati,11851,0,0,0,0,0,0,0
Grand Hotel,10751,0,0,0,0,0,0,0
Pretectmedicaid.org,12241,0,0,0,0,0,0,0
"Morgan and Morgan, PA",10773,0,0,0,0,0,0,0
"Championship Auto Shows, Inc.",11131,0,0,0,0,0,0,0
"The Kabul Golf Club Fund, Inc.",12380,0,0,0,0,0,0,0
Crane Materials International,12245,0,0,0,0,0,0,0
"LODGENET HEALTHCARE, INC.",11764,0,0,0,0,0,0,0
K12 Inc.,2694,26,0,4,30,0.866666667,0,0.133333333
OneTwoSee,11679,0,0,0,0,0,0,0
Ashton Designs,11645,0,0,0,0,0,0,0
Allurez.com,12385,0,0,0,0,0,0,0
CAVE Interactive Co. LTD,11681,0,0,0,0,0,0,0
"InvestingAnswers, Inc.",11058,0,0,0,0,0,0,0
Roblox,2674,2,0,1,3,0.666666667,0,0.333333333
Ecendant Interactive,11622,0,0,0,0,0,0,0
Captain Hirams,12446,0,0,0,0,0,0,0
"Black Diamond Equipment, Ltd.",10752,0,0,0,0,0,0,0
Banner Retail Marketing,11769,0,0,0,0,0,0,0
Wilks Broadcast Group,12382,0,0,0,0,0,0,0
"Behance, Inc.",12394,1,0,0,1,1,0,0
Philadelphia Area Regional Transit Security Working Group,11298,0,0,0,0,0,0,0
MacUpdate LLC,11809,0,0,0,0,0,0,0
"ContentWatch, Inc.",11708,0,0,0,0,0,0,0
Seminole County Convention and Visitors Bureau,11948,0,0,0,0,0,0,0
Villas of Distinction,12043,0,0,0,0,0,0,0
Gemesis,10748,0,0,0,0,0,0,0
"JumpSport, Inc.",11668,0,0,1,1,0,0,1
Hostess,11710,0,0,0,0,0,0,0
The MJ Sullivan Automotive Corner,12031,0,0,0,0,0,0,0
Total Health Physical Medicine & Rehabilitation Center,11835,0,0,0,0,0,0,0
Laitram L.L.C.,11033,0,0,0,0,0,0,0
hoteldetect.com,12097,0,0,0,0,0,0,0
Commonwealth Edison Company,12048,2,2,1,5,0.4,0.4,0.2
Indy Auto Show,12082,0,0,0,0,0,0,0
InternetSafety.com Inc.,12163,1,0,0,1,1,0,0
The Amazing Spider Man Movie,11443,0,0,0,0,0,0,0
floridacentral CU,12248,0,0,0,0,0,0,0
Hidden Valley Resort,11218,0,0,0,0,0,0,0
Beta Research Corporation,11057,0,0,0,0,0,0,0
BizBuySell.com,2683,0,0,0,0,0,0,0
The Thing Movie,2701,0,0,0,0,0,0,0
"Prisma Entertainment, Llc.",11877,0,0,0,0,0,0,0
Village of Ruidoso Tourism Department,12018,0,0,0,0,0,0,0
Arte International Furnishings,12036,0,0,0,0,0,0,0
DEWALT,12086,0,0,0,0,0,0,0
Dropbox,12034,6,0,3,9,0.666666667,0,0.333333333
VSP Books LLC,12243,0,0,0,0,0,0,0
"Ventana Medical Systems, Inc.",12386,0,0,0,0,0,0,0
"Dunlop Manufacturing, Inc.",12104,2,0,0,2,1,0,0
City of Charlotte,12068,0,0,0,0,0,0,0
TechSmith Corporation,12075,1,0,0,1,1,0,0
Whiff of Joy GmbH,10822,0,0,0,0,0,0,0
ABRAMS,12311,0,0,0,0,0,0,0
MyPradaxaLawsuit.com,10824,0,0,0,0,0,0,0
Time to Succeed Coalition,11758,0,0,0,0,0,0,0
"Nissen Co.,Ltd",11694,0,0,0,0,0,0,0
"American Air & Heat, Inc.",11417,0,0,1,1,0,0,1
Gold Star Jewelers,12393,0,0,0,0,0,0,0
bso.org,11126,0,0,0,0,0,0,0
FuzziBunz,11828,0,0,0,0,0,0,0
Incapsula,11026,0,0,0,0,0,0,0
Epoq Group Ltd,11717,0,0,0,0,0,0,0
"BrandMuscle, Inc.",11149,0,0,0,0,0,0,0
Linder's Garden Center,11047,0,0,0,0,0,0,0
"OS Prime, LLC",11156,0,0,0,0,0,0,0
Cow & Gate,11049,0,0,0,0,0,0,0
Ekornes ASA,11449,0,0,0,0,0,0,0
Fat Loss Factor,11792,35,1,1,37,0.945945946,0.027027027,0.027027027
"Location Based Technologies, Inc.",11794,0,0,0,0,0,0,0
Stowe Mountain Resort,11226,0,0,0,0,0,0,0
Top Colleges LLC,11858,0,0,0,0,0,0,0
Hutchison 3G UK Limited,11951,0,0,0,0,0,0,0
Techtronic Floor Care Technology Limited,2693,7,1,0,8,0.875,0.125,0
San Francisco International Airport,11953,0,0,0,0,0,0,0
Chrysler Dealerships,12017,122,7,4,133,0.917293233,0.052631579,0.030075188
St. Louis Science Center,12092,0,0,0,0,0,0,0
tupakpsychic.com,12160,1,0,0,1,1,0,0
Rejuvenation Inc.,12087,0,0,0,0,0,0,0
johnsdietsite.com,12095,0,0,0,0,0,0,0
Massachusetts Eye and Ear,12109,0,0,0,0,0,0,0
The F&M Bank & Trust Company,12070,0,0,0,0,0,0,0
getaroom,12077,0,0,0,0,0,0,0
Town & Country Automotive Group,12309,0,0,0,0,0,0,0
Raleigh Rescue Mission,12384,0,0,0,0,0,0,0
Ace Hotel Group,12395,0,0,0,0,0,0,0
Alacare Home Health & Hospice,11406,0,0,0,0,0,0,0
Inc Key Wireless,11688,0,0,0,0,0,0,0
Champagne Perrier Jouet S.A.,11119,0,0,0,0,0,0,0
Saphire Event Group,11005,0,0,0,0,0,0,0
"CAMELBAK PRODUCTS, LLC.",11638,0,0,1,1,0,0,1
Charlotte Metro Credit Union,11202,1,0,1,2,0.5,0,0.5
ECB,11205,0,0,0,0,0,0,0
Prospect Mortgage,11037,0,0,1,1,0,0,1
Church of Scientology International,11038,7,3,1,11,0.636363636,0.272727273,0.090909091
Loyola University New Orleans Graduate Admissions,11670,0,0,0,0,0,0,0
"Aeropostale, Inc.",11723,0,0,0,0,0,0,0
MediaComplete,11220,0,0,0,0,0,0,0
Oscar de la Renta,11398,0,0,0,0,0,0,0
"MediaNews Group, Inc",11052,0,0,0,0,0,0,0
Vacation Outlet,11055,0,0,0,0,0,0,0
Weatherby Healthcare,10798,0,0,0,0,0,0,0
Ayusa,11855,0,0,0,0,0,0,0
Telefónica UK Limited,10330,0,0,0,0,0,0,0
Kimbell Art Museum,11677,0,0,0,0,0,0,0
The American Council on Exercise,11737,0,0,0,0,0,0,0
Car Retail,11616,0,0,0,0,0,0,0
Petwellbeing.com,11738,0,0,0,0,0,0,0
Bionic Gloves,11691,0,0,0,0,0,0,0
LegacyAudio.com,11069,1,0,0,1,1,0,0
CAIVP,11634,0,0,0,0,0,0,0
ColumbiaDental.com,11873,0,0,0,0,0,0,0
Ambrands,11416,0,0,0,0,0,0,0
auravietrial.com,12056,0,0,0,0,0,0,0
PPL Corporation,11641,0,0,0,0,0,0,0
Ownbrix International Corporation,12074,0,0,0,0,0,0,0
Light of India,11423,0,0,0,0,0,0,0
Arena Stage,12392,0,0,0,0,0,0,0
"TVL Broadcasting, Inc.",11134,0,0,0,0,0,0,0
oldjewstellingjokesonstage.com,11427,2,0,0,2,1,0,0
Fanatik Bike Co.,11141,0,0,0,0,0,0,0
Vegas Uncork'd,11777,0,0,0,0,0,0,0
XoticPC.com,11034,1,0,0,1,1,0,0
"Westfield, LLC",11666,0,0,0,0,0,0,0
Sun Auto Service / Sun Devil Auto,11860,0,0,0,0,0,0,0
Cincinnati Landmark Productions,11441,0,0,0,0,0,0,0
PMC,2691,0,0,1,1,0,0,1
Babson College,2700,1,0,5,6,0.166666667,0,0.833333333
Good Foods Market & Cafe,11223,1,0,0,1,1,0,0
Village Automotive Group,12019,0,0,0,0,0,0,0
South Carolina Education Lottery,11066,0,0,0,0,0,0,0
Sealy Corporation,12026,4,0,0,4,1,0,0
Sevier County Tourism Committee,12028,0,0,0,0,0,0,0
national bank of kansas city,11802,0,0,0,0,0,0,0
The Elevation Group,2678,0,0,0,0,0,0,0
Illinois Lottery,11945,18,3,0,21,0.857142857,0.142857143,0
Wayfair LLC.,12053,49,5,3,57,0.859649123,0.087719298,0.052631579
Hanesbrands Inc.,2703,0,0,2,2,0,0,1
The Knot Inc.,12085,0,0,0,0,0,0,0
Treeland Home and Garden,12387,0,0,0,0,0,0,0
ŠKODA AUTO,12027,0,0,0,0,0,0,0
OfficeLinks,12045,0,0,0,0,0,0,0
sharegreetingcards.com,12084,0,0,0,0,0,0,0
CDG Acquisition LLC,11433,0,0,0,0,0,0,0
STERIS Corporation,11208,0,0,0,0,0,0,0
"Bodybuilding.com, LLC",11435,3,0,1,4,0.75,0,0.25
NOW Foods,11844,0,0,0,0,0,0,0
Buffalo Trace,10818,0,0,1,1,0,0,1
Spread The Wealth Around,11118,0,0,0,0,0,0,0
Mercedes-Benz Dealerships,11690,0,0,0,0,0,0,0
"Moodlerooms, Inc.",10821,0,0,0,0,0,0,0
Fort Worth Opera Festival,11757,0,0,0,0,0,0,0
Smile Generation,11122,0,0,0,0,0,0,0
"Skytap, Inc.",11640,0,0,0,0,0,0,0
Cove Haven Entertainment Resorts,11422,1,0,0,1,1,0,0
"Howl USA, LLC",11021,3,0,0,3,1,0,0
The College Republican National Committee,11772,0,0,0,0,0,0,0
Cosmos Holidays,11839,0,0,0,0,0,0,0
Forming the Future of Finance,11204,0,0,0,0,0,0,0
Visit Carlsbad,11722,0,0,0,0,0,0,0
Rejuvena Cosmetic Medical Center,11153,0,0,0,0,0,0,0
Seth Grahame-Smith,11054,0,0,0,0,0,0,0
Net communities,11871,0,0,0,0,0,0,0
HATCH by twobirds,11872,0,0,0,0,0,0,0
GateWay Community College,11954,0,0,0,0,0,0,0
Barkbox.com,12022,0,0,0,0,0,0,0
American Veterinary Medical Association,12089,0,0,0,0,0,0,0
Association For Advanced Training in the Behavioral Sciences,12040,0,0,0,0,0,0,0
Root Sports,12054,0,0,0,0,0,0,0
HiPP UK Ltd,12240,0,0,0,0,0,0,0
Aspire Financial,12390,0,0,0,0,0,0,0
"Brookhaven Retreat, LLC.",10811,3,0,0,3,1,0,0
Oklahoma City Barons Hockey Club,11113,0,0,0,0,0,0,0
newscred.com,11413,9,1,0,10,0.9,0.1,0
underwateraudio.com,10826,1,0,0,1,1,0,0
"Ben & Jerry's United States, Inc.",11762,0,0,0,0,0,0,0
The Condominiums at North Bank Park,11698,0,0,0,0,0,0,0
KOOS MFG.,11130,0,0,0,0,0,0,0
Rose State College,11405,0,0,0,0,0,0,0
Funnyshirts.org,11623,0,0,0,0,0,0,0
Riddex Power Play,11687,0,0,0,0,0,0,0
Ob/Gyn Specialists of the Palm Beaches,10819,0,0,0,0,0,0,0
Kabbage Inc.,10820,0,0,0,0,0,0,0
Southern Nevada Health District,11756,0,0,0,0,0,0,0
Superchips Inc.,11120,0,0,0,0,0,0,0
"Anderson Plumbing Heating and Air, Inc.",11637,0,0,0,0,0,0,0
Natural Resources Defense Council (NRDC),11419,0,0,0,0,0,0,0
Kantorei,11020,0,0,0,0,0,0,0
brighttradeshow.com,11656,0,0,0,0,0,0,0
North Perry General Aviation Airport,11042,0,0,0,0,0,0,0
The Bra Genie,11733,0,0,0,0,0,0,0
United Financial Casualty Company,11867,0,0,0,0,0,0,0
Kingswood Communications,11803,0,0,0,0,0,0,0
Align Technology,2675,1,0,5,6,0.166666667,0,0.833333333
OXO International Inc.,2677,0,0,0,0,0,0,0
PHH Corporation,11076,0,0,0,0,0,0,0
nuNAAT,12035,0,0,0,0,0,0,0
OpinionLab Inc.,12042,12,0,1,13,0.923076923,0,0.076923077
JerusalemOnlineU.com,12044,0,0,0,0,0,0,0
"Avomex, Inc.",12101,0,0,0,0,0,0,0
Texas A&M University,12103,0,0,0,0,0,0,0
University of Reading,12076,0,0,0,0,0,0,0
Maverick PAC,12246,0,0,0,0,0,0,0
"Road Runner Sports, Inc.",11428,0,0,0,0,0,0,0
"VOLCOM, Inc.",11430,1,0,0,1,1,0,0
WNYC Radio,11845,0,0,0,0,0,0,0
SabreMark Limited Partnership,11045,0,0,0,0,0,0,0
WYES-TV/Channel 12,11849,0,0,0,0,0,0,0
Eddie Bauer,11647,24,15,2,41,0.585365854,0.365853659,0.048780488
Philadelphia CyberKnife,11060,0,0,0,0,0,0,0
Comprehensive Clinical Development,11864,0,0,0,0,0,0,0
Calistoga Ranch Living,11745,0,0,0,0,0,0,0
"ReachLocal, Inc.",11830,0,0,0,0,0,0,0
The Pefect Family Movie,11077,0,0,0,0,0,0,0
Winery Compliance Services,11028,0,0,0,0,0,0,0
"MovieTickets.com, Inc",2687,0,0,2,2,0,0,1
RBS Insurance Services Ltd,11030,0,0,0,0,0,0,0
Trim Recipe.com,11662,0,0,0,0,0,0,0
Caviness & Cates Communities,11949,0,0,0,0,0,0,0
City of Long Beach,11715,0,0,0,0,0,0,0
"ergobaby, Inc.",11964,0,0,0,0,0,0,0
Chernobyl Diaries Movie,11664,0,0,0,0,0,0,0
"PETESKI PRODUCTIONS, INC.",12030,0,0,0,0,0,0,0
Lincoln Park Zoo,11145,0,0,0,0,0,0,0
Jennsylvania.com,11781,0,0,0,0,0,0,0
Stockyards Station,12098,0,0,0,0,0,0,0
Saga,11211,0,0,0,0,0,0,0
Jade Marketing Inc,12064,0,0,0,0,0,0,0
Simply Audiobooks,11043,0,0,0,0,0,0,0
Desales Media Group,11228,0,0,0,0,0,0,0
"FreedomFest, Inc.",12164,0,0,0,0,0,0,0
Central Avenue SID,11796,0,0,0,0,0,0,0
roundsound.com,12247,0,0,0,0,0,0,0
Mattress Barn,11162,0,0,1,1,0,0,1
Hamilton County Park District,12449,0,0,0,0,0,0,0
Arts Council Silicon Valley,11062,0,0,0,0,0,0,0
GotPrint,11947,1,1,0,2,0.5,0.5,0
Randy's Ring & Pinion,11879,0,0,0,0,0,0,0
"Higher One, Inc.",11962,0,0,0,0,0,0,0
Unicorn Theatre,12096,0,0,0,0,0,0,0
SVS Inc.,11152,0,0,0,0,0,0,0
Taste of Home,12049,0,0,0,0,0,0,0
"Hobby Lobby Stores, Inc.",11673,15,1,7,23,0.652173913,0.043478261,0.304347826
Servpro Industries Inc.,12066,0,0,1,1,0,0,1
Intelex Technologies,11787,0,0,0,0,0,0,0
shinynewitems.info,12079,0,0,0,0,0,0,0
webnewsweekly.com,11788,0,0,0,0,0,0,0
"House of Antique Hardware, Inc.",11219,1,0,0,1,1,0,0
"ShopKo Stores Operating Co., LLC",11070,0,0,0,0,0,0,0
"DNC Parks & Resorts at KSC, Inc.",11806,0,0,0,0,0,0,0
Castleberry Fairs,12081,0,0,0,0,0,0,0
"Certified Financial Planner Board of Standards, Inc.",2695,0,0,0,0,0,0,0
Good Inc.,12313,0,0,0,0,0,0,0
227 Grand,11955,0,0,0,0,0,0,0
Battlefield America Movie,12383,0,0,0,0,0,0,0
Academy Sports + Outdoors,2699,8,0,2,10,0.8,0,0.2
TextbooksRus.com,11956,0,0,0,0,0,0,0
American Action Network,12024,0,0,0,0,0,0,0
Berkeley College,12091,0,0,0,0,0,0,0
Metablocks Inc.,12041,0,0,0,0,0,0,0
Speedy Metals,12073,0,0,0,0,0,0,0
"The Center for the Performing Arts, IN",9542,0,0,0,0,0,0,0
Childrens Bureau of Southern California,12391,0,0,0,0,0,0,0
Ceva Animal Health,9608,0,0,0,0,0,0,0
"Kahala Franchising, L.L.C.",10729,0,0,0,0,0,0,0
For Greater Glory Movie,12116,0,0,0,0,0,0,0
Technion Isreal Institute of Technology,12117,0,0,0,0,0,0,0
Beverlydiamonds,12119,0,0,0,0,0,0,0
Stagecoach Group PLC,10044,20,1,0,21,0.952380952,0.047619048,0
Knievel Cycles,12121,0,0,0,0,0,0,0
ProAudioStar,11752,0,0,0,0,0,0,0
Brandywine Homes,12131,0,0,0,0,0,0,0
QualitySmith.com,12122,0,0,0,0,0,0,0
Von Housen,12128,0,0,0,0,0,0,0
"Assessment Technologies Institute®, LLC.",12125,0,0,0,0,0,0,0
"Wounded Warrior Project, Inc.",11971,0,0,0,0,0,0,0
CNW Group,11968,0,0,0,0,0,0,0
"HubSpot, Inc.",11978,0,0,0,0,0,0,0
thunderbirdartists.com,12139,0,0,0,0,0,0,0
Zep Inc.,12132,0,0,1,1,0,0,1
OTB Acquisition LLC,12133,0,0,0,0,0,0,0
The Institute for Sustainable Energy at Eastern Connecticut State University,11983,0,0,0,0,0,0,0
CoreLink Data Centers,11976,0,0,0,0,0,0,0
APEAM,12134,0,0,0,0,0,0,0
"Heavy, Inc.",12123,0,0,0,0,0,0,0
"Better Air, LLC.",11750,1,0,0,1,1,0,0
Jelly Belly Candy Company,11980,0,0,0,0,0,0,0
Metropolitan Ministries,12135,0,0,0,0,0,0,0
"Reiman Media Group, LLC.",12124,2,0,0,2,1,0,0
Acoustimac LLC,12136,0,0,0,0,0,0,0
"Briggs & Stratton Power Products Group, LLC.",11986,0,0,0,0,0,0,0
We Are Serenades,11972,0,0,0,0,0,0,0
SogoTrade,12524,0,0,0,0,0,0,0
"Chameleon Internet Group, Inc.",11987,0,0,0,0,0,0,0
RCDS,12143,0,0,0,0,0,0,0
Terrebonne General Medical Center,11993,0,0,0,0,0,0,0
Insight Direct (UK) Limited,12525,0,0,0,0,0,0,0
Skyline Financial Corp.,12137,0,0,0,0,0,0,0
Serra Market Direct,11974,0,0,0,0,0,0,0
Clark Planetarium,12141,0,0,0,0,0,0,0
Blue Bell Creameries,11991,0,0,0,0,0,0,0
LLOYDS BANKING GROUP PLC,11747,0,0,0,0,0,0,0
Essence Healthcare,12115,0,0,0,0,0,0,0
ALPINESTARS S.P.A,12517,1,0,0,1,1,0,0
Goethe Institute,11979,0,0,0,0,0,0,0
Futurepoly,10642,0,0,0,0,0,0,0
AFA Press,10210,0,0,0,0,0,0,0
Greenbrier County CVB,9976,0,0,1,1,0,0,1
Superbvideoconverter.com,10742,0,0,0,0,0,0,0
Consumer Coalition for Affordable Reliable Phone Service,9625,0,0,0,0,0,0,0
Aiyou Network Technology,10395,0,0,0,0,0,0,0
Sunshine Furnture,8555,0,0,0,0,0,0,0
"Glacier Park, Inc.",10895,0,0,0,0,0,0,0
PADI,11751,0,0,0,0,0,0,0
SolarWorld AG,12519,0,0,0,0,0,0,0
"Chopra Enterprises, LLC",12521,0,0,0,0,0,0,0
Monsanto Company,12526,0,0,0,0,0,0,0
"Ticketfly, Inc.",11817,0,0,0,0,0,0,0
The Museum of Modern Art,12530,0,0,0,0,0,0,0
"Creative Communications, Inc",11813,0,0,0,0,0,0,0
Taigan,10947,0,0,0,0,0,0,0
Imperial Chemical Industries Ltd.,11985,0,0,0,0,0,0,0
Orchard Supply Hardware,11823,0,0,0,0,0,0,0
Montana's Missouri River Country,11992,0,0,0,0,0,0,0
A. T. Cross Company,12166,0,0,1,1,0,0,1
MoreVisibility,11994,0,0,0,0,0,0,0
Predixion Software,10948,0,0,0,0,0,0,0
ShopAKIRA.com,11826,0,0,0,0,0,0,0
Arkansas Department of Parks & Tourism,10945,0,0,0,0,0,0,0
Leith Management Company,12456,0,0,0,0,0,0,0
Arvest Bank,12451,0,0,0,0,0,0,0
Cheri Media Group,12463,0,0,0,0,0,0,0
"RehabMart.com, LLC",12462,0,0,0,0,0,0,0
Palm Beach State College,10951,0,0,0,0,0,0,0
"Okuma Nutritionals, LLC",10959,0,0,0,0,0,0,0
The National Hispanic University,12168,0,0,0,0,0,0,0
BSH Home Appliances Corporation,12594,1,0,0,1,1,0,0
P4SMedia,12595,0,0,0,0,0,0,0
FMG INC.,10952,0,0,0,0,0,0,0
Woodward Tahoe,12179,0,0,0,0,0,0,0
LCH.Clearnet Ltd,12174,0,0,0,0,0,0,0
Grand Sierra Resort and Casino,12118,0,0,0,0,0,0,0
American Foundation for Suicide Prevention,12457,0,0,0,0,0,0,0
Prive Jets,12518,0,0,0,0,0,0,0
Jagex Ltd.,12599,0,0,0,0,0,0,0
"FreeCleanSolar, Inc.",12529,0,0,0,0,0,0,0
alternet.org,12184,0,0,0,0,0,0,0
"Pottsville Republican, Inc",12180,0,0,0,0,0,0,0
"Polycom, Inc.",12182,0,0,0,0,0,0,0
AGCO Corporation,11825,0,0,0,0,0,0,0
Gardenerbox.com,12602,0,0,0,0,0,0,0
The Home Depot Foundation,12187,0,0,0,0,0,0,0
Indigo Stream Technologies,12606,0,0,0,0,0,0,0
"Galderma Laboratories, L.P.",12188,1,0,0,1,1,0,0
"The Rock and Roll Hall of Fame and Museum, Inc.",12614,0,0,0,0,0,0,0
NX8.com,12616,0,0,0,0,0,0,0
Truman Arnold Companies,12611,0,0,0,0,0,0,0
EnergyFromShale.org,12454,2,1,1,4,0.5,0.25,0.25
CanadaDrugCenter.com,12199,0,0,0,0,0,0,0
"Street league, Inc.",12609,0,0,0,0,0,0,0
Nanjing Automobile,12193,0,0,0,0,0,0,0
thebeacham.com,12169,0,0,0,0,0,0,0
Furniture Village,12209,0,0,0,0,0,0,0
HOYU AMERICA,12189,0,0,0,0,0,0,0
"Green Eco Club, LLC",12623,0,0,0,0,0,0,0
Kwik Kopy,12214,0,0,0,0,0,0,0
Systweak,1528,25,0,6,31,0.806451613,0,0.193548387
"Owenby Law, LLC",12604,0,0,0,0,0,0,0
Audi,1520,38,12,8,58,0.655172414,0.206896552,0.137931034
Vodo.net,1576,0,0,0,0,0,0,0
Peoples Bank,1545,0,0,0,0,0,0,0
Nordstrom,1537,31,2,7,40,0.775,0.05,0.175
Newly Maid,1556,0,0,0,0,0,0,0
Gulfstream Aerospace Corporation,12608,0,0,0,0,0,0,0
Allen Edmonds Shoe Corporation,12617,0,0,0,0,0,0,0
"Weather Underground, Inc.",12204,0,0,0,0,0,0,0
Lift Master,1523,0,0,0,0,0,0,0
Zachys Wine & Liquor Inc .,12618,0,0,0,0,0,0,0
DUBturbo.com,12622,0,0,0,0,0,0,0
Quiznos,1563,5,0,0,5,1,0,0
"Download Freely, LLC",12211,1,0,0,1,1,0,0
Hyundai,1540,54,17,17,88,0.613636364,0.193181818,0.193181818
The Aspen Institute,12178,0,0,0,0,0,0,0
Geico,1534,192,131,12,335,0.573134328,0.391044776,0.035820896
Cupid Media Pty Ltd.,12167,7,1,1,9,0.777777778,0.111111111,0.111111111
ITN Source,12629,0,0,0,0,0,0,0
Directors Live,1536,0,0,0,0,0,0,0
Costdropper.com,1572,0,0,0,0,0,0,0
Online Consumer Journal,12610,0,0,0,0,0,0,0
Appsumo.com,12603,0,0,0,0,0,0,0
Getdislike.com,12625,0,0,0,0,0,0,0
Lower East Side Business Improvement,12201,0,0,0,0,0,0,0
Paramount,1561,0,0,0,0,0,0,0
Andticketing.com,12212,0,0,0,0,0,0,0
Zales,1582,97,19,5,121,0.801652893,0.157024793,0.041322314
"Gearbox Software, LLC",1546,0,0,0,0,0,0,0
SureSource LLC,12192,0,0,0,0,0,0,0
"MyProjectorLamps International, LLC",12619,0,0,0,0,0,0,0
Windstream Communications,12628,25,1,2,28,0.892857143,0.035714286,0.071428571
Premier Valley Bank,1525,0,0,0,0,0,0,0
Tulalip Casino,1532,0,0,0,0,0,0,0
Sears PartsDirect,10876,1,0,0,1,1,0,0
The Lofts at Valley Forge,10980,0,0,0,0,0,0,0
GNTO,11378,0,0,0,0,0,0,0
BOYIS.COM,11380,0,0,0,0,0,0,0
"FreeScale, Inc.",3205,0,0,0,0,0,0,0
EKU,11246,0,0,0,0,0,0,0
North American Hunting Club,1935,0,0,0,0,0,0,0
BuyCostumes.com,11180,0,0,1,1,0,0,1
Offleaseonly.com,10291,0,0,0,0,0,0,0
"Restaurants Unlimited, Inc.",11280,0,0,0,0,0,0,0
TheStirMate.com,10761,0,0,0,0,0,0,0
The Atlantic City Convention & Visitors Authority,10244,0,0,0,0,0,0,0
Geo. J. Foster Company,10744,0,0,1,1,0,0,1
Mr. Basement,11097,0,0,0,0,0,0,0
Polytechnic Institute of New York University,11395,3,0,0,3,1,0,0
ShopRite,10893,0,0,0,0,0,0,0
Bang & Olufsen,10327,0,0,0,0,0,0,0
"Wheaton Van Lines, Inc.",10795,1,0,0,1,1,0,0
internetpayday.co,10810,0,0,0,0,0,0,0
The Alpha Publishing House,10993,1,0,0,1,1,0,0
Right to Bare Legs,10995,0,0,0,0,0,0,0
Flagstaff Convention & Visitors Bureau,11695,0,0,0,0,0,0,0
Onesti Entertainment,10827,0,0,0,0,0,0,0
EducationHub.com,11127,0,0,0,0,0,0,0
FBC Mortgage,11765,0,0,0,0,0,0,0
DHG Management Company,11129,1,1,0,2,0.5,0.5,0
Premiere Global Sports,11829,0,0,0,0,0,0,0
"Go Forward Adventures, LLC.",11195,0,0,0,0,0,0,0
"Zhejiang Bangda Industry & Trade Co.,Ltd.",11712,0,0,0,0,0,0,0
"Sharecare, Inc.",11029,0,0,0,0,0,0,0
EA International,11714,0,0,0,0,0,0,0
"Patrician Management, LLC",11210,0,0,0,0,0,0,0
ACLU,11044,2,0,2,4,0.5,0,0.5
Lincoln Dealerships,11795,0,0,0,0,0,0,0
Frontier Airlines,2673,0,0,0,0,0,0,0
GOODBY SILVERSTEIN,11865,0,0,0,0,0,0,0
Acid Flyers,11799,0,0,0,0,0,0,0
showrates.com,11746,0,0,0,0,0,0,0
"Ashton Data, LLC.",11486,0,0,0,0,0,0,0
RecipeSecrets.net,12114,0,0,0,0,0,0,0
savemymilitaryhealthcare.com,11748,0,0,0,0,0,0,0
Tellus Science Museum,11889,0,0,0,0,0,0,0
bestringtonesmaker.com,11965,0,0,0,0,0,0,0
"BrooklynAcademyof Music, Inc.",11890,0,0,0,0,0,0,0
Exotics Racing School,12004,0,0,0,0,0,0,0
South Motors,12472,1,0,0,1,1,0,0
TDS Telecommunications Corporation,12007,0,0,0,0,0,0,0
"Adore Me.com, Corp.",11999,0,0,0,0,0,0,0
"Newland Real Estate Group, LLC.",11482,1,0,0,1,1,0,0
Personal Liberty Alerts,12222,0,0,0,0,0,0,0
The National Ballet of Canada Inc,12489,0,0,0,0,0,0,0
"ScottHyver Visioncare, Inc.",12158,0,0,0,0,0,0,0
Keadjian Associates,11887,0,0,0,0,0,0,0
Chukchansi Gold Resort & Casino,12484,0,0,0,0,0,0,0
Big Skinny Corp.,12482,0,0,0,0,0,0,0
Palo Alto Software,11487,1,0,0,1,1,0,0
Herschend Family Entertainment Corporation,12316,0,0,0,0,0,0,0
HOME SHOW MANAGEMENT CORP.,11885,0,0,0,0,0,0,0
Apollo's Fire The Cleveland Baroque Orchestra,10967,0,0,1,1,0,0,1
LACAC  FORD THEATRES,10971,0,0,0,0,0,0,0
CouponMom.com,12490,0,0,0,0,0,0,0
Blastro Networks,12000,0,0,0,0,0,0,0
Colquhoun Audio Laboratories Limited,11504,1,0,1,2,0.5,0,0.5
Agile Sports Technologies,12468,0,0,0,0,0,0,0
"Klement's Sausage Co., Inc.",11901,0,0,0,0,0,0,0
"Pauls TV, Inc.",12157,0,0,0,0,0,0,0
Danner Boots,11483,3,0,4,7,0.428571429,0,0.571428571
City of Walla Walla,12150,0,0,0,0,0,0,0
Prometheus Global Media LLC,12540,1,0,0,1,1,0,0
IQWindows.com,12483,0,0,0,0,0,0,0
Exempla Healthcare,11884,0,0,0,0,0,0,0
Tennis Express,11886,0,0,0,0,0,0,0
ENMAX Corporation,12488,0,0,0,0,0,0,0
"Spark Networks USA, LLC",12149,30,5,2,37,0.810810811,0.135135135,0.054054054
Banner Bank,11904,0,0,0,0,0,0,0
Keller Williams Tacoma,12469,0,0,0,0,0,0,0
"Water Pik, Inc.",12224,0,0,0,0,0,0,0
Worcester Polytechnic Institute,12315,0,0,0,0,0,0,0
Dorel Industries,12218,0,0,0,0,0,0,0
Brad Benson Auto Group,12009,0,0,0,0,0,0,0
Robert Wood Johnson University Hospital,12501,0,0,0,0,0,0,0
Firefly e-Ventures Ltd.,12508,0,0,0,0,0,0,0
The University of the Arts in Philadelphia,12532,0,0,0,0,0,0,0
ArcadeWeb LLC,12156,0,0,1,1,0,0,1
Jaspersoft Corporation,12507,0,0,0,0,0,0,0
"Akita, Inc.",12493,0,0,0,0,0,0,0
McCarter Theatre Center,12478,0,0,0,0,0,0,0
Unity Bank,12503,0,0,0,0,0,0,0
Ontario Reg.,11491,1,0,0,1,1,0,0
UNITY Mobile,12486,0,0,0,0,0,0,0
Couponkim.com,12495,0,0,0,0,0,0,0
Rex Healthcare,12320,0,0,1,1,0,0,1
"AdMedia, Inc.",12538,0,0,0,0,0,0,0
Jazzed.com,12498,0,0,0,0,0,0,0
"The Merlot Group, LLC",11897,0,0,0,0,0,0,0
Nissan Dealerships,12676,3,0,2,5,0.6,0,0.4
insuranow.com,12491,0,0,0,0,0,0,0
"Susquehanna Bancshares, Inc.",12217,0,0,0,0,0,0,0
Kool Smiles Jobs,12536,0,0,0,0,0,0,0
pgaresort.com,12500,0,0,0,0,0,0,0
Pearl Jam Ten Club,12533,0,0,0,0,0,0,0
Skikos Crawford Skikos & Joseph,11485,0,0,0,0,0,0,0
Revive Personal Products Company,12557,0,0,0,0,0,0,0
"Supple, LLC",12551,0,0,0,0,0,0,0
Chaos Commerce Inc.,11893,0,0,0,0,0,0,0
"Producers Guild of America, Inc.",11507,0,0,0,0,0,0,0
St. Croix Casino LLC.,11903,0,0,0,0,0,0,0
Mellanox Technologies,11500,0,0,0,0,0,0,0
Radiomovil Dipsa S.A. de C.V,11911,0,0,0,0,0,0,0
"Florida East Coast Realty, Inc.",12542,0,0,0,0,0,0,0
New York City Events,11915,0,0,0,0,0,0,0
"Real Mex Restaurants, Inc.",11495,0,0,0,0,0,0,0
maktoob-research.com,11918,0,0,0,0,0,0,0
Hayden Homes LLC,11899,0,0,0,0,0,0,0
Deutsche Post,12545,0,0,0,0,0,0,0
Warren Henry Auto Group,11906,0,0,0,0,0,0,0
Firstload,12679,0,0,0,0,0,0,0
GameDuell,11492,0,0,0,0,0,0,0
Southern Connecticut State University,11900,0,0,0,0,0,0,0
eprofits.com,11084,0,0,0,0,0,0,0
"Premier Exhibitions, Inc.",12340,0,0,0,0,0,0,0
Brunswick Corporation,12231,0,0,0,0,0,0,0
"Lighting, Incorporated",11912,0,0,0,0,0,0,0
Project J Corporation,12686,0,0,0,0,0,0,0
jazzbakery.org,12322,0,0,0,0,0,0,0
"Walmart Stores, Inc.",12690,99,6,36,141,0.70212766,0.042553191,0.255319149
TOD'S SPA,12480,0,0,0,0,0,0,0
Sunny Delight Beverage Co.,11909,0,0,0,0,0,0,0
Discount Dance Supply,12016,0,0,0,0,0,0,0
Flagler County Chamber of Commerce,12334,0,0,0,0,0,0,0
"Really Good Stuff, Inc.",11514,0,0,0,0,0,0,0
Globalcorporatecareers.com,12639,0,0,0,0,0,0,0
Diane von Furstenberg Studio,12504,0,0,0,0,0,0,0
Woot Services LLC.,12003,0,0,0,0,0,0,0
"Living Solutions Design Group, Inc.",12561,0,0,0,0,0,0,0
Great Falls Convention & Vistors Bureau,12672,0,0,0,0,0,0,0
Trinity International University,12550,0,0,0,0,0,0,0
"Genentech, Inc.",12634,0,0,2,2,0,0,1
Aedrops.com,12257,0,0,0,0,0,0,0
Perfect World Entertainment Inc,12325,21,0,1,22,0.954545455,0,0.045454545
Wasatch Funds,11930,0,0,0,0,0,0,0
Muckleshoot Indian Casino,11927,0,0,0,0,0,0,0
Hudson Medical Communications,12331,0,0,0,0,0,0,0
Personal Communications Devices,11083,0,0,0,0,0,0,0
Oxbridge Academy of the Palm Beaches,11086,0,0,0,0,0,0,0
"Radio One, Inc.",12347,0,0,0,0,0,0,0
onehawthorne.com,12235,0,0,0,0,0,0,0
mytheresa.com GmbH,11515,0,0,0,0,0,0,0
The Loft Literary Center,11923,0,0,0,0,0,0,0
Other World Computing,12535,0,0,0,0,0,0,0
ACEA,12343,0,0,0,0,0,0,0
Metro,11517,0,0,0,0,0,0,0
Playpickle.com,11518,2,0,0,2,1,0,0
Herman Herman & Katz,12675,0,0,1,1,0,0,1
Friends of Bobby Jindal,12715,0,0,0,0,0,0,0
TAB Bank,12555,0,0,0,0,0,0,0
Paradigm Electronics,11914,0,0,0,0,0,0,0
Richard Karr Motors,11936,0,0,0,0,0,0,0
Healthy Hearts Club,12505,0,0,0,0,0,0,0
VonZipper,11508,0,0,0,0,0,0,0
NAREIT,11921,0,0,0,0,0,0,0
Merchants Square Williamsburg,12512,0,0,0,0,0,0,0
K&G Fashion Superstore,12348,0,0,0,0,0,0,0
Arizona Citizens Clean Elections Commission,12354,0,0,1,1,0,0,1
Wellness Life Systems,12258,0,0,0,0,0,0,0
Amundson Mysteries,12265,0,0,0,0,0,0,0
Consolelegends.com,12554,0,0,0,0,0,0,0
MrChewy.com,12546,0,0,0,0,0,0,0
"Stratasys, Inc.",12684,0,0,0,0,0,0,0
National Association of Photoshop Professionals,11943,0,0,0,0,0,0,0
Air New Zealand Ltd.,12687,7,2,3,12,0.583333333,0.166666667,0.25
College of Mount St. Joseph,11910,0,0,0,0,0,0,0
Gibson Guitar Corp.,12638,0,0,0,0,0,0,0
"ActionSportsNow, LLC.",12717,0,0,0,0,0,0,0
"Hitachi, Ltd",12351,0,0,0,0,0,0,0
E-Lites UK,12784,0,0,0,0,0,0,0
HostDime.com,12336,0,0,0,0,0,0,0
The Regents of the University of Colorado,11922,0,0,0,0,0,0,0
Tampa Metropolitan Area YMCA.,12260,0,0,0,0,0,0,0
Horseshoe Bay Resort,12279,0,0,0,0,0,0,0
Phone Power,12263,0,0,0,0,0,0,0
"Zoosk, Inc.",12669,16,1,0,17,0.941176471,0.058823529,0
National Consumer Panel,12695,0,0,0,0,0,0,0
MTN Advertising,12572,0,0,0,0,0,0,0
"Pacific Union International, Inc.",11924,0,0,0,0,0,0,0
Annapolis & Anne Arundel County Conference & Visitors Bureau,12368,0,0,0,0,0,0,0
American Beverage Association,12510,0,0,0,0,0,0,0
PaCyber,11938,0,0,0,0,0,0,0
Euro-Pro Operating LLC,12581,2,0,0,2,1,0,0
University of Washington Tacoma,12404,1,0,0,1,1,0,0
Tout.com,12785,0,0,0,0,0,0,0
Dreamzer Games,12804,2,0,0,2,1,0,0
Long Island University,12573,0,0,0,0,0,0,0
Chinese Laundry Legwear,11908,0,0,0,0,0,0,0
SmartBargains,12583,0,0,0,0,0,0,0
New World Group,12782,0,0,0,0,0,0,0
Investec,12754,0,0,0,0,0,0,0
Alaplaya.net,11510,0,0,0,0,0,0,0
ANSI,12345,0,0,0,0,0,0,0
Coupons.com Incorporated,12254,94,31,34,159,0.591194969,0.194968553,0.213836478
U-GAS.COM,12443,0,0,0,0,0,0,0
Pets Best Insurance Services,11940,0,0,0,0,0,0,0
Seattle's Union Gospel Mission,12558,0,0,0,0,0,0,0
eBay Inc.,12657,69,13,30,112,0.616071429,0.116071429,0.267857143
iTwin Inc,12570,0,0,0,0,0,0,0
TIG Global,11941,0,0,0,0,0,0,0
NH Department of Resources and Economic Development,12237,0,0,0,0,0,0,0
book-it.org,12364,0,0,0,0,0,0,0
Chrysler Group LLC.,12726,229,21,42,292,0.784246575,0.071917808,0.143835616
SelectMark,12356,0,0,0,0,0,0,0
Joel Osteen Ministries,12731,0,0,0,0,0,0,0
The Royal Mint Limited,12693,0,0,0,0,0,0,0
Friends of Nan Hayworth,12704,0,0,0,0,0,0,0
CCP,12997,3,0,0,3,1,0,0
"Braintree Payment Solutions, LLC.",12680,0,0,0,0,0,0,0
"MyWebGrocer, Inc",12678,9,2,1,12,0.75,0.166666667,0.083333333
KOI TATTOO WEAR,12280,0,0,0,0,0,0,0
DrSinatra.com,12272,0,0,0,0,0,0,0
Liberty Savings Federal Credit Union,12798,0,0,0,0,0,0,0
Travidia Inc.,12722,1,0,1,2,0.5,0,0.5
All Media Guide LLC,12635,0,0,0,0,0,0,0
Aether Apparel,12961,0,0,0,0,0,0,0
BOMA International,12799,0,0,0,0,0,0,0
Evolven Software,12659,0,0,0,0,0,0,0
KCTS Television,12268,0,0,0,0,0,0,0
[x]cube labs,12800,0,0,0,0,0,0,0
"Tourism Bureau, Republic of China (Taiwan).",12786,0,0,0,0,0,0,0
Rochester District Visiting Nurse Association,12743,0,0,0,0,0,0,0
Plain Green Loans,12652,0,0,0,0,0,0,0
EDF Energy,12640,0,0,0,0,0,0,0
Sunrise Senior Living,12972,1,0,0,1,1,0,0
NSF International,12729,0,0,0,0,0,0,0
Churchill Downs Incorporated,12365,0,0,0,0,0,0,0
"Master Pools of Washington, Inc.",13215,0,0,0,0,0,0,0
The Harrison County Convention and Visitors Bureau,12749,0,0,1,1,0,0,1
Miami-Dade County,12298,0,0,0,0,0,0,0
"Zimbio, Inc.",12590,0,0,0,0,0,0,0
Keith McMillen Instruments,12586,0,0,0,0,0,0,0
"Kenmore Air Harbor, Inc.",12708,0,0,0,0,0,0,0
Maryville University,12290,0,0,0,0,0,0,0
Nice Work If You Can Get It.com,12745,0,0,0,0,0,0,0
Transportes Aéreos del Continente Americano S.A.,12637,0,0,0,0,0,0,0
Metropolitan Airport Authority,11939,0,0,0,0,0,0,0
"Living Assistance Services, Inc.",12741,0,0,1,1,0,0,1
invoxia,12407,0,0,0,0,0,0,0
Brizo,12282,0,0,0,0,0,0,0
First National Bank of Omaha.,12817,0,0,0,0,0,0,0
Total Defense Inc.,12721,0,0,0,0,0,0,0
"EXIT41, INC",12801,0,0,0,0,0,0,0
Rogue Movie Network,12408,0,0,0,0,0,0,0
Prince Edward Island,12787,0,0,0,0,0,0,0
"Children's Medical Center Dallas, Texas",12417,0,0,0,0,0,0,0
Sentry Group,12644,0,0,0,0,0,0,0
"Gregg's Greenlake Cycle, Inc",13565,0,0,0,0,0,0,0
"Agente Entertainment, Inc.",12374,0,0,0,0,0,0,0
Jumeirah International LLC,12285,1,0,0,1,1,0,0
"The Hartford Financial Services Group, Inc.",12399,4,0,4,8,0.5,0,0.5
"Health Diagnostic Laboratory, Inc.",12405,0,0,0,0,0,0,0
Ken Stanton Music,12736,0,0,0,0,0,0,0
ibelieveit.ca,12755,0,0,0,0,0,0,0
CBP,12576,0,0,0,0,0,0,0
Mail.ru Games,12357,0,0,0,0,0,0,0
WorkNet Pinellas,13633,0,0,0,0,0,0,0
Yeke Ltd.,12797,0,0,0,0,0,0,0
Macmillan Cancer Support,12750,0,0,0,0,0,0,0
"Binverse, Incorporated",12297,0,0,0,0,0,0,0
River Front Theater,12790,0,0,0,0,0,0,0
Lourdes Health System,12284,0,0,0,0,0,0,0
Waitrose,12857,0,0,0,0,0,0,0
"Author Solutions, Inc.",12816,6,1,0,7,0.857142857,0.142857143,0
"VIZ Media, LLC",12416,2,0,0,2,1,0,0
"WildBlue Communications, Inc.",12344,0,0,0,0,0,0,0
Flashbay Inc.,12853,0,0,0,0,0,0,0
Eggers Funeral Home,12291,0,0,0,0,0,0,0
Superiordesignassociates.com,12765,0,0,0,0,0,0,0
tosh529.org,12747,0,0,0,0,0,0,0
North Skull,12402,0,0,0,0,0,0,0
The MENTOR Network,12431,0,0,0,0,0,0,0
AirCo,12293,0,0,0,0,0,0,0
Marin Theatre Company,12809,0,0,0,0,0,0,0
political.com,12854,0,0,0,0,0,0,0
Association of Film Commissioners International,12933,0,0,0,0,0,0,0
"TMP Worldwide Advertising & Communications, LLC",12766,0,0,0,0,0,0,0
Cages By Design,12710,0,0,0,0,0,0,0
"CareerBuilder, LLC.",12855,2,0,1,3,0.666666667,0,0.333333333
J Sainsbury plc,12776,0,0,0,0,0,0,0
"Liquidity Services, Inc.",12571,0,0,0,0,0,0,0
America's Windows USA,12267,0,0,1,1,0,0,1
BuildDirect,12269,39,8,0,47,0.829787234,0.170212766,0
Gotriangle.org,12935,0,0,0,0,0,0,0
Joel C. Rosenberg,11944,0,0,0,0,0,0,0
"eContactLive, Inc.",12950,0,0,0,0,0,0,0
"Village Voice Media Holdings, LLC.",12433,0,0,1,1,0,0,1
All Seasons Lawn & Landscaping,12759,0,0,0,0,0,0,0
"TigerDirect, Inc.",12852,18,6,11,35,0.514285714,0.171428571,0.314285714
Marquette University College of Business Administration,12948,0,0,0,0,0,0,0
Municipal Theatre Association of St. Louisv,12952,0,0,0,0,0,0,0
Thrivent Financial for Lutherans,12990,0,0,0,0,0,0,0
North Essex Chamber of Commerce,12924,0,0,0,0,0,0,0
"MyJewishlearning, Inc.",12739,0,0,0,0,0,0,0
Triple Crown Corporation,12271,0,0,0,0,0,0,0
"Battleon EpicDuel, LLC",12275,0,0,0,0,0,0,0
Stenotype Institute,12424,0,0,0,0,0,0,0
BPTP,12760,0,0,0,0,0,0,0
Neuxpower Solutions Ltd.,12589,0,0,0,0,0,0,0
Universal Watch Company,12932,0,0,0,0,0,0,0
Royal Albert Hall,12922,0,0,0,0,0,0,0
Freebord.com,13057,0,0,0,0,0,0,0
Unity Catholic Federal Credit Union,12306,0,0,0,0,0,0,0
Baltimore Sun Media Group,12882,0,0,0,0,0,0,0
Crabtree & Evelyn Ltd.,12377,0,0,0,0,0,0,0
standupmedia.com,12746,0,0,0,0,0,0,0
Cardsave,12276,0,0,0,0,0,0,0
providencelv.com,12832,0,0,1,1,0,0,1
Visit Oakland,12773,0,0,0,0,0,0,0
Collings Foundation,12982,0,0,0,0,0,0,0
junkaroosandmoveroos.com/,12834,0,0,0,0,0,0,0
Gator Dominos and Dominos Pizza,12967,0,0,0,0,0,0,0
Parscarsales.com,12418,0,0,0,0,0,0,0
Robert Haack Diamond Importers,12413,0,0,0,0,0,0,0
Turgeonraine.com,12762,0,0,0,0,0,0,0
ohiomm.com,12289,0,0,0,0,0,0,0
"FreedomQuest, LLC",12926,0,0,0,0,0,0,0
Star Alliance Services,12820,0,0,0,0,0,0,0
latexmattress.org,12278,0,0,0,0,0,0,0
Ostendorf-Morris Company,12966,0,0,0,0,0,0,0
"CycleSport, Inc.",12803,0,0,0,0,0,0,0
"Wynn Resorts Holdings, LLC.",12774,11,5,0,16,0.6875,0.3125,0
Joyland Country,12376,0,0,0,0,0,0,0
MediaOne of Utah,12772,0,0,0,0,0,0,0
Stannah Stairlifts Inc.,12425,0,0,0,0,0,0,0
AIDS Healthcare Foundation,13065,0,0,0,0,0,0,0
MakeUseOf,12825,18,0,0,18,1,0,0
Metropolitan Community College,12976,0,0,0,0,0,0,0
Regency Theatres,12421,0,0,0,0,0,0,0
Edison International,12826,0,0,0,0,0,0,0
The Sanofi Group,13066,0,0,0,0,0,0,0
Omit Apparel,13218,0,0,0,0,0,0,0
Sentara Healthcare,13133,0,0,1,1,0,0,1
"National Pasteurized Eggs, Inc.",12744,0,0,0,0,0,0,0
Alain Pinel Realtors,12770,0,0,0,0,0,0,0
Oglebay Resort and Conference Center,13416,1,0,2,3,0.333333333,0,0.666666667
Solantic Corporation,12369,0,0,0,0,0,0,0
"877 SPIRITS, INC.",13211,0,0,0,0,0,0,0
Nash Health Care Systems,12420,1,0,1,2,0.5,0,0.5
Arbella Insurance Group,13420,0,0,0,0,0,0,0
Quantum Learning Network,12942,0,0,0,0,0,0,0
Gene Pankey Motors,12822,0,0,0,0,0,0,0
Oberon Media,12427,1,0,0,1,1,0,0
City of Seattle,12953,0,0,0,0,0,0,0
ParkSpringsCommunities.com,12962,0,0,0,0,0,0,0
The Echo Design group Inc.,12429,0,0,0,0,0,0,0
The Really Useful Group Ltd,12771,0,0,0,0,0,0,0
The Park School Camps,13134,0,0,0,0,0,0,0
The Brooks Companies,12873,0,0,0,0,0,0,0
"PC Pitstop, LLC",12308,1,0,0,1,1,0,0
Saratoga County Chamber of Commerce,13217,0,0,0,0,0,0,0
TAM Linhas Aéreas,12974,0,0,0,0,0,0,0
KQED Inc.,11749,0,0,0,0,0,0,0
Bed Defense,12871,0,0,0,0,0,0,0
Cincinnati Museum Center,12956,0,0,0,0,0,0,0
Safecastle LLC,12487,0,0,0,0,0,0,0
Pictopia.com,12780,0,0,0,0,0,0,0
"Advanced Markets, LLC.",13344,0,0,0,0,0,0,0
Answer This! Movie,12412,0,0,0,0,0,0,0
Best of the Best International Music Festival,11973,0,0,0,0,0,0,0
Dartmouth-Hitchcock,13060,0,0,0,0,0,0,0
Children's Creativity Museum,12947,0,0,0,0,0,0,0
Bozzani Motors,13348,0,0,0,0,0,0,0
Terratec/McFarland Cascade,13063,0,0,0,0,0,0,0
E-TRADE Financial Corporation,12153,15,1,10,26,0.576923077,0.038461538,0.384615385
Workforce Alliance,12879,0,0,0,0,0,0,0
Wings Financial Credit Union,12130,0,0,0,0,0,0,0
Droll Yankees Inc.,10950,0,0,0,0,0,0,0
JodiPicoult,13494,0,0,0,0,0,0,0
"Hormel Foods, LLC",12940,27,1,4,32,0.84375,0.03125,0.125
TollFreeForwarding.com,12814,0,0,0,0,0,0,0
SmartStyleLiving.net,12120,0,0,0,0,0,0,0
"Monkey Sports, Inc.",12461,0,0,0,0,0,0,0
Wayne County Community College District,11490,0,0,0,0,0,0,0
University of Edinburg,12126,0,0,0,0,0,0,0
"Harman International Industries, Inc.",11894,0,0,0,0,0,0,0
FOLLIES,12523,0,0,0,0,0,0,0
Chicago Zoological Society,12769,19,0,0,19,1,0,0
Red Mountain Resort,13367,0,0,0,0,0,0,0
Hotel del Coronado,13191,0,0,0,0,0,0,0
Conair Corporation,12226,0,0,2,2,0,0,1
Big Interview,12778,0,0,0,0,0,0,0
iq-150.com,13426,0,0,0,0,0,0,0
Salt Lake County Center for the Arts,13190,0,0,0,0,0,0,0
"Teva Women's Health, Inc.",12127,7,0,5,12,0.583333333,0,0.416666667
Scripps Health,12527,0,0,0,0,0,0,0
"IncrediMail, Lt",12228,0,0,0,0,0,0,0
Jeff Fouts & Associates,13349,0,0,0,0,0,0,0
Congressman Russ Carnahan,11977,0,0,0,0,0,0,0
Stabenow for U.S. Senate,12186,0,0,0,0,0,0,0
Shoeprivee.com,12528,0,0,0,0,0,0,0
Medifast San Diego,13340,0,0,0,0,0,0,0
Dodge Dealerships,12964,51,2,2,55,0.927272727,0.036363636,0.036363636
live-access.com,13219,0,0,0,0,0,0,0
Rx for Brown Skin,11996,0,0,0,0,0,0,0
GACTV.com,1533,0,0,0,0,0,0,0
"Ram International, Ltd.",12455,0,0,0,0,0,0,0
Men in Black 3 Movie,11815,0,0,0,0,0,0,0
Nullsoft,13417,0,0,0,0,0,0,0
The Caldrea Company,12173,0,0,0,0,0,0,0
City of Edmonton,12435,0,0,0,0,0,0,0
Upsellit Co,13568,0,0,0,0,0,0,0
Klipsch,12943,0,0,0,0,0,0,0
"Lump Sum, LLC.",11969,0,0,0,0,0,0,0
Adconion Media Group,12591,0,0,0,0,0,0,0
Sport On Inc.,12191,0,0,0,0,0,0,0
"Medi IP, LLC.",12439,0,0,0,0,0,0,0
SlideShare Inc.,13358,1,0,0,1,1,0,0
United Psychological Services,12993,0,0,0,0,0,0,0
ABCO Refrigeration Supply Corp.,13062,0,0,0,0,0,0,0
UNLVtickets,11881,0,0,0,0,0,0,0
Driver's Village,12496,0,0,1,1,0,0,1
discountcruises.com,11988,0,0,0,0,0,0,0
Freeze Dry Guy,12973,0,0,0,0,0,0,0
Apricorn Co.,12326,0,0,0,0,0,0,0
Buffalo Bill's Cody / Yellowstone Country.,13189,0,0,0,0,0,0,0
Shana Logic,13196,0,0,0,0,0,0,0
Holiday Lettings Ltd,13201,0,0,0,0,0,0,0
Costa Rica Tourism Board,10964,1,0,0,1,1,0,0
Permadontics.com,11819,1,0,0,1,1,0,0
Brazilian Blowout,13418,0,0,0,0,0,0,0
AppNexus Inc,12318,0,0,0,0,0,0,0
Softroute Corporation,13209,0,0,0,0,0,0,0
Uptown Place,12147,0,0,0,0,0,0,0
Hub Jewelers,12464,0,0,0,0,0,0,0
"Limited Stores, LLC",11820,0,0,0,0,0,0,0
Pennsylvania Institute of Health and Technology,12328,0,0,0,0,0,0,0
CiCi ENTERPRISES L.P.,11984,0,0,0,0,0,0,0
Excentus,13492,0,0,0,0,0,0,0
"Rocky Brands, Inc.",13499,0,0,0,0,0,0,0
Lubricants USA Inc.,10956,0,0,0,0,0,0,0
"Eve Echo, Inc.",10960,0,0,0,0,0,0,0
"The Inland Real Estate Group of Companies, Inc.",12145,0,0,0,0,0,0,0
SimplyCast,12553,0,0,0,0,0,0,0
American University of the Caribbean School of Medicine,13365,0,0,0,0,0,0,0
Oregon Symphony Association,12144,0,0,0,0,0,0,0
cath kidston,13415,0,0,0,0,0,0,0
Inmarsat Plc.,10958,0,0,0,0,0,0,0
"Nuance Communications, Inc.",12876,21,4,2,27,0.777777778,0.148148148,0.074074074
Billboard,1531,1,0,0,1,1,0,0
"Avid Technology, Inc.",12596,0,0,0,0,0,0,0
GetCashForSurveys.com,13427,0,0,0,0,0,0,0
Covidien,13207,0,0,0,0,0,0,0
Will Cardon for U.S. Senate,13243,0,0,0,0,0,0,0
BUZZMEDIA,12958,1,0,0,1,1,0,0
Woovite,12205,0,0,0,0,0,0,0
Clybournepark.com,13246,0,0,0,0,0,0,0
TBdress.com,13265,6,0,0,6,1,0,0
Diamondvaultoftroy.com,12470,0,0,0,0,0,0,0
YouBeauty,13214,0,0,0,0,0,0,0
atmo-shipping.com,12975,0,0,0,0,0,0,0
Consumerwomenshealth.com,13262,0,0,0,0,0,0,0
dianasdietblog.com,13248,0,0,0,0,0,0,0
vibescm.com,13354,0,0,0,0,0,0,0
U.S. Waterproofing,12236,0,0,0,0,0,0,0
American Gas Association,13567,0,0,0,0,0,0,0
Gemvara,1542,2,0,0,2,1,0,0
Scottsdale Silver,13368,0,0,0,0,0,0,0
"Winn-Dixie Stores, Inc.",12543,0,0,0,0,0,0,0
Vitaloneplans.com,13267,0,0,0,0,0,0,0
Laboratories Darphin,12598,0,0,0,0,0,0,0
TripMama.com,12511,0,0,0,0,0,0,0
"Knitting Paradise, Inc.",13126,0,0,0,0,0,0,0
Blackstar Amplification Ltd,13250,0,0,0,0,0,0,0
Surdyk's Liquor Store and Gourmet Cheese Shop,11524,0,0,0,0,0,0,0
People to People Ambassador Programs,13422,0,0,0,0,0,0,0
Cressy Door Company,13193,0,0,0,0,0,0,0
Maison Moi,13225,0,0,0,0,0,0,0
"VMV USA, Ltd.",12140,0,0,0,0,0,0,0
We Are Missouri,13429,0,0,0,0,0,0,0
Frameline,13226,0,0,0,0,0,0,0
InterCoast,12329,1,0,0,1,1,0,0
City of Richardson,12459,0,0,0,0,0,0,0
Colonial Downs,12473,0,0,0,0,0,0,0
Torc1racing.com,13261,0,0,0,0,0,0,0
thepointsguy.com,13496,0,0,0,0,0,0,0
California Avocado Commission,12636,0,0,0,0,0,0,0
losagaves.net,13564,0,0,0,0,0,0,0
"Kel-Tec CNC Industries, Inc.",13632,0,0,1,1,0,0,1
Verizon,11525,449,91,101,641,0.700468019,0.141965679,0.157566303
"DaVinci Roofscapes, LLC",12697,0,0,0,0,0,0,0
Lepton Labs LLC,12643,0,0,0,0,0,0,0
City of Hope,12568,2,0,1,3,0.666666667,0,0.333333333
Fitbit Inc.,13362,4,1,0,5,0.8,0.2,0
Vyatta Inc.,12661,0,0,0,0,0,0,0
Special Olympics New Jersey,12361,0,0,0,0,0,0,0
AAMI Australia,12286,0,0,0,0,0,0,0
Issuu,12411,0,0,0,0,0,0,0
VKR Holding,12761,0,0,0,0,0,0,0
Marine.mil,12861,0,0,0,0,0,0,0
VNA Homecare,12304,0,0,0,0,0,0,0
sasklotteries.ca,12936,0,0,0,0,0,0,0
Flatwatermedia.com,12779,0,0,0,0,0,0,0
Towne Auto,12872,0,0,0,0,0,0,0
Orange County's Credit Union,12979,0,0,0,0,0,0,0
Otcshop.co.uk,13061,0,0,0,0,0,0,0
Committee for Our Children’s Future,13129,0,0,0,0,0,0,0
The ComedySportz Theatre,13197,0,0,0,0,0,0,0
Avoya Travel,13347,0,0,0,0,0,0,0
The Art of Rap Movie,13497,0,0,0,0,0,0,0
Mindshapes Ltd,13247,0,0,0,0,0,0,0
Lindenwood University,11926,0,0,0,0,0,0,0
TENBA Gear,12560,0,0,0,0,0,0,0
Shell Canada Limited,12251,0,0,0,0,0,0,0
mainstreetinmotion.com/,12653,0,0,0,0,0,0,0
Broadway San Jose,12794,0,0,0,0,0,0,0
Sky Lodge,12796,0,0,0,0,0,0,0
Littler Mendelson P.C.,12753,0,0,1,1,0,0,1
"Skyline Chili, Inc.",12294,0,0,0,0,0,0,0
Sansone Corporation,12296,0,0,0,0,0,0,0
Willamette Country Music Concerts Inc.,12428,0,0,0,0,0,0,0
"Planet Discover, LLC",12830,0,0,0,0,0,0,0
Indesit Company,13064,0,0,0,0,0,0,0
"Shock Doctor, Inc.",13198,0,0,0,0,0,0,0
everymomentmatters.org,13566,0,0,0,0,0,0,0
Advanced Academics,13423,0,0,0,0,0,0,0
Places All Around Travel,13432,0,0,0,0,0,0,0
Western Connecticut Healthcare,13357,0,0,0,0,0,0,0
run10feed10.com,13230,0,0,0,0,0,0,0
"Orbitz, LLC",13232,1,0,2,3,0.333333333,0,0.666666667
Marketing Evolution,12194,0,0,0,0,0,0,0
Vocalocity.com,12630,0,0,0,0,0,0,0
Judy Moody,1530,0,0,0,0,0,0,0
Columbia Pictures,1555,0,0,0,0,0,0,0
Wheel & Sprocket Inc.,12485,0,0,0,0,0,0,0
Greater Wilmington Convention and Visitors Bureau,12151,0,0,0,0,0,0,0
Gage Auto Sales,11892,0,0,0,0,0,0,0
Human Performance Network LLC,11479,0,0,0,0,0,0,0
Alabama Center for Real Estate,12494,0,0,0,0,0,0,0
creativeamerica.org,12319,0,0,0,0,0,0,0
"Penske Truck Leasing Co., L.P.",12183,4,1,0,5,0.8,0.2,0
getschooled.com,12321,0,0,0,0,0,0,0
U.S. Retailers LLC,12600,0,0,0,0,0,0,0
Plantation Homes,11081,0,0,0,0,0,0,0
Discover Bank,12615,29,1,6,36,0.805555556,0.027777778,0.166666667
Howards.com,11917,0,0,1,1,0,0,1
Ottawa Tourism,12200,0,0,0,0,0,0,0
"RM Acquisition, LLC",11519,2,1,0,3,0.666666667,0.333333333,0
Blog.com,12466,0,0,0,0,0,0,0
Doane Academy,11919,0,0,0,0,0,0,0
Palms of Pasadena Hospital,10962,0,0,0,0,0,0,0
Spoetzl Brewery,11928,0,0,0,0,0,0,0
IK Softwareportal GmbH,12013,0,0,0,0,0,0,0
Walden Font,12562,0,0,0,0,0,0,0
"Forex Club, LLC",11494,0,0,0,0,0,0,0
DMS Group Pte. Ltd.,12262,0,0,0,0,0,0,0
"RevZilla Motorsports, LLC.",12534,0,0,0,0,0,0,0
J. P.Boden & Co. Limited Trading,12353,0,0,0,0,0,0,0
Pennsylvania Department of Community and Economic Development,12232,0,0,0,0,0,0,0
"Compete, Inc.",12655,0,0,0,0,0,0,0
Recap Investments,11511,5,0,0,5,1,0,0
SilverTribe,12662,0,0,0,0,0,0,0
PlayerAuctions,12332,0,0,0,0,0,0,0
New York State Energy Research & Development Authority,12728,4,1,0,5,0.8,0.2,0
"DWS Investments Distributors, Inc.",12698,0,0,0,0,0,0,0
TREADEPOT.COM,12585,0,0,0,0,0,0,0
"Found Animals Foundation, Inc.",12566,0,0,0,0,0,0,0
AIR MILES Canada,12730,0,0,0,0,0,0,0
Design Interaction,12349,0,0,0,0,0,0,0
"Moneytree, Inc.",12360,0,0,0,0,0,0,0
ClubOneInc.com,12264,0,0,0,0,0,0,0
Jacuzzi Inc.,12921,0,0,0,0,0,0,0
Forwardprinting.com,12664,0,0,0,0,0,0,0
Freeway Autos,12764,0,0,0,0,0,0,0
IPligence,12734,0,0,0,0,0,0,0
Des Moines Art Center,12819,0,0,0,0,0,0,0
"Geoffrey, LLC.",12366,27,2,24,53,0.509433962,0.037735849,0.452830189
Center for Audit Quality,12419,0,0,0,0,0,0,0
"Super 8 Worldwide, Inc.",12751,7,0,1,8,0.875,0,0.125
RBCPlazaCondos.com,12821,0,0,0,0,0,0,0
Momentum Development,12815,0,0,0,0,0,0,0
southernoregon.org,12928,0,0,0,0,0,0,0
"Cross Country Home Services, Inc.",12862,0,0,0,0,0,0,0
Akamai Technologies,12426,0,0,0,0,0,0,0
"Affinity Road & Travel Club, LLC",12864,0,0,0,0,0,0,0
New Orleans Ballet Association,12828,0,0,0,0,0,0,0
"Mignon Faget, Ltd.",12994,0,0,0,0,0,0,0
Long Island Convention & Visitors Bureau and Sports Commission,12955,0,0,0,0,0,0,0
"Jacobs Heating & Air Conditioning, Inc.",12996,0,0,1,1,0,0,1
The Wildlife Experience,12998,0,0,0,0,0,0,0
"ING Investments Distributor, LLC",13128,0,0,0,0,0,0,0
Ksl Resorts,12300,0,0,2,2,0,0,1
Our Lady of the Lake Physician Group,13130,0,0,0,0,0,0,0
Durham Performing Arts Center,13221,0,0,0,0,0,0,0
Other Press,12768,0,0,0,0,0,0,0
Trip Technologies Inc.,13223,0,0,0,0,0,0,0
"United Parcel Service of America, Inc (UPS)",12868,41,5,6,52,0.788461538,0.096153846,0.115384615
LEO Pharma Inc.,13421,0,0,0,0,0,0,0
Waterbrook Multnomah,12432,0,0,0,0,0,0,0
NETC,13355,0,0,0,0,0,0,0
AAA Furnace & Air Conditioning Co.,13132,0,0,0,0,0,0,0
CITY Cosmetics,13228,20,0,0,20,1,0,0
Firstgiving.com,13200,0,0,0,0,0,0,0
Teligence,13498,0,0,0,0,0,0,0
Lakewood Cemetery,13353,0,0,0,0,0,0,0
HAVAIANAS.COM,13264,0,0,0,0,0,0,0
"PhoneFactor, Inc",13236,0,0,0,0,0,0,0
MDG Computers Canada Inc.,13500,0,0,0,0,0,0,0
Gold Club SF LLC,11989,0,0,0,0,0,0,0
"Hair Club for Men, Ltd.",11484,0,0,0,0,0,0,0
BT PLC,12002,0,0,0,0,0,0,0
Re-Body LLC,12220,0,0,0,0,0,0,0
NO on I-1183,11895,0,0,0,0,0,0,0
neatoshop.com,12502,0,0,0,0,0,0,0
AxisRemit,12234,0,0,0,0,0,0,0
"Small Dog Electronics, Inc",12552,0,0,1,1,0,0,1
Hanks and Mortensen,11934,0,0,0,0,0,0,0
National Instruments Corporation,12645,2,0,1,3,0.666666667,0,0.333333333
InternetSurveyPrizes.com,12713,0,0,0,0,0,0,0
P.J. Morgan Real Estate,12352,0,0,0,0,0,0,0
superprizeworld.com,12720,1,0,0,1,1,0,0
Groundlink Inc.,12727,0,0,0,0,0,0,0
Orange Bowl Committee,12359,0,0,0,0,0,0,0
Foodie Blogroll,12363,0,0,0,0,0,0,0
Zen NFO,12795,0,0,0,0,0,0,0
"Teva Respiratory, LLC.",12370,0,0,0,0,0,0,0
Hyundai Dealerships,12763,28,1,7,36,0.777777778,0.027777778,0.194444444
The TFT Group,12302,0,0,0,0,0,0,0
Lightning Labels,12931,0,0,0,0,0,0,0
Muscle & Joint Performance Chiropractic,12777,0,0,0,0,0,0,0
"Video Only, Inc.",12938,2,0,2,4,0.5,0,0.5
Catholic Relief Services,12870,0,0,0,0,0,0,0
"Emerald Landscape Supply, LLC.",12945,0,0,0,0,0,0,0
Skyvue.com,12438,0,0,0,0,0,0,0
"Arena Rush, LLC",12995,0,0,0,0,0,0,0
"Hagerty Insurance Agency, LLC",12881,0,0,0,0,0,0,0
St. David's HealthCare,13056,0,0,0,0,0,0,0
"SharesPost , Inc.",13188,0,0,0,0,0,0,0
PT Astra Honda Motor,13206,0,0,0,0,0,0,0
The Honest Company,13263,0,0,0,0,0,0,0
Hershey Theatre,13356,0,0,0,0,0,0,0
oneminutecommissions.com,13231,0,0,0,0,0,0,0
"Master Spas, Inc.",11812,0,0,0,0,0,0,0
Money Advice Service,12146,0,0,0,0,0,0,0
GREAT BUILDER SOLUTIONS,11478,0,0,0,0,0,0,0
Boerne Convention & Visitors Bureau,11880,0,0,0,0,0,0,0
teeturtle.com,13070,0,0,0,0,0,0,0
Warwick Business School,13069,0,0,0,0,0,0,0
Pediatric Associates,13071,0,0,0,0,0,0,0
Virgin Australia Airlines Pty Ltd,12165,0,0,0,0,0,0,0
Dalani Home & Living,13271,0,0,0,0,0,0,0
FXVA,13270,0,0,0,0,0,0,0
Topdeck,12450,0,0,0,0,0,0,0
"Zynga, Inc.",13273,0,0,0,0,0,0,0
Shapell Homes,13275,0,0,1,1,0,0,1
Riemann Family Funeral Homes,13279,0,0,0,0,0,0,0
Contain My Dog,13284,0,0,0,0,0,0,0
shapeyourfutureok.com,13288,0,0,0,0,0,0,0
"YellowDog Media, Inc.",13290,0,0,0,0,0,0,0
Energy Northwest,12988,0,0,0,0,0,0,0
AlwaysDownloads,13641,0,0,0,0,0,0,0
Lily of the Desert,13647,0,0,0,0,0,0,0
"The Hammock Company, LLC",13649,0,0,0,0,0,0,0
bestbuddieschallenge.org,13294,0,0,0,0,0,0,0
PKR Limited,13300,0,0,0,0,0,0,0
TradeTheMarkets.com,13003,0,0,0,0,0,0,0
"BHNM, Inc.",13646,0,0,0,0,0,0,0
International Travel Network,13002,0,0,0,0,0,0,0
ontd-political.livejournal.com,13639,0,0,0,0,0,0,0
"MotherKnows, Inc.",13292,0,0,0,0,0,0,0
MajorGeeks.Com,13648,0,0,1,1,0,0,1
zbani.com,13286,0,0,0,0,0,0,0
Ferring Pharmaceuticals Inc.,13642,0,0,0,0,0,0,0
ScienceCare,13299,0,0,0,0,0,0,0
webcamz.info,13072,0,0,0,0,0,0,0
Northern Lights Direct,12986,0,0,0,0,0,0,0
"Nemecorp Distribution, LLC.",11821,0,0,0,0,0,0,0
"Brasher-Gunn, Inc.",11822,0,0,0,0,0,0,0
"EmpowHER/HW, LLC",12458,0,0,0,0,0,0,0
California Science Center,12171,0,0,0,0,0,0,0
Ultimate-Downloads.com,12172,18,2,0,20,0.9,0.1,0
Kensington Computer Group,10954,0,0,0,0,0,0,0
"NetSeer, Inc.",12607,0,0,0,0,0,0,0
Archer Daniels Midland Company,12208,0,0,0,0,0,0,0
teleflora,1526,67,1,2,70,0.957142857,0.014285714,0.028571429
CDW,1544,29,17,9,55,0.527272727,0.309090909,0.163636364
QIP Holder LLC.,12221,0,0,0,0,0,0,0
"Adorama Camera, Inc.",11489,1,0,0,1,1,0,0
GUGGENHEIM PARTNERS LLC,10968,0,0,0,0,0,0,0
SalvageData Recovery Service,11503,0,0,0,0,0,0,0
Momentum Telecom Inc.,12539,0,0,0,0,0,0,0
"Huffman Productions, Inc.",11907,0,0,0,0,0,0,0
Palm Beach Opera,11085,0,0,0,0,0,0,0
Roche Diagnostics,11522,0,0,0,0,0,0,0
"ProHealth Physicians, Inc.",12339,0,0,0,0,0,0,0
"Marchex, Inc",12689,0,0,0,0,0,0,0
FileSonic,12658,0,0,0,0,0,0,0
City Index Ltd,12725,0,0,0,0,0,0,0
Shock Top Brewing Co.,12358,0,0,0,0,0,0,0
George Mason University,12740,0,0,0,0,0,0,0
Thermo Fisher Scientific Inc.,12757,0,0,0,0,0,0,0
PennLive LLC.,12807,0,0,1,1,0,0,1
Peoples Gas,12758,0,0,0,0,0,0,0
VA Mortgage Center.com,12858,0,0,0,0,0,0,0
Artha Property,12925,0,0,0,0,0,0,0
Hood River County Chamber of Commerce,12307,0,0,0,0,0,0,0
Waterheatedbythesun.com,12775,15,1,0,16,0.9375,0.0625,0
"BitTorrent, Inc.",12875,0,0,0,0,0,0,0
CompressionSale.com,12440,0,0,0,0,0,0,0
applianceprices.net,12957,0,0,0,0,0,0,0
driverperformer.com,13125,0,0,0,0,0,0,0
Delphix,13194,0,0,0,0,0,0,0
"Complete Ticket Solutions, Inc.",13208,0,0,0,0,0,0,0
Wise Food Supply,13361,0,0,0,0,0,0,0
Visit Newport Beach Inc.,13244,0,0,0,0,0,0,0
Eurotunnel,13276,0,0,0,0,0,0,0
ActBlue,13293,0,0,0,0,0,0,0
"Laguna Tools, Inc",13644,0,0,0,0,0,0,0
The E. W. Scripps Company,12196,6,0,4,10,0.6,0,0.4
Orange County Market Place,12198,0,0,0,0,0,0,0
Dollar Rent a Car,1553,0,0,0,0,0,0,0
myfreshideas.com,11481,0,0,0,0,0,0,0
Expressions of Humankind Foundation,11998,0,0,0,0,0,0,0
XL Group plc,12481,0,0,0,0,0,0,0
Gretna Career College,12317,0,0,0,0,0,0,0
Wawa Inc.,11896,3,1,1,5,0.6,0.2,0.2
Wake Up Frankie,12230,0,0,0,0,0,0,0
PTSLA.COM,12666,0,0,0,0,0,0,0
Datweb pty ltd,12547,0,0,0,0,0,0,0
HomEquity Bank,11513,0,0,0,0,0,0,0
"Poptent, Inc.",12549,0,0,0,0,0,0,0
Brickyard.com,12668,0,0,0,0,0,0,0
Energy For America,12330,0,0,0,0,0,0,0
"Just Fabulous, Inc",12681,17,1,3,21,0.80952381,0.047619048,0.142857143
RaidenTech,12651,0,0,0,0,0,0,0
City of Pismo Visitors & Conference Bureau,12781,0,0,0,0,0,0,0
"NetProspex, Inc.",12266,0,0,0,0,0,0,0
BankForeclosedListings.com,12783,3,0,0,3,1,0,0
"CASIO AMERICA, INC.",12732,1,0,0,1,1,0,0
"Eagle Construction of VA., LLC.",12281,0,0,0,0,0,0,0
"Breakthrough Fitness Systems, LLC",12398,0,0,0,0,0,0,0
Isabel Wilkerson,12283,0,0,0,0,0,0,0
TAMPA PREPARATORY SCHOOL,12400,0,0,0,0,0,0,0
Suncoast Eye Center,12849,0,0,0,0,0,0,0
The Sun Products Corporation,12851,0,0,0,0,0,0,0
City of Miami Beach,12415,0,0,0,0,0,0,0
ASIS Healthcare,12934,0,0,0,0,0,0,0
Geary Group,12430,0,0,0,0,0,0,0
"Lund Food Holdings, Inc.",12949,0,0,0,0,0,0,0
Baltimore Gas and Electric Company,12951,0,0,0,0,0,0,0
Oakland Museum of California,12968,0,0,0,0,0,0,0
Moose International,13202,0,0,0,0,0,0,0
Kaufman Center,13351,0,0,0,0,0,0,0
Kitchen Craft Cabinetry,13634,0,0,0,0,0,0,0
Pentax Ricoh Imaging Americas Corporation,13366,0,0,0,0,0,0,0
Oregon Coast Aquarium,13234,0,0,0,0,0,0,0
"Treehouse Island, Inc.",13266,0,0,0,0,0,0,0
Wowcher Limited,13268,0,0,0,0,0,0,0
Cajun Operating Company,13251,0,0,0,0,0,0,0
Design Toscano,13068,0,0,0,0,0,0,0
Purchasing Power,13283,4,0,1,5,0.8,0,0.2
"Reliance Relocation Services, INC.",12985,0,0,0,0,0,0,0
Cockfight Play,12176,0,0,0,0,0,0,0
"Prudent Publishing Co., Inc.",12605,0,0,0,0,0,0,0
OwnerIQ Inc,12612,3,0,0,3,1,0,0
"Atlas Business Solutions, Inc.",12210,0,0,0,0,0,0,0
Realestate.com,1539,0,0,0,0,0,0,0
EarnMyDegree.com,1541,0,0,0,0,0,0,0
Hank Graff,1580,0,0,0,0,0,0,0
Richard Ivey School of Business,12471,0,0,0,0,0,0,0
The Parable Group,12476,0,0,0,0,0,0,0
New Land Films,12001,0,0,0,0,0,0,0
"BlueCava, Inc.",12008,0,0,0,0,0,0,0
GANZ,12010,0,0,0,0,0,0,0
Grocery Shopping Network,11501,0,0,0,0,0,0,0
Riverside County Transportation Commission,12537,0,0,0,0,0,0,0
URBAN1972,12544,0,0,0,0,0,0,0
SafeTouch,12335,0,0,0,0,0,0,0
The Clorox Pets Products Company,12337,0,0,0,0,0,0,0
Glennz Tees,12346,0,0,0,0,0,0,0
Palmer/Wirfs & Associates,11933,0,0,0,0,0,0,0
Industrial and Financial Systems (IFS),12703,0,0,0,0,0,0,0
Atlantic Health System,11935,0,0,0,0,0,0,0
"Almased USA, Inc",12646,0,0,0,0,0,0,0
TriWest Healthcare Alliance,12714,0,0,0,0,0,0,0
"Peel Technologies, Inc.",12578,0,0,0,0,0,0,0
Legacy Marketing Partners,11816,0,0,0,0,0,0,0
Robert J. DeBry & Associates,12452,0,0,0,0,0,0,0
"Raymond James Financial, Inc.",11827,0,0,0,0,0,0,0
"Seapine Software, Inc.",12613,0,0,0,0,0,0,0
Muskoka Tourism,12195,0,0,0,0,0,0,0
Blue Cross and Blue Shield of Alabama,12620,0,0,0,0,0,0,0
"initiative legal group, apc",12202,0,0,0,0,0,0,0
GameArt Studio GmbH,12627,0,0,0,0,0,0,0
Walter E. Smithe Furniture,13077,0,0,0,0,0,0,0
BECKER DESIGNED INC,12841,0,0,0,0,0,0,0
Luther Brookdale,13029,0,0,0,0,0,0,0
Haaretz Daily Newspaper Ltd.,13075,0,0,1,1,0,0,1
American Dry Cleaners,12839,0,0,0,0,0,0,0
San Juan Islands Visitors Bureau,13078,0,0,0,0,0,0,0
"Legg Mason Investor Services, LLC.",12847,0,0,0,0,0,0,0
Telecom Italia Sparkle S.p.A.,13017,0,0,0,0,0,0,0
Running Aces Harness Park,12838,0,0,0,0,0,0,0
Find University Online Degrees,13009,0,0,0,0,0,0,0
Peoples Bancorp,13076,0,0,0,0,0,0,0
Turkish Airlines,13016,1,2,1,4,0.25,0.5,0.25
"Goodguys Enterprises, Inc.",13080,0,0,0,0,0,0,0
Paramount Farms International LLC.,13023,0,0,1,1,0,0,1
Dollar General Corporation,13006,3,1,1,5,0.6,0.2,0.2
S&E Auto Sales,13024,0,0,0,0,0,0,0
Medical City Children's Hospital,12845,0,0,0,0,0,0,0
"F.H. Furr Plumbing, Heating And Air Conditioning",13081,0,0,0,0,0,0,0
Eastern University,12840,0,0,0,0,0,0,0
"Destination Hotels & Resorts, Inc.",12846,2,0,0,2,1,0,0
saki,12843,0,0,0,0,0,0,0
Teva Pharmaceutical Industries Ltd.,13012,0,0,0,0,0,0,0
Twin Cities Public Television,13008,0,0,0,0,0,0,0
Alamo Capital,13025,0,0,0,0,0,0,0
Santa Cruz Beach Boardwalk,13015,0,0,0,0,0,0,0
Local SEO Formula,13032,0,0,0,0,0,0,0
yourrewardstoday,13034,0,0,0,0,0,0,0
Precious Metals Financial,13020,0,0,0,0,0,0,0
Heard Museum,13031,1,0,0,1,1,0,0
Solutions By Web,13019,0,0,0,0,0,0,0
Honda,1524,20,2,11,33,0.606060606,0.060606061,0.333333333
"DoubleDown Interactive, LLC",12477,4,0,0,4,1,0,0
Panasonic,12152,13,0,4,17,0.764705882,0,0.235294118
Real Media Inc,12227,0,0,0,0,0,0,0
Cathy Schnaubelt Rogers,11502,0,0,0,0,0,0,0
The Bushnell Center for the Performing Arts,11902,0,0,0,0,0,0,0
"CSC Holdings, LLC.",11509,16,0,4,20,0.8,0,0.2
BrainStorm Group,12513,0,0,0,0,0,0,0
VitecGroup Italia Spa,12327,0,0,0,0,0,0,0
National Lottery Commision,12677,0,0,0,0,0,0,0
sunnews6.com,11920,0,0,0,0,0,0,0
PizzaExpress,12688,0,0,0,0,0,0,0
iTRADE.com,12252,0,0,0,0,0,0,0
"SimplyWheelz, LLC",12563,0,0,0,0,0,0,0
Imagewear Apparel Corp.,12259,0,0,0,0,0,0,0
Ted Movie,12788,0,0,0,0,0,0,0
Edge Marketing llc,12588,0,0,0,0,0,0,0
Oregon Children’s Theatre,12277,0,0,0,0,0,0,0
North Shore Gas,12802,0,0,0,0,0,0,0
advertise.com,12752,0,0,0,0,0,0,0
Dimitriou's Jazz Alley,12295,0,0,0,0,0,0,0
"National Kidney Foundation, Inc.",12813,1,0,0,1,1,0,0
"Workday, Inc.",12856,0,0,1,1,0,0,1
"Laura Ashley, Inc.",12863,1,0,0,1,1,0,0
Palmetto Dunes Oceanfront Resort,12877,1,0,0,1,1,0,0
Preferred Hotel Group,12445,0,0,0,0,0,0,0
Greenbriar Treatment Center,12963,0,0,0,0,0,0,0
BlueShield of Northeastern New York,13131,1,0,0,1,1,0,0
Raritan Inc.,13195,0,0,0,0,0,0,0
Lake of the Ozarks Convention & Visitor Bureau,13213,0,0,0,0,0,0,0
Tommy Hilfiger Licensing LLC.,13220,0,0,2,2,0,0,1
Ingersoll-Rand plc,13424,0,0,0,0,0,0,0
The Roanoke Valley Convention & Visitors Bureau,13431,1,0,0,1,1,0,0
"Eye Care Centers of America, Inc.",13363,1,0,0,1,1,0,0
Media-Resource.net,13238,0,0,0,0,0,0,0
Central Park Conservancy,13245,0,0,0,0,0,0,0
Koka Booth Amphitheatre,13295,0,0,0,0,0,0,0
Wisconsin Department of Natural Resources,13638,0,0,0,0,0,0,0
"TShirt Laundry, LLC",13013,0,0,0,0,0,0,0
PicYou,12474,0,0,0,0,0,0,0
megaplayercodecs.com,12155,0,0,0,0,0,0,0
VEVO LLC,11506,0,0,0,0,0,0,0
"Cash America International, Inc.",12509,0,0,0,0,0,0,0
SequelMedia,12323,0,0,0,0,0,0,0
The Everson Museum of Art,11087,0,0,0,0,0,0,0
TwinStar Credit Union,12338,0,0,0,0,0,0,0
"MSC Industrial Direct Co., Inc.",12723,0,0,0,0,0,0,0
Surplus Warehouse,12724,0,0,0,0,0,0,0
Apollo Research Institute,12791,0,0,0,0,0,0,0
"Edison Properties, LLC.",12806,0,3,0,3,0,1,0
"All Star Directories, Inc.",12409,0,0,0,0,0,0,0
Rock of Ages Movie,12923,0,0,0,0,0,0,0
Savills,13059,0,0,0,0,0,0,0
ShopPaddock.com,13124,0,0,0,0,0,0,0
Reusablecanninglids.com,13127,0,0,0,0,0,0,0
Occidental College,13224,0,0,0,0,0,0,0
San Cristobal Treatment Center,13260,0,0,0,0,0,0,0
KnowledgeTree Inc.,13341,0,0,0,0,0,0,0
Virginia Lottery,13495,5,0,0,5,1,0,0
recycler.com,13241,0,0,0,0,0,0,0
Sunvil International Sales Ltd,13274,0,0,0,0,0,0,0
Zale Corporation,13645,0,0,0,0,0,0,0
Library Foundation of Los Angeles,12842,0,0,0,0,0,0,0
Provena Health,13027,0,0,0,0,0,0,0
Saris Cycling Group,13287,0,0,0,0,0,0,0
VoltDB Inc.,13296,0,0,0,0,0,0,0
Ryanair Ltd.,13298,0,0,0,0,0,0,0
CruisePlus Management Ltd.,12987,0,0,0,0,0,0,0
"Classified Ventures, LLC.",13021,26,0,7,33,0.787878788,0,0.212121212
People Are the New Bottom Line,13028,0,0,0,0,0,0,0
appround.net,13030,44,1,14,59,0.745762712,0.016949153,0.237288136
"Concur Technologies, Inc.",12580,3,0,1,4,0.75,0,0.25
Vibram USA Inc.,11942,0,0,0,0,0,0,0
Carphone Warehouse Group PLC,12735,0,0,0,0,0,0,0
"Wausau Financial Systems, Inc.",12737,0,0,0,0,0,0,0
"Catholic Charities, Diocese of Metuchen",12401,0,0,0,0,0,0,0
Trump Orgainzation,12371,0,0,0,0,0,0,0
e.Venue Tech,12403,0,0,0,0,0,0,0
Smuin Ballet,12805,0,0,0,0,0,0,0
The Phillips Club,12410,0,0,0,0,0,0,0
Master of Science in Global Finance,12301,0,0,0,0,0,0,0
Point Park University,12303,0,0,2,2,0,0,1
Town Hall Seattle,12939,0,0,0,0,0,0,0
The Dating Lab,12946,0,0,0,0,0,0,0
IBC Bank,12437,0,0,0,0,0,0,0
Furbush homestead inc.,12444,0,0,0,0,0,0,0
File-Extractor.com,12878,0,0,0,0,0,0,0
Lifesize Communications,12880,0,0,0,0,0,0,0
Calistoga Visitors Center and Calistoga Chamber of Commerce,12969,0,0,0,0,0,0,0
Porch & Patio,12971,0,0,0,0,0,0,0
Confucius Institute Online,13203,0,0,0,0,0,0,0
Spredfast,13346,0,0,0,0,0,0,0
"Vantage Media, LLC.",13237,0,0,0,0,0,0,0
Mushroom Bureau,13239,0,0,0,0,0,0,0
Skin Gentlemens Lounge,12837,0,0,1,1,0,0,1
"Irvine Pacific, L.P.",13073,0,0,0,0,0,0,0
Children of America,13005,0,0,0,0,0,0,0
Railey Mtn. Lake Vacations,12844,0,0,0,0,0,0,0
"CraftJack, Inc.",12592,1,0,0,1,1,0,0
Medicis Pharmaceutical Corporation,12624,0,0,0,0,0,0,0
C&A,1527,0,0,0,0,0,0,0
British Airways,1560,1,0,3,4,0.25,0,0.75
"Schwan's Home Service, Inc.",12005,0,0,0,0,0,0,0
Beauty Schools Marketing Group,12223,0,0,0,0,0,0,0
Aspen Dental,12492,0,0,0,0,0,0,0
"Build.com, Inc.",11505,2,0,1,3,0.666666667,0,0.333333333
Paralyzed Veterans of America,12541,0,0,0,0,0,0,0
"Northeast Georgia Health System, Inc.",12506,0,0,0,0,0,0,0
"L'Oreal USA Creative, Inc.",11905,0,0,1,1,0,0,1
"O'Reilly Media, Inc.",12556,0,0,0,0,0,0,0
Rasqal Coupons,12559,0,0,0,0,0,0,0
Awareness Technologies,12341,0,0,0,0,0,0,0
Penske Automotive Group,12342,0,0,0,0,0,0,0
That's My Boy Movie,12691,0,0,0,0,0,0,0
Provident Precious Metals,12255,0,0,0,0,0,0,0
Vet Ionx,12256,2,0,0,2,1,0,0
Roxley LLC,12641,0,0,0,0,0,0,0
Kingofweb.com,12642,0,0,0,0,0,0,0
American Health Care Association,12706,0,0,0,0,0,0,0
U.S. Space & Rocket Center,11937,0,0,0,0,0,0,0
Multiply,12656,0,0,0,0,0,0,0
Tea Living Inc.,12355,0,0,0,0,0,0,0
CANNON SAFE,12273,0,0,0,0,0,0,0
"Sam’s West, Inc.",12792,1,0,0,1,1,0,0
Charles Fine Furniture,12742,0,0,0,0,0,0,0
FAIRWINDS Credit Union,12288,0,0,0,0,0,0,0
Time and Gems.,12406,0,0,0,0,0,0,0
Mussel Industry Council of North America,12756,0,0,0,0,0,0,0
"Fila U.S.A., Inc.",12292,0,0,1,1,0,0,1
Star Career Academy,12810,0,0,0,0,0,0,0
"St. Vincent’s Medical Center, CT",12927,1,0,2,3,0.333333333,0,0.666666667
San Francisco Performances,12305,0,0,0,0,0,0,0
SeasonMall.com,12824,0,0,0,0,0,0,0
"Cleveland Beer Week, Inc.",12992,0,0,0,0,0,0,0
Portland Meadows,12959,0,0,0,0,0,0,0
American Photo,12960,0,0,0,0,0,0,0
"Invite Media, Inc.",12977,0,0,0,0,0,0,0
Kaine for Virginia,13192,0,0,0,0,0,0,0
Banyan Tree Infomedia LLP,13210,0,0,0,0,0,0,0
Lindsay Automotive Group,13227,0,0,0,0,0,0,0
STS Tire and Auto Centers,13342,0,0,0,0,0,0,0
Modern Office Furniture,13360,0,0,0,0,0,0,0
Piacci,13242,0,0,0,0,0,0,0
befloridian.org,13074,0,0,0,0,0,0,0
Siemens Product Lifecycle Management Software Inc.,13010,0,0,0,0,0,0,0
NAMCO BANDAI Games Inc.,13026,0,0,0,0,0,0,0
SAMM Sound Inc.,13079,0,0,0,0,0,0,0
Reply.com,13022,3,0,0,3,1,0,0
"Electric Cloud, Inc.",10944,0,0,0,0,0,0,0
Siemens,1518,0,0,0,0,0,0,0
International Expiditions,12465,0,0,0,0,0,0,0
National Council on Strength and Fitness,13084,0,0,0,0,0,0,0
St. Petersburg/Clearwater Area Convention & Visitors Bureau,13087,0,0,0,0,0,0,0
Military Advantage,11480,0,0,1,1,0,0,1
BizBash,13090,0,0,0,0,0,0,0
Wildlife Conservation Society,13092,0,0,0,0,0,0,0
The Stratford Shakespearean Festival of Canada,13707,0,0,0,0,0,0,0
Padopolis Inc,11882,0,0,0,0,0,0,0
"Runza National, Inc.",13710,0,0,0,0,0,0,0
DC Entertainment,11997,1,0,2,3,0.333333333,0,0.666666667
PGL,13097,0,0,0,0,0,0,0
Prometheus Movie,13039,0,0,0,0,0,0,0
Light In The Box Ltd,12216,21,0,1,22,0.954545455,0,0.045454545
Lucasfilm Entertainment Company Ltd.,13371,0,0,0,0,0,0,0
"McGoldrick Fuel, Inc.",10961,0,0,0,0,0,0,0
Mass Educational Financing Authority,12148,0,0,0,0,0,0,0
"Otsuka America Pharmaceutical, Inc.",12531,4,0,7,11,0.363636364,0,0.636363636
Gulf Coast Medical Center,10963,0,0,0,0,0,0,0
Premier Care in Bathing,13509,9,0,2,11,0.818181818,0,0.181818182
"Illumina, Inc.",12314,0,0,0,0,0,0,0
Mydegreeoptions.com,13109,0,0,0,0,0,0,0
Fund Raisers Ltd.,13651,0,0,0,0,0,0,0
King David's Restaurant,13110,0,0,0,0,0,0,0
Des Moines University,12014,0,0,0,0,0,0,0
Olde Towne Bicycles,13659,0,0,0,0,0,0,0
Mainers United for Marriage,13382,0,0,0,0,0,0,0
"Deja Vu Consulting, Inc.",13101,0,0,0,0,0,0,0
"BancVue, LTD.",13096,0,0,0,0,0,0,0
feelingoodtees.com,13375,0,0,0,0,0,0,0
University Bound Inc.,13653,0,0,0,0,0,0,0
Lippincott Williams & Wilkins,13038,0,0,0,0,0,0,0
City of Pacifica,13718,0,0,0,0,0,0,0
"internalDrive, Inc.",13086,0,0,0,0,0,0,0
New York Department of Economic Development,13037,0,0,0,0,0,0,0
"Brain Buster Enterprises, LLC.",13108,2,0,0,2,1,0,0
The Royal Society for the Protection of Birds,13045,0,0,0,0,0,0,0
Cleveland Zoological Society,13716,0,0,0,0,0,0,0
JLG Industries,13512,0,0,0,0,0,0,0
iSonea Ltd.,13739,0,0,0,0,0,0,0
"FA Management Enterprises, Inc.",13093,0,0,0,0,0,0,0
sleep-comfort.com,13372,0,0,0,0,0,0,0
CIS General Insurance Ltd,13744,0,0,0,0,0,0,0
Destination DC,13652,0,0,0,0,0,0,0
Insider Lifestyles,13308,0,0,0,0,0,0,0
Brookdale Senior Living Inc.,13050,1,0,1,2,0.5,0,0.5
Washington United for Marriage,13103,3,0,0,3,1,0,0
"Fruitlands Museum, Inc.",13053,0,0,0,0,0,0,0
Maryland Live! Casino,13253,0,0,1,1,0,0,1
UBinary,13052,0,0,0,0,0,0,0
Saint Leo University,13506,0,0,0,0,0,0,0
Bova Furniture,13115,0,0,0,0,0,0,0
Corban University,13520,0,0,0,0,0,0,0
Programs for Human Development,13654,0,0,0,0,0,0,0
"vente-privee USA Brands, Inc.",13521,0,0,0,0,0,0,0
Irvine Community Development Company LLC,13507,0,0,0,0,0,0,0
Olsons Garden Center,13118,0,0,0,0,0,0,0
ThriftQuote,13748,0,0,0,0,0,0,0
Norwalk Community College,13660,0,0,0,0,0,0,0
Shriners Hospitals for Children,13533,0,0,0,0,0,0,0
BMO InvestorLine Inc.,13517,11,1,4,16,0.6875,0.0625,0.25
"i-Health, Inc.",13812,0,0,0,0,0,0,0
Wells Fargo Center for the Arts,13528,0,0,0,0,0,0,0
Ameren Services,13780,7,0,0,7,1,0,0
"Motif Investing, Inc.",13043,1,0,1,2,0.5,0,0.5
Zoo Amphitheatre,13708,0,0,0,0,0,0,0
Strader's Garden Center,13792,0,0,0,0,0,0,0
Keswick Hall,13106,0,0,0,0,0,0,0
"Grand Pacific Resorts, Inc.",13518,0,0,0,0,0,0,0
Province of British Columbia,13305,0,0,1,1,0,0,1
RSA Insurance Group plc,13785,0,0,0,0,0,0,0
Iplay Enterprises,13113,0,0,0,0,0,0,0
"Premio Foods, INC",13801,0,0,0,0,0,0,0
"The Ritz-Carlton Hotel Company, L.L.C.",13782,0,0,1,1,0,0,1
Power4Home.com,13543,0,0,0,0,0,0,0
Gene Juarez Salons LLC.,13805,0,0,0,0,0,0,0
Norton Museum of Art,13656,1,0,0,1,1,0,0
Guy4game.com,13036,0,0,0,0,0,0,0
Daily Consumer Alerts,13669,0,0,0,0,0,0,0
"philosophy.com, inc.",13746,0,0,0,0,0,0,0
Bainbridge Graduate Institute,13047,1,0,0,1,1,0,0
Finish@UT,13121,0,0,0,0,0,0,0
Halifax Health,13671,0,0,0,0,0,0,0
Banana Hobby,13254,0,0,0,0,0,0,0
Manulife Financial Corporation,13391,2,0,2,4,0.5,0,0.5
usLifestyles.org,13444,0,0,0,0,0,0,0
Infiniti Dealerships,13539,4,1,0,5,0.8,0.2,0
Studio 3 Partners LLC.,13741,0,0,0,0,0,0,0
TrackTown USA,13694,0,0,0,0,0,0,0
Constellation Brands,13809,0,0,1,1,0,0,1
Dada.Pro,13403,0,0,0,0,0,0,0
"Elkhart Lake's Road America, Inc.",13044,0,0,0,0,0,0,0
"Kawasaki Motors Corp., U.S.A.",13781,0,0,0,0,0,0,0
Evangelical Christian Credit Union,13673,0,0,0,0,0,0,0
Fork Ltd.,13740,0,0,0,0,0,0,0
House Committee on Oversight and Government Reform,13664,0,0,0,0,0,0,0
Conner Prairie,13750,0,0,0,0,0,0,0
Mississippi Development Authority,13441,0,0,0,0,0,0,0
"Minuteman Press International, Inc.",13387,0,0,0,0,0,0,0
International Performing Arts Academy,13316,0,0,0,0,0,0,0
London and Cover,13309,0,0,0,0,0,0,0
National Marrow Donor Program,13808,0,0,0,0,0,0,0
University of California,13814,0,0,4,4,0,0,1
Freegamesforprizes.com,13869,1,0,0,1,1,0,0
Realty Store,13935,0,0,1,1,0,0,1
Mammoth Lakes Tourism,13314,6,0,0,6,1,0,0
Hammerhead Designs,13546,0,0,0,0,0,0,0
OFI Private Investments Inc.,13816,0,0,0,0,0,0,0
Confused.com,13530,0,0,0,0,0,0,0
"Spectrum Pharmaceuticals, Inc.",13961,0,0,0,0,0,0,0
Sara Lee Corporation,13405,0,0,0,0,0,0,0
Motor Home Specialist,13937,0,0,0,0,0,0,0
Two Trees Management Co. LLC,13107,0,0,0,0,0,0,0
Dave Delaney's Columbia,13256,0,0,0,0,0,0,0
Charleston Area Convention & Visitors Bureau,13448,0,0,1,1,0,0,1
Sovena Group USA,13504,0,0,0,0,0,0,0
"RE/MAX, LLC.",13526,0,0,0,0,0,0,0
Entertainment Industry Foundation,13407,11,0,1,12,0.916666667,0,0.083333333
Stonewall Resort,13545,0,0,0,0,0,0,0
Marathon Petroleum Corporation,13337,0,0,0,0,0,0,0
Spaulding Rehabilitation Network,13446,0,0,0,0,0,0,0
Northern and Shell Media Publications,13393,0,0,0,0,0,0,0
Ormco Corporation,13786,0,0,0,0,0,0,0
"Biola University, Inc.",13738,0,0,0,0,0,0,0
AskPCExperts,13389,0,0,0,0,0,0,0
Bombay High,13678,0,0,0,0,0,0,0
"Savvy Rest, Inc",13384,0,0,0,0,0,0,0
High Liner Foods,13858,0,0,0,0,0,0,0
Richard Petty Driving Experience,13409,0,0,0,0,0,0,0
"BRE Properties, Inc.",13524,0,0,0,0,0,0,0
Plentywatch.com,13311,0,0,0,0,0,0,0
Missouri Bank,13333,0,0,0,0,0,0,0
Udemy.com,13120,1,0,0,1,1,0,0
The Principal Charity Classic,13386,0,0,0,0,0,0,0
Sound Credit Union,13865,0,0,0,0,0,0,0
Sole Food,13111,0,0,0,0,0,0,0
Phones4u,13803,121,65,0,186,0.650537634,0.349462366,0
The Sporting Exchange Limited,13800,0,0,0,0,0,0,0
Pacific Marketing Associates,13658,0,0,0,0,0,0,0
"Canine Companies, Inc.",13538,0,0,0,0,0,0,0
Northwest Hot Spring Spa,13855,0,0,0,0,0,0,0
"The 88 San Jose (Wilson Meany, LLC)",14001,0,0,0,0,0,0,0
Eastman Chemical Company,13675,0,0,0,0,0,0,0
"VeriFone, Inc.",14010,0,0,0,0,0,0,0
Sovereign Bank,13339,0,0,0,0,0,0,0
Greater Morgantown Convention and Visitors Bureau,13933,0,0,0,0,0,0,0
Kearny Federal Savings Bank,13964,0,0,0,0,0,0,0
Brothers Bar & Grill,13783,0,0,0,0,0,0,0
prettypractical LLC,13329,0,0,0,0,0,0,0
BinaryDecoded,13434,0,0,0,0,0,0,0
Atlantic.Net,14003,0,0,0,0,0,0,0
Sevierville Chamber of Commerce,13965,0,0,0,0,0,0,0
Cincinnati USA CVB,13319,0,0,0,0,0,0,0
GOLFLAND ENTERTAINMENT CENTER. INC.,13682,0,0,0,0,0,0,0
HomeAntennas.com,13537,0,0,0,0,0,0,0
Carol’s Daughter,13687,0,0,0,0,0,0,0
"Extell Boston Harbor, LLC",14005,0,0,0,0,0,0,0
Deseret Book Company,13529,0,0,0,0,0,0,0
zdmcirc.com,14086,0,0,0,0,0,0,0
City of Golden,13306,0,0,0,0,0,0,0
Theamazonpost.com,13813,0,0,0,0,0,0,0
topwebsystem.com,13443,0,0,0,0,0,0,0
"LaPrairie.com, LLC",13435,2,0,1,3,0.666666667,0,0.333333333
MedStar Georgetown University Hospital,13929,0,0,0,0,0,0,0
FairSearch.org,13818,0,0,0,0,0,0,0
Infibeam.com,13336,0,0,0,0,0,0,0
Brittany Ferries,13962,0,0,0,0,0,0,0
"Delaware Management Holdings, Inc.",13968,0,0,0,0,0,0,0
Ivory Companies,13318,0,0,0,0,0,0,0
Bath Authority LLC,13817,0,0,0,0,0,0,0
Global Information Security,14075,0,0,0,0,0,0,0
The Franklin Institute,13684,0,0,0,0,0,0,0
Jones Beach Airshow,13390,0,0,0,0,0,0,0
"Publitek, Inc.",14009,4,0,0,4,1,0,0
LateRooms Ltd,13863,0,0,0,0,0,0,0
"Kalamazoo Outdoor Gourmet, LLC",13686,0,0,0,0,0,0,0
TruAudio,13549,0,0,0,0,0,0,0
Upper Peninsula Travel & Recreation Association,14016,0,0,0,0,0,0,0
Damn! LOL,13950,14,0,1,15,0.933333333,0,0.066666667
"Schwan’s Consumer Brands, Inc.",13335,0,0,0,0,0,0,0
Sun Life Assurance Company of Canada,14007,0,0,0,0,0,0,0
The New York Stock Exchange,13406,0,0,0,0,0,0,0
"Resource Nation, Inc.",14012,0,0,0,0,0,0,0
Cox Ohio Publishing,13942,0,0,0,0,0,0,0
SF Playhouse,13304,0,0,0,0,0,0,0
Epicor Software Corporation,14018,0,0,0,0,0,0,0
EMILY's List,14079,0,0,0,0,0,0,0
Geotradex.com,13672,0,0,0,0,0,0,0
Matrox Electronic Systems Ltd.,13397,0,0,0,0,0,0,0
Wyoming Office of Tourism,13815,0,0,1,1,0,0,1
"TRE MILANO, LLC",13322,0,0,0,0,0,0,0
American Television Alliance,14019,0,0,0,0,0,0,0
cbtl.com,13940,0,0,0,0,0,0,0
DSG Retail Limited,14076,0,0,0,0,0,0,0
movieplayerdownloads.com,14015,0,0,1,1,0,0,1
Function(x) Inc.,13083,0,0,0,0,0,0,0
Central Oregon Visitors Association,13100,0,0,0,0,0,0,0
City of Richmond,13717,0,0,1,1,0,0,1
yalosangeles.com,13051,0,0,0,0,0,0,0
"The NASDAQ OMX Group, Inc.",13719,4,0,0,4,1,0,0
Lennox Industries,13734,0,0,0,0,0,0,0
Seattle's Convention and Visitors Bureau,13519,3,0,1,4,0.75,0,0.25
Gerberkawasaki.com,13736,0,0,0,0,0,0,0
"Internet Order, LLC.",13383,4,0,0,4,1,0,0
Meru Networks,13119,0,0,0,0,0,0,0
driveandc.com,13385,0,0,0,0,0,0,0
A Little Bit Of Heaven Movie,13670,0,0,0,0,0,0,0
"Cricket Communications, Inc.",13436,36,21,1,58,0.620689655,0.362068966,0.017241379
National Trust,13402,0,0,0,0,0,0,0
Dignity Health,13819,0,0,0,0,0,0,0
Catchmethemusical.com,13317,0,0,0,0,0,0,0
San Diego Unified Port District,13936,0,0,0,0,0,0,0
Seneca Allegany Casino,13953,0,0,0,0,0,0,0
Academy of Television Arts and Sciences,14002,0,0,0,0,0,0,0
"CDS Global, Inc.",14087,2,0,6,8,0.25,0,0.75
Margaritaville Cargo,13094,0,0,0,0,0,0,0
Virgin Holidays Ltd.,13711,0,0,0,0,0,0,0
bestmindquiz.com,13040,0,0,0,0,0,0,0
Hayneedle Inc.,13712,0,0,0,0,0,0,0
The Pew Charitable Trusts,13508,0,0,0,0,0,0,0
iMemories,13376,0,0,0,0,0,0,0
Buick Dealerships,13726,23,3,1,27,0.851851852,0.111111111,0.037037037
Radiator Specialty Company,13729,1,0,1,2,0.5,0,0.5
Whitworth University,13661,2,4,0,6,0.333333333,0.666666667,0
Mark Warner Ltd.,13258,0,0,0,0,0,0,0
TIBCO Software Inc,13525,0,0,0,0,0,0,0
The First Academy,13662,0,0,0,0,0,0,0
DelBene for Congress,13793,0,0,0,0,0,0,0
Medical Mutual of Ohio,13743,0,0,0,0,0,0,0
"CityCenter Land, LLC",13394,0,0,0,0,0,0,0
GWPC & IOGCC,13811,0,0,0,0,0,0,0
the one campaign,13544,0,0,0,0,0,0,0
Caribou Coffee Company,13861,0,0,0,0,0,0,0
Positionly,13862,0,0,0,0,0,0,0
Edward Rose & Sons,13679,0,0,0,0,0,0,0
PAREXEL International Corporation,13926,0,0,0,0,0,0,0
AudienceScience Inc.,13408,0,0,0,0,0,0,0
FKM Agency,13325,0,0,0,0,0,0,0
Giorgio Armani S.p.A.,13693,0,0,0,0,0,0,0
Miami Herald Media Co.,13943,0,0,0,0,0,0,0
Satarii Inc.,13944,0,0,0,0,0,0,0
"MAINGEAR Inc,",13709,0,0,0,0,0,0,0
"The Men's Wearhouse, Inc.",13041,1,0,0,1,1,0,0
"Ditto Technologies, Inc.",13727,0,0,0,0,0,0,0
Transformyourpatch.com,13728,0,0,0,0,0,0,0
Wright Automotive Group,13378,0,0,0,0,0,0,0
Cakecafeatlanta.com,13310,0,0,0,0,0,0,0
Alchemy Collections,13442,0,0,0,0,0,0,0
"ART & FRAME DIRECT, INC",13859,0,0,0,0,0,0,0
Featherlite Trailers,13328,0,0,0,0,0,0,0
Stuart Weitzman,13695,0,0,1,1,0,0,1
CheapBooks,13946,0,0,0,0,0,0,0
Marlo Furniture,13963,0,0,1,1,0,0,1
ReverseOurMortgage,13502,0,0,0,0,0,0,0
"Procopio, Cory, Hargreaves & Savitch LLP",13049,0,0,0,0,0,0,0
STOXX,13117,0,0,0,0,0,0,0
Xactly Corporation,13787,0,0,0,0,0,0,0
MZA Events,13302,0,0,0,0,0,0,0
Katy Perry Part of Me Movie,13534,0,0,0,0,0,0,0
Premier Foods,13804,0,0,0,0,0,0,0
"Good Technology, Inc.",13751,0,0,1,1,0,0,1
getredakai.com,13400,0,0,0,0,0,0,0
Kelly-Moore Paints,13868,0,0,0,0,0,0,0
"University Athletic Assoc., Inc.",13870,0,0,0,0,0,0,0
The Gabriel Method PTY LTD.,13685,0,0,0,0,0,0,0
"EMCO Enterprises, Inc",13334,0,0,0,0,0,0,0
CariNet Inc.,13104,0,0,0,0,0,0,0
Albuquerque Journal,13054,0,0,0,0,0,0,0
BPP Holdings Limited,13515,0,0,0,0,0,0,0
"Cardo Systems, Inc.",13522,0,0,0,0,0,0,0
Twee's Candy,13540,0,0,0,0,0,0,0
KONI North America,13315,0,0,0,0,0,0,0
Aventure Sports Travel,13404,0,0,0,0,0,0,0
Washington Federal,13447,0,0,0,0,0,0,0
"Vidyo, Inc.",13690,0,1,1,2,0,0.5,0.5
"Luster Products, Inc.",13697,0,0,0,0,0,0,0
Vans Comfortemp,13947,0,0,0,0,0,0,0
Pine Hills LLC,13997,0,0,0,0,0,0,0
Geneva College,13958,0,0,0,0,0,0,0
Weigel Broadcasting Co.,14008,0,0,0,0,0,0,0
Northwest Community Healthcare,14083,0,0,0,0,0,0,0
"Ooyala, Inc.",13098,0,0,0,0,0,0,0
THOUGHT FREE GOLF,13721,0,0,0,0,0,0,0
Brand New Day NV,13730,0,0,0,0,0,0,0
Renomark.ca,13789,0,0,0,0,0,0,0
One Call Now,13666,0,0,0,0,0,0,0
The Natural Epicurean Academy of Culinary Arts,13123,0,0,0,0,0,0,0
Oregon Shakespeare Festival,13857,0,0,0,0,0,0,0
Sensory Spectrum Inc.,13925,0,0,0,0,0,0,0
WORLDVIEW TRAVEL,13321,0,0,0,0,0,0,0
"Health Management Solutions, Inc.",13323,0,0,0,0,0,0,0
Public Service Credit Union,13930,0,0,0,0,0,0,0
uTest Inc.,13934,0,0,0,0,0,0,0
Crown Motors Redding,13330,0,0,0,0,0,0,0
Max Bupa Health Insurance Company Limited,13332,0,0,0,0,0,0,0
King Jewelers Inc.,13700,0,0,0,0,0,0,0
Marine Club,13955,0,0,0,0,0,0,0
"Ken's Foods, Inc.",13959,0,0,0,0,0,0,0
Stevenson University,13714,0,0,0,0,0,0,0
Digicel,13046,0,0,0,0,0,0,0
Creaturefrombeyond.com,13048,0,0,0,0,0,0,0
my-video-downloader.com,13105,1,0,0,1,1,0,0
Western Seminary,13516,0,0,0,0,0,0,0
Georgetown County Tourism Management Commission,13380,0,0,0,0,0,0,0
Brand USA,13807,0,0,1,1,0,0,1
Madagascar 3 Movie,13541,0,0,0,0,0,0,0
PERFUMANIA.COM,13439,0,0,0,0,0,0,0
Todays Home,13548,0,0,0,0,0,0,0
Cardinal Health,13680,0,0,0,0,0,0,0
Breathe,13941,0,0,0,0,0,0,0
City Colleges of Chicago,13948,0,0,0,0,0,0,0
LendingClub,14084,0,0,0,0,0,0,0
Deutsche Telekom,13088,0,0,0,0,0,0,0
moneycontrol.com,13370,1,0,1,2,0.5,0,0.5
SellCell.com,13374,0,0,0,0,0,0,0
Blue Square Rank.com,13513,0,0,0,0,0,0,0
American Career Institute,13381,0,0,0,0,0,0,0
Devon Hill Motors,13788,0,0,0,0,0,0,0
The Lynde and Harry Bradley Foundation,13663,0,0,0,0,0,0,0
CruiseWise,13388,0,0,0,0,0,0,0
Getaheadofthegames.com,13799,0,0,0,0,0,0,0
West Hollywood Marketing & Visitors Bureau,13749,0,0,0,0,0,0,0
Corn Farmers Coalition,13438,0,0,0,0,0,0,0
The Barge,13856,0,0,0,0,0,0,0
ABBEY CARPET & FLOOR,13924,0,0,0,0,0,0,0
International Manufacturing Technology Show,13931,0,0,0,0,0,0,0
Enterfactory.com,13413,0,0,0,0,0,0,0
TD Bank Group,13331,17,1,3,21,0.80952381,0.047619048,0.142857143
Silver in the City,13338,0,0,0,0,0,0,0
"Old Second Bancorp, Inc.",14006,0,0,0,0,0,0,0
barrows-insurance.com,14074,0,0,0,0,0,0,0
BlogWorld,13377,0,0,0,0,0,0,0
"Five9, Inc.",13742,0,0,0,0,0,0,0
Austin CVB,13796,0,0,0,0,0,0,0
The Historic Harmony Inn,13259,0,0,0,0,0,0,0
HAIR CUTTERY,13745,0,0,0,0,0,0,0
City of Chicago,13392,0,0,0,0,0,0,0
"TOURICO HOLIDAY FLIGHTS, INC",13542,0,0,0,0,0,0,0
MetroCast Communications,13677,0,0,0,0,0,0,0
Vision Magazine,13927,0,0,0,0,0,0,0
Mercy College,13928,1,0,0,1,1,0,0
Cookiedustermusic.com,13410,0,0,0,0,0,0,0
"STAHL Plumbing, Heating & Air Conditioning, Inc.",13327,1,0,0,1,1,0,0
Women for Women International,13692,0,0,0,0,0,0,0
HowBooks.com,14077,0,0,0,0,0,0,0
PRO PERFORMANCE SPORTS LLC,14013,0,0,0,0,0,0,0
"Mobi PCS, Inc.",14078,0,0,0,0,0,0,0
Amelia Island Tourist Development Council,13095,0,0,0,0,0,0,0
Canvas Holidays Ltd,13724,0,0,0,0,0,0,0
Crescent Credit Union,13731,0,0,0,0,0,0,0
UAP Inc.,13531,0,0,0,0,0,0,0
Utah Shakespeare Festival,13674,0,0,0,0,0,0,0
Monmouth Park Racetrack,13313,0,0,0,0,0,0,0
Forced Air Inc,13681,0,0,0,0,0,0,0
Allscripts,13867,0,0,0,0,0,0,0
D-Dub Software,13449,0,0,0,0,0,0,0
rodenhiser.com,13324,0,0,0,0,0,0,0
"Blue Ion, LLC",13688,0,0,0,0,0,0,0
"INXPO, INC.",13949,2,2,0,4,0.5,0.5,0
Assured Guaranty Ltd.,13956,0,0,0,0,0,0,0
Jaguar Dealerships,13967,14,0,1,15,0.933333333,0,0.066666667
eDonor,14017,0,0,0,0,0,0,0
Regal Entertainment Group,13089,4,1,5,10,0.4,0.1,0.5
Stopthegastaxar.com,13723,0,0,0,0,0,0,0
FlyLaces,13725,0,0,0,0,0,0,0
FreeGamesList.net,13055,0,0,0,0,0,0,0
"Bath & Body Works Direct, Inc.",13657,5,4,0,9,0.555555556,0.444444444,0
Safety Not Guaranteed Movie,13255,0,0,0,0,0,0,0
Seattle Aquarium,13523,0,0,0,0,0,0,0
Dailyconsumerlifestyle.com,13257,0,0,0,0,0,0,0
Audi Dealerships,13798,30,11,6,47,0.638297872,0.234042553,0.127659574
Springfree Trampoline Inc.,13532,0,0,0,0,0,0,0
HID Global,13398,0,0,0,0,0,0,0
"Buy For Less, Inc.",13923,0,0,0,0,0,0,0
"Trion Worlds, Inc.",13864,0,0,0,0,0,0,0
Massachusetts Dental Society,13866,0,0,0,0,0,0,0
Community College of Beaver County,13932,1,0,0,1,1,0,0
American Lantern Press,13691,0,0,0,0,0,0,0
"Plante & Moran, PLLC",13696,0,0,0,0,0,0,0
DLT Solutions,13698,0,0,0,0,0,0,0
TASCHEN,14000,0,0,0,0,0,0,0
Herriman Towne Center,13957,0,0,0,0,0,0,0
WorthPoint Corporation,12497,0,0,0,0,0,0,0
"Current Worldwide, LLC",12233,0,0,0,0,0,0,0
Navy Yard Bistro and Wine Bar,11080,0,0,0,0,0,0,0
Gatestone Institute,13753,0,0,0,0,0,0,0
Cumberland Farms,13754,0,0,0,0,0,0,0
ArtsQuest Center,13756,0,0,0,0,0,0,0
"ABF U-Pack Moving, Inc.",13136,7,0,0,7,1,0,0
Cars Buyer Inc,13140,0,0,0,0,0,0,0
"Reznick Group, P.C.",13137,0,0,0,0,0,0,0
Pasco-Hernando Community College,13763,0,0,0,0,0,0,0
Boston Gay Men's Chorus,13138,0,0,0,0,0,0,0
Comparehealthinsurancenow.com,13765,0,0,0,0,0,0,0
University of Surrey,13139,0,0,0,0,0,0,0
PulteGroup. Inc.,13141,1,0,4,5,0.2,0,0.8
Myrtlebeachskywheel.com,13755,0,0,0,0,0,0,0
FindMeLove.com,13147,0,0,0,0,0,0,0
Broadcom Corporation,13766,0,0,0,0,0,0,0
Boyce College,13143,0,0,0,0,0,0,0
Ocracoke Business & Civic Association,13150,0,0,0,0,0,0,0
Six Flags Entertainment Corporation,13144,1,0,1,2,0.5,0,0.5
Pear Sports,13824,0,0,0,0,0,0,0
"Branchwater Productions, Inc.",13839,0,0,0,0,0,0,0
"Kaplan, Inc.",13847,0,0,2,2,0,0,1
"Red Robin International, Inc.",13842,6,0,2,8,0.75,0,0.25
Arlington Community Media Inc,13165,0,0,0,0,0,0,0
Alliance for a Better California,13835,0,0,0,0,0,0,0
Coro Realty Advisors,13152,0,0,0,0,0,0,0
Hackettstown Business Improvement District,13849,0,0,0,0,0,0,0
Wingate Inns International Inc.,13158,0,0,0,0,0,0,0
Friendship Dairies,13852,0,0,0,0,0,0,0
Dignified Caskets,13164,0,0,0,0,0,0,0
ASTROWAY Ltd,13833,1,0,0,1,1,0,0
The Fox Theatre,14149,0,0,0,0,0,0,0
waterfrontseattle.org,13151,0,0,0,0,0,0,0
Senate Conservatives Fund,14190,0,0,0,0,0,0,0
Welsh Pawn Shop,13843,0,0,0,0,0,0,0
CÉLINE,13850,0,0,1,1,0,0,1
"PlaySides, Inc.",14192,2,0,0,2,1,0,0
Kaiparasoft Limited,14182,0,0,0,0,0,0,0
Von Vonni,13840,0,0,0,0,0,0,0
Chicago Home Fitness,14184,0,0,0,0,0,0,0
SKLZ,13836,0,0,0,0,0,0,0
"AGC, LLC.",13854,0,0,0,0,0,0,0
STYLEFANTASIA LTD,14143,0,0,0,0,0,0,0
Harte-Hanks,14151,0,0,0,0,0,0,0
Texas.gov,13853,0,0,0,0,0,0,0
Jewish Community Center of Syracuse,13844,0,0,0,0,0,0,0
James Rollins,14176,0,0,0,0,0,0,0
hybrigenics,14152,0,0,0,0,0,0,0
Magic Mike Movie,14162,0,0,0,0,0,0,0
AmeriCU Credit Union,14157,0,0,0,0,0,0,0
Exploration Place,14171,0,0,0,0,0,0,0
PETA,14144,0,0,0,0,0,0,0
ApplianceSmart,14194,0,0,0,0,0,0,0
The Little Nell,14169,0,0,0,0,0,0,0
Hulu,14183,50,4,9,63,0.793650794,0.063492063,0.142857143
TILA MORTGAGE,14166,0,0,0,0,0,0,0
Dave & Buster's,14168,0,0,0,0,0,0,0
AllSaints,14201,2,0,0,2,1,0,0
Fellowship for the Performing Arts,14161,0,0,0,0,0,0,0
Copper River Salmon,14198,0,0,0,0,0,0,0
optimallyorganic.com,14186,0,0,0,0,0,0,0
Yakima Valley Visitors & Convention Bureau,14172,0,0,0,0,0,0,0
"Smith & Wollensky Restaurant Group, Inc.",13160,0,0,0,0,0,0,0
Brookhaven National Lab,14187,0,0,0,0,0,0,0
Phillips 66 Company,13828,0,0,1,1,0,0,1
Kapitall Inc.,14146,0,0,0,0,0,0,0
Dana-Farber/Brigham and Women’s Cancer Center,13768,0,0,0,0,0,0,0
UK FightLab Ltd.,13149,0,0,0,0,0,0,0
Florida Cancer Physicians Network,13821,0,0,0,0,0,0,0
Times Newspapers Ltd,13834,0,0,0,0,0,0,0
Seeking Justice Movie,13851,0,0,0,0,0,0,0
24wired.tv,14170,1,0,0,1,1,0,0
Shaw Media Inc.,13146,0,0,0,0,0,0,0
"County Records Research, Inc.",13148,0,0,0,0,0,0,0
The College of St. Scholastica,13848,6,0,0,6,1,0,0
Quizzino Limited,14148,0,0,0,0,0,0,0
Toronto Star Newspapers Limited,14173,1,0,0,1,1,0,0
Brightcove Inc.,14175,0,0,0,0,0,0,0
Wall Street Daily,13142,0,0,0,0,0,0,0
California Newspapers Partnership,13845,0,0,0,0,0,0,0
"CBRE, Inc.",13846,0,0,0,0,0,0,0
Greater Philadelphia Tourism Marketing Corporation,14178,0,0,0,0,0,0,0
Fox Restaurant Concepts,13831,1,0,0,1,1,0,0
MilesTek Corporation,13838,0,0,0,0,0,0,0
Riviera Hotel,14156,0,0,0,0,0,0,0
MacNeil Automotive Products Limited,14174,0,0,0,0,0,0,0
"PHE, Inc.",14181,0,0,0,0,0,0,0
Golden Route Operations,14199,0,0,0,0,0,0,0
Infirmary Health System,13155,0,0,0,0,0,0,0
"Central DuPage Health, Inc.",13823,0,0,0,0,0,0,0
121 Financial Credit Union,13830,0,0,1,1,0,0,1
Acuityads.com,13832,0,0,0,0,0,0,0
Facemyer Air Conditioning & Heating,14159,0,0,0,0,0,0,0
Washington State Patrol,14189,0,0,0,0,0,0,0
"Papa Murphy's International, LLC",13153,0,0,0,0,0,0,0
ASDA Stores Limited,13162,0,0,0,0,0,0,0
E-Nor Inc.,14164,0,0,0,0,0,0,0
One Reel,14191,42,6,0,48,0.875,0.125,0
The Hoffman Group,12514,0,0,0,0,0,0,0
GreaterGood Network,11512,0,0,0,0,0,0,0
Zuhu.com,12667,0,0,0,0,0,0,0
ComCorp of Texas Inc.,12516,0,0,0,0,0,0,0
Maracay Homes,12682,1,0,1,2,0.5,0,0.5
HalloweenAdventure.com,13971,0,0,0,0,0,0,0
"Anthem Insurance Companies, Inc.",12631,0,0,0,0,0,0,0
Rosamond Gifford Zoo,13169,0,0,0,0,0,0,0
AlviArmani,13171,0,0,0,0,0,0,0
Zendesk,12250,9,2,0,11,0.818181818,0.181818182,0
Century 21 Department Stores,14093,1,0,2,3,0.333333333,0,0.666666667
Ritz Camera & Image,12633,0,0,0,0,0,0,0
Blue Waters,13172,0,0,0,0,0,0,0
ftalk.com,14094,3,0,0,3,1,0,0
Vkidz,11929,0,0,0,0,0,0,0
Signum International,12893,0,0,0,0,0,0,0
Howard University,11931,0,0,0,0,0,0,0
PIttsburgh Zoo & PPG Aquarium,13176,0,0,0,0,0,0,0
Tucson Electric Power Company,13879,0,0,0,0,0,0,0
Martha Turner Properties,12895,0,0,0,0,0,0,0
BrandSource,14099,0,0,0,0,0,0,0
Hodgson Mill,12886,0,0,0,0,0,0,0
PotashCorp,13994,0,0,0,0,0,0,0
City of Mesa,13872,0,0,0,0,0,0,0
Indian Ranch,13980,0,0,0,0,0,0,0
Datefaithful.com,13576,0,0,0,0,0,0,0
secondsandsurplus.com,13986,0,0,0,0,0,0,0
"Mizkan Americas, Inc.",14097,0,0,0,0,0,0,0
Panama City Beach Convention and Visitors Bureau,13883,0,0,0,0,0,0,0
"SearchApps, Inc.",13180,0,0,0,0,0,0,0
JOYFORT ENTERTAINMENT LIMITED,13884,0,0,0,0,0,0,0
Park Springs Communities,14095,0,0,0,0,0,0,0
City of Houston,13890,0,0,0,0,0,0,0
Urban Planet Media & Entertainment,13882,0,0,0,0,0,0,0
LolaSabe,14226,0,0,0,0,0,0,0
First Data Merchant Services Corporation,13178,0,0,0,0,0,0,0
Brothers International Food Corporation,13976,0,0,0,0,0,0,0
BBK Worldwide,13182,0,0,0,0,0,0,0
Creafi Online Media,14233,1,0,0,1,1,0,0
Center of Science and Industry,14091,0,0,0,0,0,0,0
Germany Trade & Invest,13993,0,0,0,0,0,0,0
"Nerve.com, Inc",14294,0,0,0,0,0,0,0
"Together Rx Access, LLC.",13992,0,0,0,0,0,0,0
Iron Horse Auction Company,14111,0,0,0,0,0,0,0
SureWest Communications,14301,0,0,0,0,0,0,0
Hostly.com,12901,0,0,0,0,0,0,0
"AFC Enterprises, Inc.",13581,0,0,0,0,0,0,0
"IgnitionOne, Inc.",13880,0,0,0,0,0,0,0
TECO Energy,13184,0,0,1,1,0,0,1
EFFS,13886,0,0,0,0,0,0,0
San Francisco SPCA,13582,0,0,0,0,0,0,0
ATI Career Training Center,14100,0,0,0,0,0,0,0
Vancouver Film School,14222,0,0,0,0,0,0,0
AdExtent,14229,0,0,0,0,0,0,0
Minwax Company,13888,0,0,0,0,0,0,0
FASTSIGNS® International. Inc.,13891,0,0,0,0,0,0,0
puzzlezonegames.com,12908,2,0,0,2,1,0,0
"New England Research Associates, LLC",14107,0,0,0,0,0,0,0
RugsUSA.com Inc.,12913,0,0,0,0,0,0,0
NineSigma,13970,0,0,0,0,0,0,0
kinkbmx.com,14303,0,0,0,0,0,0,0
MiTAC International Corporation,12912,1,0,0,1,1,0,0
Deloitte LLP,13900,0,0,1,1,0,0,1
sharpfanlabs.com,14239,0,0,0,0,0,0,0
"Thomas Nelson, Inc.",12914,4,1,0,5,0.8,0.2,0
SpeedyPC.com,14025,0,0,1,1,0,0,1
International Data Group (IDG),14230,0,0,0,0,0,0,0
"Spanx, Inc.",12903,0,0,0,0,0,0,0
HighTable,14297,0,0,0,0,0,0,0
Warner Bros. Shop,12885,0,0,0,0,0,0,0
DHL International,14235,0,0,0,0,0,0,0
Lee County Government,12904,0,0,0,0,0,0,0
San Jose Downtown Association,13985,0,0,0,0,0,0,0
Kahuna Creations,14232,0,0,0,0,0,0,0
Kelsidagger.com,14237,0,0,0,0,0,0,0
Hiway Federal Credit Union,12891,0,0,0,0,0,0,0
Asia TV USA Ltd.,14231,0,0,0,0,0,0,0
"Oakley, Inc.",14298,0,0,0,0,0,0,0
Xsilva Systems Inc.,13572,0,0,0,0,0,0,0
Minnesota Zoo,14026,0,0,0,0,0,0,0
Ristorante Fratelli Milano,14115,0,0,0,0,0,0,0
Fury Water Adventures,14300,0,0,0,0,0,0,0
"Signeo USA, LLC",14022,0,0,0,0,0,0,0
The Providence Warwick Convention & Visitors Bureau,14240,0,0,1,1,0,0,1
NewHope Surgery Center,14251,0,0,0,0,0,0,0
Maple Leaf Sports and Entertainment Ltd.,14109,0,0,0,0,0,0,0
Ruby Lane Inc.,14102,0,0,1,1,0,0,1
Borgess Health,12905,0,0,0,0,0,0,0
freeproducttesters.com,13877,0,0,0,0,0,0,0
ModelMayhem.com,14299,0,0,0,0,0,0,0
Jim Collins,13177,0,0,0,0,0,0,0
Middleburg Bank,13878,0,0,0,0,0,0,0
H&H Shooting Sports Complex,13995,0,0,0,0,0,0,0
Open Hospitality Inc.,13573,0,0,0,0,0,0,0
Mercy Gilbert Medical Center,14116,0,0,0,0,0,0,0
gloriaferrer.com,14241,0,0,0,0,0,0,0
Pool City Inc.,14243,0,0,0,0,0,0,0
Avanade Inc.,13185,0,0,0,0,0,0,0
Willy Bogner GmbH & Co.,13578,0,0,0,0,0,0,0
thewindflower.com,14021,0,0,0,0,0,0,0
"Dealerdotcom, Incorporated.",12915,8,0,0,8,1,0,0
LeMay - America's Car Musuem,12910,0,0,0,0,0,0,0
Sporting Index,14296,0,0,0,0,0,0,0
Nova Scotia Tourism & Culture,14246,0,0,0,0,0,0,0
Rack N Road,14248,0,0,0,0,0,0,0
Sea Tow International,13770,0,0,0,0,0,0,0
Darcy Burner for Congress,14155,0,0,0,0,0,0,0
indirectpurchasersfiltersettlement.com,14185,0,0,0,0,0,0,0
servcoauto.com,14202,0,0,0,0,0,0,0
"Ameriprise Financial, Inc.",13168,0,0,0,0,0,0,0
Fairmont Hotels & Resorts,12900,1,0,1,2,0.5,0,0.5
Comet Group Ltd,14104,0,0,0,0,0,0,0
"Elkhart Lake, WI",13183,0,0,0,0,0,0,0
alzheimersresearchstudy.com,13551,0,0,0,0,0,0,0
NC Quick Pass,14304,0,0,1,1,0,0,1
Atlanta Convention & Visitors Bureau,13170,0,0,0,0,0,0,0
The International Business Times Inc.,12888,0,0,0,0,0,0,0
NITESH ESTATES,13981,0,0,0,0,0,0,0
GMAR Home & Garden Show,13181,0,0,0,0,0,0,0
"Amrep, Inc.",12906,0,0,1,1,0,0,1
KingIce.com,13574,0,0,1,1,0,0,1
Washington BID,13899,0,0,0,0,0,0,0
Arizona Central Credit Union,14117,0,0,0,0,0,0,0
River to River Festival,14024,0,0,0,0,0,0,0
"Daylife, Inc.",14031,0,0,0,0,0,0,0
Emerson Hospital,13759,0,0,0,0,0,0,0
OR Books,13760,0,0,0,0,0,0,0
ShowClix,13159,0,0,0,0,0,0,0
National Association for Gun Rights,14145,7,0,0,7,1,0,0
Pactimo,14160,1,0,0,1,1,0,0
Union Pacific Railroad Company,14163,0,0,0,0,0,0,0
"Rainmaker Systems, Inc.",13978,0,0,0,0,0,0,0
TrueBlue Interactive,13577,0,0,0,0,0,0,0
Luminato,12909,0,0,0,0,0,0,0
The Little America Hotel,14027,0,0,0,0,0,0,0
Shannon Fine Jewelry,14228,0,0,0,0,0,0,0
Dark Horse Movie,13973,0,0,0,0,0,0,0
Trader Publishing Limited,13975,0,0,0,0,0,0,0
Pepco,13984,0,0,0,0,0,0,0
IC INTRACOM,13873,0,0,0,0,0,0,0
Sigma Enterprises LLC.,13571,0,0,0,0,0,0,0
"IntraLinks, Inc.",14114,0,0,0,0,0,0,0
Nitto Tire U.S.A. Inc.,13580,0,0,0,0,0,0,0
Channel Four Television Corporation,14250,0,0,0,0,0,0,0
shoeandsneakerbarn.com,13974,0,0,0,0,0,0,0
Central New York Business Journal,14092,0,0,0,0,0,0,0
"LeapFrog Enterprises, Inc.",13874,0,0,1,1,0,0,1
Hotels of Oak Brook,13881,0,0,0,0,0,0,0
LOVEFiLM UK Ltd.,14106,0,0,0,0,0,0,0
"TriNet Group, Inc.",13892,0,0,0,0,0,0,0
Mr & Mrs Smith,14224,0,0,0,0,0,0,0
Team Superstores,14292,0,0,0,0,0,0,0
"Museum of Science, Boston",14249,2,0,0,2,1,0,0
Behr Process Corporation,12889,0,0,0,0,0,0,0
Payless Car Rental,14098,4,1,0,5,0.8,0.2,0
BigSoccerCamp.com,13991,0,0,0,0,0,0,0
Fitness Together,12896,0,0,0,0,0,0,0
Equipment Locator Service,13898,0,0,0,0,0,0,0
MyPublisher Inc.,14023,0,0,0,0,0,0,0
LovePastry.com,14223,0,0,0,0,0,0,0
ESADE Business School,14225,0,0,0,0,0,0,0
Vapor4Life,14293,1,0,1,2,0.5,0,0.5
St. Tammany Parish Hospital,14034,0,0,0,0,0,0,0
NV Energy,14089,0,0,0,0,0,0,0
New Mexico Department of Tourism,13889,0,0,0,0,0,0,0
Smart Deploy,13187,0,0,0,0,0,0,0
WaterAid,14032,0,0,0,0,0,0,0
United Auto Insurance,14234,1,0,0,1,1,0,0
Centennial Bancorp,12565,0,0,0,0,0,0,0
Playwrights Foundation,14441,0,0,0,0,0,0,0
The Washington Newspaper Publishing Company LLC ,14401,0,0,0,0,0,0,0
REMAX Kentucky-Tennessee,14374,0,0,0,0,0,0,0
Panhandle Productions LP,14361,0,0,0,0,0,0,0
Album DS Design Software,13705,0,0,0,0,0,0,0
U.S. Highbush Blueberry Council,14366,0,0,0,0,0,0,0
Renault,14369,0,0,0,0,0,0,0
"WS-COS, LLC.",14448,0,0,0,0,0,0,0
NCI Company,14402,0,0,0,0,0,0,0
Encore Career Institute,14383,0,0,0,0,0,0,0
Regional Planning Commission of Greater Birmingham,14392,0,0,0,0,0,0,0
Info Publishing Masterplan,14380,0,0,0,0,0,0,0
Maritime Motors of Fairfield,14450,0,0,0,0,0,0,0
National Express Ltd,14417,0,0,0,0,0,0,0
"Fraser Partners, LLC.",14398,0,0,0,0,0,0,0
Ice Age Movie,14404,0,0,0,0,0,0,0
"Leisure Sports, Inc.",14362,0,0,0,0,0,0,0
JustinBiebersGirlfriend.com,14390,0,0,0,0,0,0,0
Smart Life Weekly,14397,0,0,0,0,0,0,0
Reiss,14400,0,0,0,0,0,0,0
DG International,14425,1,0,0,1,1,0,0
Harborstone Credit Union,14403,0,0,0,0,0,0,0
Tate,14408,0,0,0,0,0,0,0
Stanford Jazz Workshop,14424,0,0,0,0,0,0,0
"Emerald Isle Realty, Inc.",14452,0,0,0,0,0,0,0
Merlin Entertainments Group Attraction,14430,0,0,0,0,0,0,0
National Wildlife Federation,14427,0,0,0,0,0,0,0
"TicketLeap, Inc.",14433,0,0,0,0,0,0,0
ftfeedbackforum.com,14379,0,0,0,0,0,0,0
"C.F. Martin & Co., Inc.",14440,0,0,0,0,0,0,0
Pharmdaily.com,14363,0,0,0,0,0,0,0
Special Events Management,14373,0,0,0,0,0,0,0
"Travelpro International, Inc.",14378,0,0,0,0,0,0,0
California Chamber of Commerce,14411,0,0,0,0,0,0,0
The New York Racing Association,14413,0,0,0,0,0,0,0
Solemates LLC,14371,0,0,0,0,0,0,0
"Abercrombie & Kent, Inc.",14444,0,0,0,0,0,0,0
Temasek International,14414,0,0,0,0,0,0,0
American Financing Corporation,14420,0,0,0,0,0,0,0
Closet World,14451,0,0,0,0,0,0,0
Direct Holdings Americas Inc.,14429,0,0,0,0,0,0,0
Summer Bay Resort,14436,0,0,0,0,0,0,0
"ConAgra Foods, Inc.",14375,1,0,6,7,0.142857143,0,0.857142857
Avidia Bank,14384,0,0,0,0,0,0,0
Avid Home Theater,14407,0,0,0,0,0,0,0
gamestock2012.com,14437,0,0,0,0,0,0,0
Atout France,14405,0,0,0,0,0,0,0
Mazzaros Italian Market,14439,0,0,0,0,0,0,0
Colony BMX,14416,0,0,0,0,0,0,0
North Central Texas Council of Governments,14422,0,0,0,0,0,0,0
GetLocalDentist,14418,0,0,0,0,0,0,0
"WEBZEN, INC.",14443,0,0,0,0,0,0,0
Ford Dealerships,13758,11,0,12,23,0.47826087,0,0.52173913
Taproot Theatre,13154,0,0,0,0,0,0,0
Palmetto State Armory,13822,0,0,0,0,0,0,0
To Rome with Love Movie,14165,0,0,0,0,0,0,0
The Tupelo Convention & Visitors Bureau,13972,0,0,0,0,0,0,0
U K Insurance Limited,14090,0,0,0,0,0,0,0
Glock Ges.m.b.H.,13983,10,3,0,13,0.769230769,0.230769231,0
IQAir,14101,0,0,0,0,0,0,0
Voter Logistics Inc.,14108,0,0,0,0,0,0,0
101Panda,13897,0,0,0,0,0,0,0
FXORO,13583,0,0,0,0,0,0,0
Newfoundland & Labrador Tourism,12911,0,0,0,0,0,0,0
Chesapeake Bank of Maryland,14365,0,0,0,0,0,0,0
Window-Price.com,14415,0,0,0,0,0,0,0
Bridgeport Hospital,12902,1,0,0,1,1,0,0
The Greater Hartford Community Foundation,13887,0,0,0,0,0,0,0
Vitals.com,14236,0,0,0,0,0,0,0
The Steamship Authority,14302,0,0,0,0,0,0,0
"Plixer International, Inc.",14238,0,0,0,0,0,0,0
Bluejeanscable.com,13704,0,0,0,0,0,0,0
The American Center for Spine & Neurosurgery,14372,0,0,0,0,0,0,0
Hollywood & Wine at Arizona Biltmore,14387,0,0,0,0,0,0,0
"Redstate, Inc.",14389,0,0,0,0,0,0,0
"Peter Piper, Inc.",14406,0,0,0,0,0,0,0
Consumer Lifestyles,13761,6,0,1,7,0.857142857,0,0.142857143
MetroTix Inc.,13762,0,0,0,0,0,0,0
TheCancerYouCanPrevent.org,13161,0,0,0,0,0,0,0
Town Center Bike & Tri,13829,0,0,0,0,0,0,0
Salomonsson Agency,14179,0,0,0,0,0,0,0
Purolator Filters NA LLC,14180,0,0,0,0,0,0,0
Name.com LLC,14197,0,0,0,0,0,0,0
LGS Innovations,13979,0,0,0,0,0,0,0
Voyages of Discovery,13175,0,0,0,0,0,0,0
Carnet Atlantique.com,13876,0,0,0,0,0,0,0
Ellis Sothebys International Realty,13893,0,0,0,0,0,0,0
Mitsubishi Dealerships,14112,5,0,0,5,1,0,0
Pritikin Longevity Center + Spa,12907,0,0,0,0,0,0,0
Sonoa Healthcare Group,14247,0,0,0,0,0,0,0
Reckitt Benckiser Pharmaceuticals Inc.,14394,17,1,6,24,0.708333333,0.041666667,0.25
"InsWeb, Inc.",14412,0,0,0,0,0,0,0
Penn's Landing Corporations,14447,0,0,0,0,0,0,0
"Videotel, Inc.",13977,0,0,0,0,0,0,0
Blair LLC,14096,0,0,0,0,0,0,0
All The Webs Information,13174,0,0,0,0,0,0,0
State of New York,12892,2,0,0,2,1,0,0
Zoological Society of Florida,14110,0,0,0,0,0,0,0
AppRiver,13996,0,0,0,0,0,0,0
Stay Aspen Snowmass,13895,0,0,0,0,0,0,0
Sideshow Inc,13896,0,0,1,1,0,0,1
Repsol,14360,0,0,0,0,0,0,0
Copenhagen Imports,14367,0,0,0,0,0,0,0
blinkbox Entertainment Limited,14385,0,0,0,0,0,0,0
"Gentle Giant Studios, Inc.",14399,0,0,0,0,0,0,0
Jazz Arts Group,14435,0,0,0,0,0,0,0
"PAUL MILLER AUTO GROUP, LLC",14449,0,0,1,1,0,0,1
Factory Effex,14359,0,0,0,0,0,0,0
"AccountNow, Inc.",14368,0,0,0,0,0,0,0
"Worldwide Golf Enterprises, Inc.",13706,0,0,0,0,0,0,0
Successful Online Stores,14410,0,0,0,0,0,0,0
Cherokee Nation,14364,0,0,0,0,0,0,0
"Mitsubishi Electric Visual Solutions America, Inc.",14377,0,0,0,0,0,0,0
"Eight Factors, Inc.",14395,0,0,0,0,0,0,0
University of Southern California Marshall School of Business,14446,0,0,0,0,0,0,0
Save North Texas Water,14370,0,0,0,0,0,0,0
San Jose Repertory Theatre,14419,0,0,0,0,0,0,0
primesport.com,14421,3,0,0,3,1,0,0
Dean College,14453,1,0,0,1,1,0,0
"25 Hill Akron Filmworks, LLC.",14391,0,0,0,0,0,0,0
P&O Ferries,14393,0,0,0,0,0,0,0
NewYork-Presbyterian Hospital,14423,1,0,0,1,1,0,0
Lifted Research Group,14432,0,0,0,0,0,0,0
Gillibrand for Senate,12701,0,0,0,0,0,0,0
"New Dream Network, LLC",12567,3,0,0,3,1,0,0
Lens.com,12650,0,0,0,0,0,0,0
Puerto Vallarta Convention and Visitors Bureau,14254,0,0,0,0,0,0,0
Language Stars,12716,0,0,0,0,0,0,0
Parrot SA,14257,6,0,0,6,1,0,0
Dollar Shave Club,14258,0,1,0,1,0,1,0
"DataSphere Technologies, Inc.",14261,0,0,1,1,0,0,1
Guardian News and Media Limited,12718,0,0,1,1,0,0,1
Boardwalk Automall,14263,0,0,0,0,0,0,0
Food Network New York City Wine & Food Festival,14262,0,0,1,1,0,0,1
FOOTASYLUM Limited,14210,0,0,0,0,0,0,0
AirTran Airways,12582,0,0,0,0,0,0,0
Link Control,12584,0,0,0,0,0,0,0
"Millennium Pharmaceuticals, Inc.",14269,1,0,0,1,1,0,0
Ambiente International,14122,0,0,0,0,0,0,0
Davinci Virtual Office Space & Solutions,12665,0,0,0,0,0,0,0
Crossroads Bellevue,14215,0,0,0,0,0,0,0
BROKEN ARROW PERFORMING ARTS CENTER,12397,0,0,0,0,0,0,0
"Mahindra, USA",12367,0,0,0,0,0,0,0
WAMC Public Radio,14277,0,0,0,0,0,0,0
westfieldsmiles.com,12850,0,0,0,0,0,0,0
MYA,13908,0,0,0,0,0,0,0
Metropolitan Builders Association,14128,0,0,0,0,0,0,0
Carpet One Floor & Home,12818,0,0,0,0,0,0,0
trynono.com,14126,5,1,1,7,0.714285714,0.142857143,0.142857143
DateFree,12767,0,0,1,1,0,0,1
Mattress Warehouse,14279,1,0,0,1,1,0,0
Solar Universe Inc.,14267,0,0,0,0,0,0,0
Fischer Homes Inc,14207,0,0,2,2,0,0,1
BASF SE,13778,1,1,1,3,0.333333333,0.333333333,0.333333333
"Restava, Inc.",14214,0,0,0,0,0,0,0
Great Expectations Seattle,13906,0,0,0,0,0,0,0
CupCakeRoyale.com,14208,0,0,0,0,0,0,0
Sagicor Life Insurance Company,14218,0,0,0,0,0,0,0
Southern Lumber Company,13911,0,0,0,0,0,0,0
Starpower,14283,0,0,0,0,0,0,0
Edelman Financial Services LLC,13907,1,0,0,1,1,0,0
endless.com,14120,0,0,0,0,0,0,0
National Gold Group Corporation,14125,0,0,0,0,0,0,0
Dick Scott Automotive Group,14139,0,0,0,0,0,0,0
murfie.com,13903,0,0,0,0,0,0,0
PageCovers.com,14276,0,0,0,0,0,0,0
Chene Park Amphitheater,14220,0,0,0,0,0,0,0
"Alclear, LLC.",14129,0,0,0,0,0,0,0
Vermont Department of Tourism and Marketing,13590,0,0,0,0,0,0,0
Homemakers Furniture Inc.,13599,0,0,0,0,0,0,0
Rewards on the Go Customer Service,14130,0,0,0,0,0,0,0
"Community Healthcare System, Indiana",14280,0,0,0,0,0,0,0
Royal & Sun Alliance Insurance plc,14272,0,0,0,0,0,0,0
The HEAT Group,14216,0,0,0,0,0,0,0
Lexus Dealerships,14288,3,0,1,4,0.75,0,0.25
Exercise Equipment Northwest,13561,0,0,0,0,0,0,0
Apple Air Inc.,13559,0,0,0,0,0,0,0
Fox Head Inc.,14282,0,0,0,0,0,0,0
Optyx,13776,0,0,0,0,0,0,0
Onwax Media Holdings Corp.,13614,0,0,0,0,0,0,0
"Offshore Sailing, Ltd.",14121,0,0,0,0,0,0,0
cableandgauge.com,13554,0,0,0,0,0,0,0
Buy Real Marketing,14643,0,0,0,0,0,0,0
Petro,14479,0,0,0,0,0,0,0
The Grand Island Independent,14135,0,0,0,0,0,0,0
Getnow.com,13597,0,0,0,0,0,0,0
The Royal Navy,13601,0,0,0,0,0,0,0
"Cosmetic & Family Dentistry by Dwoskin, Owens & Fortino",13920,0,0,0,0,0,0,0
"LeafFilter North, Inc.",13560,0,0,0,0,0,0,0
TotalBank,14488,0,0,0,0,0,0,0
"Eatwise Rx, LLC",13604,0,0,0,0,0,0,0
Bluenote Jazz Festival,13555,0,0,0,0,0,0,0
BEAUFORT COUNTY SCHOOLS,14471,0,0,0,0,0,0,0
videolistger.com,14140,0,0,0,0,0,0,0
"EvoShield, LLC.",14561,0,0,0,0,0,0,0
Stony Brook University,14582,0,0,0,0,0,0,0
Tech Waste Recycling,14469,0,0,0,0,0,0,0
Liebherr-International AG,13603,0,0,0,0,0,0,0
Watkins Glen International,14597,0,0,0,0,0,0,0
Oregon.gov,14290,0,0,0,0,0,0,0
healthierlivingtips.com,14571,0,0,0,0,0,0,0
ChatZum,13608,0,0,0,0,0,0,0
David's Survival,14219,0,0,0,0,0,0,0
Public Storage,14284,0,0,0,0,0,0,0
Hello!Lucky,14458,0,0,0,0,0,0,0
Shelter,14512,0,0,0,0,0,0,0
Another Planet Entertainment,14137,0,0,0,0,0,0,0
"Jackson Design and Remodeling, Inc.",13596,0,0,0,0,0,0,0
ECHO Bear Cat,14679,0,0,0,0,0,0,0
LSI Corporation,13602,0,0,0,0,0,0,0
"Enigma Software Group USA, LLC.",13773,1,0,0,1,1,0,0
"Freakonomics, LLC.",13615,0,0,0,0,0,0,0
bakebakebake.livejournal.com,13606,0,0,0,0,0,0,0
The Long Center for the Performing Arts,13775,0,0,0,0,0,0,0
P&J Custom Window Coverings,14637,0,0,0,0,0,0,0
ii2P L.L.C,14461,0,0,0,0,0,0,0
Pioneer Press,14553,0,0,0,0,0,0,0
"Razzle Enterprises, LLC",14551,0,0,0,0,0,0,0
workopolis.com,13605,0,0,0,0,0,0,0
RudeFinder.com,14456,0,0,0,0,0,0,0
Vision Airlines,14142,0,0,0,0,0,0,0
Room 77,13619,1,0,0,1,1,0,0
ontdgames.livejournal.com,13607,0,0,0,0,0,0,0
Classical South Florida,13618,0,0,0,0,0,0,0
Doba,14639,0,0,0,0,0,0,0
Refidesk,14911,0,0,0,0,0,0,0
Cinema Blend LLC,14141,0,0,0,0,0,0,0
Arkansas State University,14572,0,0,0,0,0,0,0
Johnson & Johnson Inc.,14654,0,0,9,9,0,0,1
Horizons Exchange Traded Funds Inc.,13609,0,0,0,0,0,0,0
"Resolution, Inc.",13620,0,0,0,0,0,0,0
RED WHITE AND BLUE AUTO SALES,14680,0,0,0,0,0,0,0
"Fart O Gram (Savant Marketing, LLC)",14703,0,0,0,0,0,0,0
"Obentec, Inc.",14486,0,0,0,0,0,0,0
Drugs.com,14550,1,0,0,1,1,0,0
BC Greenhouse Builders Ltd,14924,0,0,0,0,0,0,0
Lighthouserecording.com,14462,0,0,0,0,0,0,0
Multiple Health Research,14920,0,0,0,0,0,0,0
DeMarini Sports Inc.,14988,0,0,0,0,0,0,0
Meebo,14586,0,0,0,0,0,0,0
"Karla Robinson Realty, Inc.",14829,0,0,0,0,0,0,0
MyDentistMatches,14132,0,0,0,0,0,0,0
"Healthy Directions, LLC",14560,0,0,0,0,0,0,0
One Kish Hospital,14478,0,0,0,0,0,0,0
NW Chocolate Festival & NW Coffee Festival 2012,14644,0,0,0,0,0,0,0
"Pandora Jewelry, LLC",14503,6,0,2,8,0.75,0,0.25
RussianBrides.com,14558,0,0,0,0,0,0,0
Bemidji State University,14915,0,0,0,0,0,0,0
Bayer HealthCare LLC.,14552,20,2,8,30,0.666666667,0.066666667,0.266666667
Loehmann's Inc.,14291,0,0,0,0,0,0,0
"Chesapeake Fine Food Group, LLC.",14635,0,0,0,0,0,0,0
Sparkle Movie,14634,0,0,0,0,0,0,0
us.audio-schools.com,14501,0,0,0,0,0,0,0
"AV Science, Inc.",14585,1,0,0,1,1,0,0
"MovieWeb, Inc.",14491,0,0,0,0,0,0,0
"Viator, Inc.",14510,0,0,0,0,0,0,0
"Braddock & Logan Services, Inc.",14576,0,0,0,0,0,0,0
Rock Star Real Estate Inc.,14975,1,0,0,1,1,0,0
Hackensack University Medical Center,14589,0,0,0,0,0,0,0
Safecap Investments Limited,14517,0,0,1,1,0,0,1
Cogburn Law Offices,14671,0,0,0,0,0,0,0
"Gilt Groupe, Inc.",14464,38,3,2,43,0.88372093,0.069767442,0.046511628
Palm Beach National,14583,0,0,0,0,0,0,0
Capt. Anderson's,13454,0,0,1,1,0,0,1
"Remedy Health Media, LLC.",14629,1,0,0,1,1,0,0
"Klaff's, Inc.",14853,0,0,0,0,0,0,0
Crown Center,13630,1,0,0,1,1,0,0
"Big Green Egg, Inc.",14670,2,0,0,2,1,0,0
"Old Forge Properties, Inc.",14658,0,0,0,0,0,0,0
msn,14652,2,1,0,3,0.666666667,0.333333333,0
Tweaks Software,14676,0,0,0,0,0,0,0
"DBH Worldwide, LLC.",14675,0,0,0,0,0,0,0
SavingsOnDeals.net,14502,0,0,0,0,0,0,0
Kimball Art Center,14837,0,0,0,0,0,0,0
The Wooden Duck,14630,0,0,0,0,0,0,0
Gala Interactive,14672,0,0,0,0,0,0,0
Pennsylvania Coal Alliance,14683,0,0,0,0,0,0,0
Citizens for Transportation Mobility,14591,0,0,0,0,0,0,0
Mystic Country,14852,0,0,0,0,0,0,0
Ducati Bellevue,14631,0,0,0,0,0,0,0
FreeBird Chicken,13625,0,0,0,0,0,0,0
"Aedge Performance BCN, S.L.U.",14910,0,0,0,0,0,0,0
Ironstone Vineyards,13468,0,0,0,0,0,0,0
NoSQL Now! Conference,14651,0,0,0,0,0,0,0
FreeGrowthStocks.com,14905,0,0,0,0,0,0,0
"INO.com, Inc.",14967,0,0,0,0,0,0,0
"Xignite, Inc.",14666,0,0,0,0,0,0,0
Staff Management | SMX,14966,0,0,0,0,0,0,0
Boston Children’s Hospital,14646,0,0,0,0,0,0,0
Blue Moon Brewing Company,14826,0,0,0,0,0,0,0
"Weiss Research, Inc.",14907,0,0,0,0,0,0,0
Dallas Baptist University,14515,0,0,0,0,0,0,0
InkGarden.com,14908,0,0,0,0,0,0,0
THE BALANCE BAR COMPANY,14595,0,0,0,0,0,0,0
National Cancer Institute,14700,0,0,0,0,0,0,0
"Gateway Ticketing Systems, Inc.",14919,0,0,0,0,0,0,0
MBM,14702,0,0,0,0,0,0,0
Blinds First LLC,14928,0,0,0,0,0,0,0
UltimateHuntingGuides.com,14929,0,0,0,0,0,0,0
Department of Health (UK),14977,0,0,0,0,0,0,0
"dELiA's, Inc.",14663,0,0,0,0,0,0,0
"Hipmunk, Inc",14922,3,0,4,7,0.428571429,0,0.571428571
YMCA,14976,0,0,0,0,0,0,0
W. I. Simonson Santa Monica Mercedes-Benz Dealer,14704,0,0,0,0,0,0,0
American Council On Renewable Energy,14494,0,0,0,0,0,0,0
National Savings and Investments,14838,0,0,0,0,0,0,0
"Monster Cable Products, Inc.",14984,0,0,0,0,0,0,0
Donate Car for Charity,14664,0,0,0,0,0,0,0
"Edelbrock, LLC",14986,0,0,0,0,0,0,0
Mont Pelerin Society,14985,0,0,0,0,0,0,0
British Army,14648,0,0,0,0,0,0,0
Next Issue Media,14979,7,0,3,10,0.7,0,0.3
LA Music Academy,14768,0,0,0,0,0,0,0
evacuumstore.com,14827,0,0,0,0,0,0,0
"Elite Web Holding, LLC.",14970,0,0,0,0,0,0,0
"NorCal Rental Group, LLC.",14831,0,0,0,0,0,0,0
Auralog Inc.,14971,0,0,0,0,0,0,0
Greenlawn Mortuaries,14980,0,0,0,0,0,0,0
Banfi Products Corp,14498,0,0,0,0,0,0,0
"Vizio, Inc.",14669,0,0,0,0,0,0,0
Home Builders Association (HBA) of Greater Austin,14896,0,0,0,0,0,0,0
Bank of Scotland plc,14662,0,0,0,0,0,0,0
RUNWAY BIDDER,14981,0,0,0,0,0,0,0
"Fourth Wall Studios, Inc.",13465,0,0,0,0,0,0,0
"Ocean State Jobbers, Inc.",14665,0,0,0,0,0,0,0
"Luce, Schwab & Kase",13458,0,0,0,0,0,0,0
BTO Sports,14701,1,0,0,1,1,0,0
Plainville Farms,13461,0,0,0,0,0,0,0
Northcentral University,14769,0,0,0,0,0,0,0
Stealth Media Group,14982,0,0,0,0,0,0,0
Meredith Bay Sales Center,14965,0,0,0,0,0,0,0
Coloplast Corp.,14833,0,0,0,0,0,0,0
.CO Internet S.A.S.,14844,0,0,0,0,0,0,0
William J. Clinton Foundation,14901,5,1,0,6,0.833333333,0.166666667,0
TCP Global Corporation,14926,0,0,0,0,0,0,0
CiRBA Inc,14265,0,0,0,0,0,0,0
"Fark, Inc.",13772,0,0,0,0,0,0,0
Orleans Technical Institute,14133,0,0,0,0,0,0,0
Marin Community Foundation,14476,0,0,0,0,0,0,0
"SurePayroll, Inc.",14465,0,0,0,0,0,0,0
Franklin County Tourist Development Council,13622,0,0,0,0,0,0,0
"Gamewave Interactive Technology Co., Ltd.",14565,0,0,0,0,0,0,0
"City of Cleveland Heights, OH",14590,0,0,0,0,0,0,0
"InfoReach, Inc.",14594,0,0,0,0,0,0,0
Carl Buddig & Company,14601,0,0,0,0,0,0,0
Micro Focus,14851,0,0,0,0,0,0,0
Maxpedition Hard-Use Gear,14211,0,0,0,0,0,0,0
Winchester Hospital,14212,0,0,0,0,0,0,0
Peugeot Motor Company PLC,13912,0,0,0,0,0,0,0
BigCommerce Pty. Ltd.,13593,0,0,0,0,0,0,0
"United Rentals, Inc.",13558,0,0,0,0,0,0,0
videoconvertertool.net,13779,1,0,0,1,1,0,0
Klüber Lubrication North America L.P.,13611,0,0,0,0,0,0,0
ZoomDownloader.com,13612,11,0,2,13,0.846153846,0,0.153846154
POST UNIVERSITY,14480,0,0,0,0,0,0,0
Flight Display Systems,13626,0,0,0,0,0,0,0
"Wholesale Direct Metals, Inc.",13629,0,0,0,0,0,0,0
Ascot Racecourse Ltd.,14579,0,0,0,0,0,0,0
Burger 21 Inc.,14497,0,0,0,0,0,0,0
bestproducttesters.com,14598,20,0,0,20,1,0,0
Franchise Direct,14698,0,0,0,0,0,0,0
Standard Life Investments Inc.,14830,0,0,0,0,0,0,0
Renthal,14847,0,0,0,0,0,0,0
"Solar Alliance of America, Inc.",14898,0,0,0,0,0,0,0
Colgate University,14930,0,0,0,0,0,0,0
Robert Bosch GmbH,14113,0,0,0,0,0,0,0
Moody Bible Institute,14028,0,0,0,0,0,0,0
Mike Thompson's,14227,0,0,0,0,0,0,0
John Lewis Partnership,14295,0,0,0,0,0,0,0
"Square Enix Holdings Co., Ltd.",14396,0,0,0,0,0,0,0
Spa Resort Casino,14428,0,0,0,0,0,0,0
"GOTOGABBY, LLC.",14431,0,0,0,0,0,0,0
"Side.Cr, LLC.",14445,0,0,0,0,0,0,0
medtech,14213,0,0,0,0,0,0,0
Perion Network Ltd.,14278,1,0,1,2,0.5,0,0.5
Essence Communications Inc.,13909,0,0,0,0,0,0,0
Wehrenberg Theatres,13913,0,0,0,0,0,0,0
"Community Marketing, Inc.",13595,0,0,0,0,0,0,0
Crown Education UK,13610,0,0,0,0,0,0,0
ResponsibleTravel.com,14463,0,0,0,0,0,0,0
J. Rockcliff Realtors,14563,0,0,0,0,0,0,0
Cambria Winery & Vineyards,14578,0,0,0,0,0,0,0
E. & J. Gallo Winery,14496,0,0,0,0,0,0,0
Texas Department of State Health Services,14513,0,0,0,0,0,0,0
SAY HUEQUE,13459,0,0,0,0,0,0,0
Dow Corning Corporation,14678,0,0,0,0,0,0,0
Stericycle,14681,0,0,0,0,0,0,0
"Matrix Direct, Inc.",14832,0,0,0,0,0,0,0
nitrolicious inc,14845,0,0,0,0,0,0,0
Unified Health Solution Pvt. Ltd.,14932,2,0,0,2,1,0,0
Edmonton Economic Development Corporation,14273,0,0,0,0,0,0,0
Butler County Visitors Bureau,13905,0,0,0,0,0,0,0
Lionel NASCAR Collectables,14473,0,0,0,0,0,0,0
Falcon Northwest,14475,0,0,0,0,0,0,0
"Writers Guild of America, West, Inc.",13616,0,0,0,0,0,0,0
The Amateur Gourmet,14482,0,0,0,0,0,0,0
Dialaphone,14484,0,0,0,0,0,0,0
"Spectrum Brands, Inc.",14641,0,0,0,0,0,0,0
Internap Network Services Corporation,14575,0,0,0,0,0,0,0
The Ohio Light Opera,14577,0,0,0,0,0,0,0
"Index Digital Media, Inc.",14650,0,0,0,0,0,0,0
UTC Fire & Security,14584,0,0,0,0,0,0,0
Bid My Trade In.com,14509,0,0,0,0,0,0,0
Givology,14677,10,0,0,10,1,0,0
New Gift Depot,14682,0,0,0,0,0,0,0
"APP Pharmaceuticals, Inc.",14684,0,0,0,0,0,0,0
Rizzuto Management,14850,0,0,0,0,0,0,0
Cincy Mattress,14909,0,0,0,0,0,0,0
Switzerland Tourism,14916,0,0,0,0,0,0,0
The Sawaya Law Firm,14260,0,0,0,0,0,0,0
Solar Technology,13910,0,0,0,0,0,0,0
journeyintothelight.org,14127,0,0,0,0,0,0,0
asos.com Ltd,13777,6,0,4,10,0.6,0,0.4
SEMRush,14564,0,0,0,0,0,0,0
"Praxis Works, LLC",13628,0,0,0,0,0,0,0
"PepsiCo, Inc.",14495,2,0,1,3,0.666666667,0,0.333333333
Dewhurst for Texas,14581,0,0,0,0,0,0,0
Southern Wesleyan University,14514,0,0,0,0,0,0,0
PureVolume.com,13460,0,0,0,0,0,0,0
"Bankers Healthcare Group, Inc.",14846,0,0,0,0,0,0,0
Titus-Will,14849,0,0,0,0,0,0,0
Ticket Software LLC,14895,0,0,0,0,0,0,0
Stryker Corporation,14913,0,0,0,0,0,0,0
St Clair Jewelers,14931,0,0,0,0,0,0,0
Balboni's Landscape Supply,14206,0,0,0,0,0,0,0
"ZipList, Inc.",14124,0,0,3,3,0,0,1
FESTIVAL OF ARTS,13588,0,0,0,0,0,0,0
Canadian Natural Gas Initiative,13917,0,0,0,0,0,0,0
Collins Bridge,14131,0,0,0,0,0,0,0
Youngssuncoast.com,13774,0,0,0,0,0,0,0
The Canadian Institute of Chartered Business Valuators,13556,0,0,0,0,0,0,0
UJToys.com,14474,0,0,0,0,0,0,0
Earnhardt Management Company,14460,0,0,0,0,0,0,0
"80sTees.com, Inc.",13624,0,0,0,0,0,0,0
"Reed Real Estate, Inc.",14567,0,0,0,0,0,0,0
NATIONAL ASSOCIATION OF REALTORS,14492,3,0,0,3,1,0,0
Downunder Travel Ltd,13631,0,0,0,0,0,0,0
Peapack-Gladstone Bank,14599,0,0,0,0,0,0,0
ICC Development (International) Ltd,13456,0,0,0,0,0,0,0
Contiki Vacations,14667,3,0,0,3,1,0,0
HSM,14674,0,0,0,0,0,0,0
First Tennessee Bank National Association,14824,0,0,0,0,0,0,0
BevMo!,14828,0,0,0,0,0,0,0
Monthlys Inc.,14835,0,0,0,0,0,0,0
Porter Health System,14842,0,0,0,0,0,0,0
Just Energy Group Inc.,14978,1,0,0,1,1,0,0
Delray Recovery Center,14935,0,0,0,0,0,0,0
"Network Instruments, LLC.",14268,0,0,0,0,0,0,0
"XP Innovation, LLC. (Danscomp.com)",13557,1,0,0,1,1,0,0
Esure Services Limited,14457,0,0,0,0,0,0,0
alwaysonthenet.com,14466,0,0,0,0,0,0,0
RochesterMN.com,13623,0,0,0,0,0,0,0
The Abbey Resort,14632,0,0,0,0,0,0,0
Pacific Gas and Electric Company,14493,12,0,2,14,0.857142857,0,0.142857143
Roland Corporation,14661,1,0,0,1,1,0,0
Lake Forest Park Montessori,14602,0,0,0,0,0,0,0
"GameWorks Entertainment, LLC",14900,0,0,0,0,0,0,0
"Constant Hosting, LLC",14968,2,0,0,2,1,0,0
CouponPal,14934,0,0,0,0,0,0,0
DogVacay,14259,0,0,0,0,0,0,0
EyeBuyDirect.com,14266,3,0,0,3,1,0,0
Washington Round Table,13589,0,0,0,0,0,0,0
TuneupMyMac.com,13598,0,0,0,0,0,0,0
Innovative Radio Solutions,14459,0,0,0,0,0,0,0
Erin Mills Auto Super Centre,13621,0,0,0,0,0,0,0
Vista College,14593,0,0,0,0,0,0,0
The Dark Knight Rises Movie,14657,0,0,0,0,0,0,0
The Bourne Legacy Movie,14659,0,0,0,0,0,0,0
Smith Optics,14600,0,0,0,0,0,0,0
Southwest Ohio Regional Transit Authority,13455,0,0,0,0,0,0,0
Akron Aeros,14668,0,0,0,0,0,0,0
Turn,13464,0,0,0,0,0,0,0
Coalition for New Yorkers for Beverage Choices,14825,0,0,0,0,0,0,0
"C. Wonder, LLC",14836,4,13,0,17,0.235294118,0.764705882,0
"Vu TelePresence, Inc.",14902,0,0,0,0,0,0,0
ZoolaGames.com,14925,0,0,0,0,0,0,0
Paradox Interactive,14927,0,0,0,0,0,0,0
Transworld Surf,14936,0,0,0,0,0,0,0
TheSolarPanelExperts.com,14217,0,0,0,0,0,0,0
Eos Sleep,14281,0,0,0,0,0,0,0
Southern Polytechnic State University,13613,0,0,0,0,0,0,0
"Country Home Products, Inc.",14467,0,0,0,0,0,0,0
Porcelanosa,14574,1,0,0,1,1,0,0
"Blanchard and Company, Inc.",14642,0,0,0,0,0,0,0
SETEDGE LLC,14649,0,0,0,0,0,0,0
"T. Rowe Price Investment Services, Inc.",14499,7,0,5,12,0.583333333,0,0.416666667
Biggest Energy Saver Campaign,14660,0,0,0,0,0,0,0
Renaissance Entertainment Productions,14685,0,0,0,0,0,0,0
"Petplan Insurance Agency, LLC",14767,0,0,0,0,0,0,0
Dobosh Center,14903,0,0,0,0,0,0,0
Marburn Curtains,14917,0,0,0,0,0,0,0
National FFA Organization,14119,0,0,0,0,0,0,0
"Ultracool Air Conditioning & Heating, Inc.",13902,0,0,0,0,0,0,0
"Kentucky Raceway, LLC.",13585,0,0,0,0,0,0,0
Premu,14285,0,0,0,0,0,0,0
"Edible Arrangements, LLC.",14287,8,0,0,8,1,0,0
1ShoppingCart,13919,0,0,0,0,0,0,0
"Glen Raven, Inc.",14289,0,0,0,0,0,0,0
Al Jazeera Sport,13921,0,0,0,0,0,0,0
"HFL, Inc.",13617,0,0,0,0,0,0,0
"James Perse Enterprises, Inc.",14489,0,0,0,0,0,0,0
Resorts Casino Hotel,14570,0,0,0,0,0,0,0
erin's emporium of discount dreams & well-worn wonders,14470,0,0,0,0,0,0,0
Aqua Systems,14587,0,0,0,0,0,0,0
"EverBank Wealth Management, Inc.",14655,0,0,0,0,0,0,0
Forest Holidays,14687,0,0,0,0,0,0,0
Buffalo Niagara Convention & Visitors Bureau,14770,0,0,0,0,0,0,0
Lung Cancer Alliance,14921,0,0,0,0,0,0,0
Ninian Solutions Ltd,13451,0,0,0,0,0,0,0
"Rick Bartalini Presents, LLC",14253,0,0,0,0,0,0,0
Merchant Warehouse,14036,0,0,0,0,0,0,0
The Peterson Companies,14255,0,0,0,0,0,0,0
"Sterling Publishing Co., Inc",13904,0,0,0,0,0,0,0
"Ruth's Hospitality Group, Inc.",13587,1,0,2,3,0.333333333,0,0.666666667
Goaldash Limited,13600,0,0,0,0,0,0,0
The Finance Authority,14136,0,0,0,0,0,0,0
powerreviewsexpress.com,14472,0,0,0,0,0,0,0
CSU Monterey Bay,14555,0,0,0,0,0,0,0
XFX,14487,0,0,0,0,0,0,0
OhioHealth,14636,0,0,0,0,0,0,0
"Thumbtack, Inc.",13453,0,0,0,0,0,0,0
Jumpstart Medicine,14653,0,0,0,0,0,0,0
Optical Express,14519,0,0,0,0,0,0,0
"InvestorsHub.Com, Inc.",14904,0,0,0,0,0,0,0
Costa Vida Restaurants,14906,0,0,0,0,0,0,0
Haley Comfort Systems,14923,0,0,0,0,0,0,0
Live Nation Entertainment,14972,13,6,18,37,0.351351351,0.162162162,0.486486486
Daily Trade Alert,14974,0,0,0,0,0,0,0
Yellowfin International Pty Ltd.,14987,0,0,0,0,0,0,0
Inanna Digital,14989,0,0,0,0,0,0,0
Lunada Biomedical,12867,2,0,0,2,1,0,0
Mind (National Association for Mental Health),12831,0,0,0,0,0,0,0
The National Association of Personal Financial Advisors (NAPFA),12833,0,0,0,0,0,0,0
Perry Homes,12835,0,0,0,0,0,0,0
"Suchada, LLC.",14690,0,0,0,0,0,0,0
Inspirations for Youth and Families,13067,0,0,0,0,0,0,0
"InQuicker, LLC.",14694,0,0,0,0,0,0,0
"CashEuroNetUK, LLC",14695,0,0,0,0,0,0,0
Mastercraft Starwood,15037,0,0,0,0,0,0,0
"The Inspirational Networks, Inc.",14707,0,0,0,0,0,0,0
Santa Clara Valley Transportation Authority,12999,0,0,0,0,0,0,0
Finger Lakes School of Massage,14691,0,0,0,0,0,0,0
The Health Care and You Coalition,15035,0,0,0,0,0,0,0
Swimsuits For All,14709,0,1,0,1,0,1,0
VOX Amplification Ltd.,13269,0,0,0,0,0,0,0
"Folica, Inc.",14710,0,0,0,0,0,0,0
BedDefense.com,12984,0,0,0,0,0,0,0
Mall of America,14713,0,0,0,0,0,0,0
"Live in Love, Inc.",14717,0,0,0,0,0,0,0
AllianceBernstein L.P.,13001,0,0,0,0,0,0,0
Bookspan,14714,0,0,0,0,0,0,0
Cadillac Dealerships,13501,28,1,12,41,0.682926829,0.024390244,0.292682927
SHRM,13082,0,0,0,0,0,0,0
Pentagon Federal Credit Union,14773,0,0,0,0,0,0,0
McKinnon Furniture,12848,0,0,0,0,0,0,0
Ely Chamber Of Commerce,13035,0,0,0,0,0,0,0
First 5 California,15054,0,0,0,0,0,0,0
Plantation on Crystal River,13369,0,0,0,0,0,0,0
Wüsthof,15056,0,0,0,0,0,0,0
MARTA,13503,0,0,0,0,0,0,0
Free Samples Network,14954,0,0,0,0,0,0,0
Zonin USA,13650,0,0,0,0,0,0,0
"Matrix Concepts, LLC.",13252,0,0,0,0,0,0,0
Lux Delux,14948,0,0,0,0,0,0,0
Rachael Ray Digital LLC,13116,0,0,0,0,0,0,0
VisitScotland,14043,4,0,0,4,1,0,0
Whoviewedmyprofile.com,13735,0,0,0,0,0,0,0
Las Vegas Nightlife Group,14529,0,0,0,0,0,0,0
digitalear.com,13301,0,0,0,0,0,0,0
"MainGate, Inc.",15012,0,0,0,0,0,0,0
Parkwood at Cambridge Crossings,14962,0,0,0,0,0,0,0
NFL Enterprises LLC.,14747,5,1,2,8,0.625,0.125,0.25
game-designschool.com,13433,0,0,0,0,0,0,0
The Do-Deca-Pentathlon Movie,14329,0,0,0,0,0,0,0
Flavorus,13667,0,0,0,0,0,0,0
"Pulmuone Foods USA, Inc.",14330,0,0,0,0,0,0,0
The Esplanade Tacoma,13752,0,0,0,0,0,0,0
Arizona-Sonora Desert Museum,13135,0,0,0,0,0,0,0
Andersen Windows and Doors,13820,0,0,0,0,0,0,0
Honda Dealerships,14718,56,19,18,93,0.602150538,0.204301075,0.193548387
Gogo LLC.,15079,0,0,0,0,0,0,0
"Johnson Outdoors Marine Electronics, Inc.",14344,0,0,0,0,0,0,0
Hollister Co.,14736,17,2,0,19,0.894736842,0.105263158,0
beIN SPORT USA,15165,0,0,0,0,0,0,0
Baby Jogger Company,14708,0,0,0,0,0,0,0
Lebanon Valley Brethren Home,15071,0,0,0,0,0,0,0
ANY LAB TEST NOW,14539,0,0,0,0,0,0,0
Chartered Alternative Investment Analyst Association,15061,0,0,0,0,0,0,0
"Secco Media, Inc.",15039,0,0,0,0,0,0,0
"Smartling, Inc.",14308,0,0,0,0,0,0,0
"Cloud B, Inc.",14706,0,0,0,0,0,0,0
Cranium Fitteds,14337,0,0,0,0,0,0,0
"Westward Leaning, Inc.",15094,0,0,0,0,0,0,0
"Ajinomoto North America, Inc.",15041,0,0,0,0,0,0,0
Crescendo Designs,15104,0,0,0,0,0,0,0
Petoskey Area Visitors Bureau,14532,0,0,0,0,0,0,0
Coverleaf.com,14339,0,0,0,0,0,0,0
Matrix Medical Network,14726,0,0,0,0,0,0,0
HerbalBiz,14712,0,0,0,0,0,0,0
Y REACH and the YMCA SWIFT Program,14942,0,0,0,0,0,0,0
The Heritage Foundation,15158,0,0,0,0,0,0,0
City of Olathe,14945,0,0,0,0,0,0,0
Killer Joe Movie,14722,0,0,0,0,0,0,0
Santa Cruz Seaside Company,15043,0,0,0,0,0,0,0
Levitt Pavilion Arlington,14071,0,0,0,0,0,0,0
crowdvi.be,15101,0,0,0,0,0,0,0
"Iovate Health Sciences International, Inc.",15139,3,0,0,3,1,0,0
Kennedy Wilson Auction Group,14732,0,0,0,0,0,0,0
NickHotel.com,14325,0,0,0,0,0,0,0
VBT Bicycling and Walking Vacations,14737,0,0,0,0,0,0,0
Rise Beauty International Limited,14994,0,0,0,0,0,0,0
"Optimum Installer, Inc.",14943,0,0,0,0,0,0,0
The Solomon R. Guggenheim Foundation,14045,0,0,0,0,0,0,0
"Quinstreet, Inc.",15057,1,0,0,1,1,0,0
Welsh Government,14322,0,0,0,0,0,0,0
Canada's History,15141,0,0,0,0,0,0,0
Madea's Witness Protection Movie,14040,0,0,0,0,0,0,0
RealD Inc.,15001,0,0,0,0,0,0,0
Wing Luke Museum of the Asian Pacific American Experience,15052,0,0,0,0,0,0,0
"DS Waters of America, Inc.",14715,2,0,0,2,1,0,0
Night Vision Depot,15022,0,0,0,0,0,0,0
"Taxpayers to Preserve Community Jobs, No on Measure A",15013,0,0,0,0,0,0,0
Wente Vineyards,14797,0,0,0,0,0,0,0
FileParade.com,15097,0,0,0,0,0,0,0
Aberdeen Asset Management PLC,15058,0,0,0,0,0,0,0
Kentucky Lottery Corporation,15064,0,0,0,0,0,0,0
Cincinnati Parks,14955,0,0,0,0,0,0,0
Global Mattress Group LLC,14784,0,0,0,0,0,0,0
Nexon Korea Corporation,14315,0,0,0,0,0,0,0
Philadelphia Museum of Art,14306,0,0,0,0,0,0,0
University of the Sciences in Philadelphia,14805,0,0,0,0,0,0,0
Cox Media Group,14733,13,1,3,17,0.764705882,0.058823529,0.176470588
"Comodo Group, Inc.",14780,0,0,0,0,0,0,0
Riverside Military Academy,14356,0,0,0,0,0,0,0
"Air Treatment System, LLC",15068,0,0,0,0,0,0,0
Austin & Co. Jewelry Buyers & Coin Dealers,14060,0,0,0,0,0,0,0
Tenpin Ltd.,15239,0,0,0,0,0,0,0
Heritage Texas Properties,14951,0,0,0,0,0,0,0
"Tea Party Patriots, Inc.",14332,0,0,0,0,0,0,0
Fleaflicker LLC,14321,0,0,0,0,0,0,0
Children's Theatre of Charlotte,15053,0,0,0,0,0,0,0
Bellevue Towers,14798,0,0,0,0,0,0,0
GazeboCreations.com,15048,0,0,0,0,0,0,0
Newvem Insight Ltd.,15305,0,0,0,0,0,0,0
StarEvents,14740,0,0,0,0,0,0,0
madison.com,15062,0,0,0,0,0,0,0
Vacation Property Resales Inc,14947,0,0,0,0,0,0,0
The Restored Church of God,14047,0,0,0,0,0,0,0
National Center for Telehealth and Technology,15106,0,0,0,0,0,0,0
Manchester Business School,14311,0,0,0,0,0,0,0
"Heritage of Pride, Inc",15147,0,0,0,0,0,0,0
"Zerorez Franchising Systems, Inc.",15230,0,0,0,0,0,0,0
Lucid Imagination,15003,0,0,0,0,0,0,0
NEWaukee,15019,0,0,0,0,0,0,0
ATS Euromaster Ltd,14318,0,0,0,0,0,0,0
Institute of Contemporary Art,14053,0,0,0,0,0,0,0
Hilsoft Notifications,14958,0,0,0,0,0,0,0
BLACK OPAL,14039,0,0,0,0,0,0,0
Rue Education,15122,0,0,0,0,0,0,0
Utah Commission on Criminal and Juvenile Justice,15011,0,0,0,0,0,0,0
Bank Leumi USA,15124,0,0,0,0,0,0,0
Greener Dawn Inc.,14997,0,0,0,0,0,0,0
Virginia Beach Department of Economic Development,14048,0,0,0,0,0,0,0
Washington Indian Gaming Association (WIGA),14044,1,0,1,2,0.5,0,0.5
Indiana Economic Development Corporation,14317,0,0,0,0,0,0,0
Deborah Heart and Lung Center,14524,0,0,0,0,0,0,0
grolsch.com,14051,0,0,0,0,0,0,0
The Sage Group PLC,14069,0,0,0,0,0,0,0
Wright State University,15031,0,0,0,0,0,0,0
"Pax Memoriam, Inc.",14759,0,0,0,0,0,0,0
Florida Virtual School,14741,0,0,0,0,0,0,0
Seattle Sounders FC,14530,0,0,0,0,0,0,0
ATOLL PARADISE,14743,0,0,0,0,0,0,0
"McBride Research Laboratories, Inc.",15072,0,0,0,0,0,0,0
microcookinggames.com,15109,0,0,0,0,0,0,0
ABT Performing Arts Association,15088,0,0,0,0,0,0,0
"Emerald Coast Convention & Visitors Bureau, Inc.",14744,0,0,1,1,0,0,1
Turkey Hill Dairy,14752,0,0,0,0,0,0,0
The San Diego Chargers,14953,0,0,0,0,0,0,0
"C28, Inc.",15125,0,0,0,0,0,0,0
"Koffler Sales, LLC",14762,0,0,0,0,0,0,0
EvergreenHealth Medical Center,14336,0,0,0,0,0,0,0
"Jockey International, Inc.",15075,0,0,0,0,0,0,0
LoJack Corporation,15017,0,0,0,0,0,0,0
International Sports Sciences Association,15069,7,0,0,7,1,0,0
"Eastern Mountain Sports, Inc.",15132,0,0,0,0,0,0,0
Downtown Seattle Association (DSA),15118,0,0,0,0,0,0,0
The Blue Rooster Company,15298,0,0,0,0,0,0,0
Genting New York LLC.,14540,3,0,0,3,1,0,0
"Lazy Days RV Center, Inc.",15133,0,0,0,0,0,0,0
Private Formula Corporation,14341,0,0,0,0,0,0,0
"Atlas Productions, LLC.",15233,0,0,0,0,0,0,0
SuperMedia LLC,14795,3,0,0,3,1,0,0
"OnlineStores, Inc.",15166,0,0,0,0,0,0,0
Bad Boys Bail Bonds,14326,0,0,0,0,0,0,0
Palm Beach Jewelry,14333,0,0,0,0,0,0,0
The Financial Times Ltd.,15439,3,0,1,4,0.75,0,0.25
BetVictor,15157,0,0,1,1,0,0,1
Marin Mountain Bikes Inc.,15224,0,0,0,0,0,0,0
TheRetirementReboot.com,14347,0,0,0,0,0,0,0
Happy Mutants LLC,15089,0,0,0,0,0,0,0
NRA Freedom Action Foundation,14041,0,0,0,0,0,0,0
Waterford Area Chamber of Commerce,15084,0,0,0,0,0,0,0
Hillarys Blinds,15447,0,0,0,0,0,0,0
Times Inside,14952,0,0,0,0,0,0,0
jajagames.com,14352,0,0,0,0,0,0,0
"Novation Capital, LLC.",14796,0,0,0,0,0,0,0
Caterpillar Inc.,14050,2,0,0,2,1,0,0
The Book Nook,15161,0,0,0,0,0,0,0
OneWest Bank,15076,0,1,0,1,0,1,0
St Endellion Ltd.,15223,0,0,0,0,0,0,0
"GENJI, INC.",15297,0,0,0,0,0,0,0
OMNITelecom Ltd.,15441,0,0,0,0,0,0,0
Digital First Media,14791,0,0,1,1,0,0,1
GHOST on Broadway,15018,0,0,0,0,0,0,0
TechSpace,15516,0,0,0,0,0,0,0
Aventura Isles,15288,0,0,0,0,0,0,0
ACM SIGGRAPH,15505,0,0,0,0,0,0,0
Hammer Museum,15633,0,0,0,0,0,0,0
"Woodbridge Structured Funding, LLC",15086,0,0,0,0,0,0,0
Cloudability Inc.,15231,0,0,0,0,0,0,0
"ABG TapouT, LLC",14751,0,0,0,0,0,0,0
Women for a Healthy Environment,15020,0,0,0,0,0,0,0
Human Innovation Labs,15126,0,0,0,0,0,0,0
XOLO,15507,0,0,0,0,0,0,0
Marketing VF Ltd.,15299,0,0,0,0,0,0,0
escapistexpo.com,14073,0,0,0,0,0,0,0
slowrobot.com,15290,0,0,0,0,0,0,0
32nd District Agricultural Association,14793,0,0,0,0,0,0,0
Empowered Careers,15148,0,0,0,0,0,0,0
Elsevier B.V.,15218,3,0,0,3,1,0,0
West Herr Automotive Group,15168,0,0,0,0,0,0,0
"Bisk Education, Inc.",15367,0,0,0,0,0,0,0
"The Great Atlantic & Pacific Tea Company, Inc.",14800,0,0,0,0,0,0,0
Linda Mulligan,14072,0,0,0,0,0,0,0
MyMajors.com,15156,0,0,0,0,0,0,0
Vision Express (UK) Limited,15111,0,0,0,0,0,0,0
Synchronous Technologies,15110,0,0,0,0,0,0,0
Alabama Tourism Department,15241,0,0,0,0,0,0,0
La Redoute,14544,0,0,0,0,0,0,0
"Little Gym International, Inc.",15227,0,0,0,0,0,0,0
AC Lens,14543,0,0,0,0,0,0,0
Royal Karina Air Service,15220,0,0,0,0,0,0,0
STAGES ST. LOUIS,14056,0,0,0,0,0,0,0
Hampton Beach Village District,15366,0,0,0,0,0,0,0
TimberTech Limited,15229,0,0,0,0,0,0,0
"uCool, Inc.",15172,67,1,8,76,0.881578947,0.013157895,0.105263158
Oregon Food Bank,14350,0,0,0,0,0,0,0
"Beachbody, LLC.",14355,2,0,0,2,1,0,0
"ISN Education, LLC.",15247,0,0,0,0,0,0,0
CIEE,14343,0,0,0,0,0,0,0
Delta Faucet Company,15302,0,0,0,0,0,0,0
Alliance Inc.,15509,0,0,0,0,0,0,0
"A&E Television Networks, LLC",14806,2,0,3,5,0.4,0,0.6
Stand Up For Salem,15238,0,0,0,0,0,0,0
"Fotolog, Inc.",15286,0,0,0,0,0,0,0
U.N. Me Movie,15440,0,0,0,0,0,0,0
North Seattle Community College,15436,0,0,0,0,0,0,0
Dr. Miracles Inc.,15145,2,0,2,4,0.5,0,0.5
FragranceX.com,15570,0,0,0,0,0,0,0
Lucas Oil Off Road Racing,15154,0,0,0,0,0,0,0
Walser Automotive Group,15442,0,0,0,0,0,0,0
Friends Reunited Limited,15150,0,0,0,0,0,0,0
"Peter Jacobsen SPORTS, LLC",15119,0,0,0,0,0,0,0
Greenwood Management,15506,0,0,0,0,0,0,0
"Hendrick Motorsports, LLC",15087,0,0,0,0,0,0,0
"Newark Public Radio, Inc.",15152,0,0,0,0,0,0,0
Destination New South Wales,15522,0,0,0,0,0,0,0
Street Soccer USA,15313,0,0,0,0,0,0,0
Partnership for a Secure Financial Future,15455,0,0,0,0,0,0,0
Dryer Vent Wizard,15450,0,0,0,0,0,0,0
Norwich University,15316,4,0,0,4,1,0,0
Skin-Peel.com,15638,0,0,0,0,0,0,0
"Goldco Direct, LLC.",15634,0,0,0,0,0,0,0
C.C. Filson Company,14340,0,2,0,2,0,1,0
nutrasciencediet.com,15162,0,0,0,0,0,0,0
Online Western New York Learning Alliance,15169,0,0,0,0,0,0,0
The Resort Company,14794,0,0,0,0,0,0,0
sweetdailydeals.com,14351,0,0,0,0,0,0,0
Game Plan For Life,15523,0,0,0,0,0,0,0
Christian Prayer Center,15219,0,0,0,0,0,0,0
Citizens Equity First Credit Union,15252,0,0,0,0,0,0,0
Phygame.com,15320,0,0,0,0,0,0,0
Marylanders for Marriage Equality,15287,0,0,0,0,0,0,0
didigames.com,15301,0,0,0,0,0,0,0
"Platinum Performance, Inc.",14358,0,0,0,0,0,0,0
Lexington Medical Center,15362,0,0,0,0,0,0,0
Spur Tree Lounge,14331,0,0,0,0,0,0,0
SUNY Oneonta,15309,0,0,0,0,0,0,0
American Medical Systems,15144,0,0,0,0,0,0,0
IAC Search & Media Europe Limited,15312,0,0,0,0,0,0,0
"Romney Victory, Inc.",14542,0,0,0,0,0,0,0
Myron Corp.,15520,0,0,0,0,0,0,0
Startpins,15251,0,0,0,0,0,0,0
greataudioconverter.com,14792,0,0,0,0,0,0,0
Lightower Fiber Networks,15437,0,0,0,0,0,0,0
"Royal Purple, Inc.",15319,0,0,1,1,0,0,1
PlateFull,14349,0,0,1,1,0,0,1
ImageShack Corporation,15444,0,0,0,0,0,0,0
"Shoptiques, Inc.",15445,0,0,0,0,0,0,0
"The Tennis Channel, Inc.",15454,0,0,0,0,0,0,0
Pelican Shops,15513,0,0,0,0,0,0,0
"Arborjet, Inc.",14803,0,0,0,0,0,0,0
Chimera Energy Corporation,15518,0,0,0,0,0,0,0
"Gerler and Son, Inc.",15501,24,14,0,38,0.631578947,0.368421053,0
The MITRE Corporation,15292,0,0,0,0,0,0,0
Encorp Pacific (Canada),14778,0,0,0,0,0,0,0
"Getty Images, Inc.",15521,0,0,0,0,0,0,0
elainestips.com,15519,0,0,0,0,0,0,0
Washington Beer Commission,15569,0,0,0,0,0,0,0
The Backyard Store,15046,0,0,0,0,0,0,0
Warren County Tourism Department,15630,0,0,0,0,0,0,0
"GetHired, Inc.",14781,0,0,0,0,0,0,0
"ThoughtWorks, Inc.",14782,0,0,0,0,0,0,0
crankbrothers,14728,0,0,0,0,0,0,0
"Joyce Communications, Inc.",14731,0,0,0,0,0,0,0
Downtown Boulder Inc.,14528,0,0,0,0,0,0,0
Boost Software Inc.,15063,2,1,2,5,0.4,0.2,0.4
Rack Room Shoes,14531,0,0,0,0,0,0,0
"123Greetings.com, Inc.",15014,0,0,0,0,0,0,0
Rivermark Community Credit Union,14327,0,0,0,0,0,0,0
Damaged Cars,14328,0,0,0,0,0,0,0
Yes on 37 For Your Right to Know if Your Food Has Been Genetically Engineered,15113,0,0,0,0,0,0,0
Shakespeare Santa Cruz,14964,0,0,0,0,0,0,0
"TYR Sport, Inc.",15114,0,0,0,0,0,0,0
San Diego Radiosurgery,15032,0,0,0,0,0,0,0
TheLuxRack.com,15131,0,0,0,0,0,0,0
"Rush, Hannula, Harkins & Kyler, L.L.P.",14763,0,0,0,0,0,0,0
Raspberry Ketone Max,14764,0,0,0,0,0,0,0
1-800-GOT-JUNK? LLC,14345,0,0,0,0,0,0,0
RADIUS-8 Clinical Research Study,15232,0,0,0,0,0,0,0
PlayCola.com,15300,1,0,0,1,1,0,0
Star Tribune Media Company LLC,15364,0,0,0,0,0,0,0
Dealyst,15250,0,0,0,0,0,0,0
Epicurious,15314,0,0,0,0,0,0,0
Pottermore Limited,15449,0,0,0,0,0,0,0
"Sierra Instruments, Inc.",14697,0,0,0,0,0,0,0
Tunica Convention and Visitor's Bureau,15098,0,0,0,0,0,0,0
The Board of Investment of Thailand,14779,0,0,0,0,0,0,0
Canada Inc.,15047,0,0,0,0,0,0,0
Austin Telco Federal Credit Union,14730,0,0,0,0,0,0,0
"W.S.Goodrich, Inc.",14312,0,0,0,0,0,0,0
Kellogg-Recanati International Executive MBA,15016,0,0,0,0,0,0,0
Sony Music Entertainment,15065,0,0,0,0,0,0,0
BicyclingHub.com,14748,0,0,0,0,0,0,0
The Voca People,15029,0,0,0,0,0,0,0
Carter Lumber Company,15115,0,0,0,0,0,0,0
Mayborn USA Inc.,15030,0,0,0,0,0,0,0
"Departamento de Salud y Servicios Humanos, EE. UU.",15116,0,0,0,0,0,0,0
Scarletroadstudy.com,14061,0,0,0,0,0,0,0
ArcadeGo,14547,0,0,0,0,0,0,0
"Free College Scholarships, LLC",14548,3,0,0,3,1,0,0
Indianapolis Neighborhood Housing Partnership,15080,0,0,0,0,0,0,0
"InMotion Hosting, Inc.",15129,5,1,0,6,0.833333333,0.166666667,0
DVD Planet,14765,0,0,0,0,0,0,0
BeautiSkinRx.com,15365,0,0,0,0,0,0,0
LightHaus Logic,15448,0,0,0,0,0,0,0
Schooners Restaurant & Beach Club,15515,0,0,0,0,0,0,0
NARAL Pro-Choice America,12917,0,0,0,0,0,0,0
The Penthouse Club & Steakhouse,14721,0,0,0,0,0,0,0
Lake Lanier Islands Resort,14938,0,0,0,0,0,0,0
"Insperity, Inc.",14521,1,0,0,1,1,0,0
eReplacementParts.com Inc.,15055,0,0,0,0,0,0,0
SimonHouses.com,15006,0,0,0,0,0,0,0
Razer USA Ltd.,14738,0,0,0,0,0,0,0
California Exposition & State Fair,14538,0,0,0,0,0,0,0
"Connections Education, LLC.",14753,0,0,0,0,0,0,0
National Tool Warehouse,15074,0,0,0,0,0,0,0
Auburn Regional Medical Center,14757,0,0,0,0,0,0,0
The Exploratorium,15123,0,0,0,0,0,0,0
Malta Direct Travel,14789,0,0,0,0,0,0,0
Slimband Inc.,15140,1,1,0,2,0.5,0.5,0
"Fearless Arcade, LLC",15291,0,0,0,0,0,0,0
BRAVO | BRIO Restaurant Group,15240,0,0,0,0,0,0,0
"The Maids International, Inc.",15372,0,0,0,0,0,0,0
"Darden Concepts, Inc.",15034,25,0,10,35,0.714285714,0,0.285714286
The Westin Bonaventure,15036,0,0,0,0,0,0,0
Ballplayer Pelotero Movie,15102,0,0,0,0,0,0,0
aramatheydidnt,14727,0,0,0,0,0,0,0
"J. Y. Monk Real Estate Training Center, Inc.",14993,0,0,0,0,0,0,0
Charity Dine LLC.,14995,0,0,0,0,0,0,0
Colligo Networks Inc.,15000,0,0,0,0,0,0,0
Royal Dutch Shell,14734,0,0,7,7,0,0,1
"TPR Education IP Holdings, LLC.",14525,0,0,0,0,0,0,0
USA Air Conditioning Services,14323,0,0,0,0,0,0,0
Harbor History Museum,14961,0,0,0,0,0,0,0
Well Go USA,14534,0,0,0,0,0,0,0
WalkMe Ltd,15070,0,0,0,0,0,0,0
U.S.-Ukraine Foundation,15025,0,0,0,0,0,0,0
Musikfest,14057,0,0,0,0,0,0,0
Webcandy Limited,15127,0,0,0,0,0,0,0
Sedona Winds,15136,0,0,0,0,0,0,0
Central Indiana Regional Transportation Authority,14766,0,0,0,0,0,0,0
"Anvil Studios, Inc",15295,0,0,0,0,0,0,0
Charles R. Drew University of Medicine and Science,15093,0,0,0,0,0,0,0
Walgreen Co.,15293,41,4,11,56,0.732142857,0.071428571,0.196428571
Rock of Ages Musical,15438,0,0,0,0,0,0,0
"Boyette Cummins Nailos, Attorneys at Law",14776,0,0,0,0,0,0,0
Wicked Good Deals,15044,0,0,0,0,0,0,0
Salomon SAS,14783,0,0,0,0,0,0,0
Salt Lake Community College,15051,0,0,0,0,0,0,0
BESTFLVPLAYER.NET,14689,9,0,0,9,1,0,0
Playtika Ltd.,14604,1,0,3,4,0.25,0,0.75
Star Furniture,15040,0,0,1,1,0,0,1
"California State University, Los Angeles",14772,0,0,0,0,0,0,0
Gillece Services,14723,0,0,0,0,0,0,0
Rendezvousenfrance.com,14940,0,0,0,0,0,0,0
"Resignation Media, LLC.",14991,1,0,0,1,1,0,0
"Visit Us, Inc.",14038,0,0,0,0,0,0,0
"Armstrong Garage Door, Inc.",14787,0,0,0,0,0,0,0
Mayo Performing Arts Center,14523,0,0,0,0,0,0,0
Sally Beauty Supply LLC,15004,0,0,0,0,0,0,0
Project Sport,14319,0,0,0,0,0,0,0
Valero Energy Corporation,14957,1,0,0,1,1,0,0
Breville Canada,15023,0,0,0,0,0,0,0
Ariens Company,15108,0,0,0,0,0,0,0
CanDoFinance.com,14055,0,0,0,0,0,0,0
Ca1Media,14338,0,0,0,0,0,0,0
Nymgo,14068,0,0,0,0,0,0,0
tristatelm.com,15138,0,0,0,0,0,0,0
"Tower Hill Insurance Group, LLC.",15091,0,0,0,0,0,0,0
"J. P. King Auction Company, Inc",15221,0,0,0,0,0,0,0
SecretWeapon.org,15225,0,0,0,0,0,0,0
Kathleen Drew 2012,14804,0,0,0,0,0,0,0
"IT Chair, Inc.",15289,0,0,0,0,0,0,0
Saint Francis University,15155,0,0,0,0,0,0,0
L.A. County Fair Association,15306,0,0,0,0,0,0,0
My Yoga Online,15508,0,0,0,0,0,0,0
"BH Management Services, Inc",15096,0,0,0,0,0,0,0
Northeastern State University,15099,0,0,0,0,0,0,0
YSI Incorporated,14946,0,0,0,0,0,0,0
"PsychicPower.com, Inc.",14996,0,0,0,0,0,0,0
Consignment Northwest,14949,0,0,0,0,0,0,0
National Republican Senatorial Committee,14313,0,0,0,0,0,0,0
Endura Financial Federal Credit Union,14745,0,0,0,0,0,0,0
"Mutual Mobile, Inc.",14063,0,0,0,0,0,0,0
"Wisconsin Milk Marketing Board, Inc.",15081,0,0,0,0,0,0,0
St. Joseph Convention & Visitors Bureau,15082,0,0,0,0,0,0,0
HDtracks,15163,0,0,0,0,0,0,0
"Burnsville Heating & Air Conditioning, Inc.",15164,0,0,0,0,0,0,0
John Michael Kohler Arts Center,14346,0,0,0,0,0,0,0
Grub Crawl Inc.,15146,0,0,0,0,0,0,0
Eric Harmon for Judge,15246,0,0,0,0,0,0,0
Park Plaza Hospital,15249,0,0,0,0,0,0,0
Dean Foods Company,15514,0,0,0,0,0,0,0
"Timbuk2 Designs, Inc",15517,0,0,0,0,0,0,0
After Dark Films,15631,0,0,0,0,0,0,0
Cat Footwear,12920,0,0,0,0,0,0,0
AMG Group Ltd,14785,0,0,0,0,0,0,0
Avenidas Inc.,14310,0,0,0,0,0,0,0
LearnVest,14042,0,0,0,0,0,0,0
Alstarz Bar & Grill,15060,0,0,0,0,0,0,0
Infinity Insurance,15010,0,0,0,0,0,0,0
MSGCU,14049,0,0,1,1,0,0,1
Power Admin LLC,14960,0,0,0,0,0,0,0
Independent Digital News and Media Limited,15067,0,0,0,0,0,0,0
"SKECHERS USA, Inc.",15117,0,0,0,0,0,0,0
U.S. Department of State,14067,0,0,0,0,0,0,0
EPIC Imaging,14760,0,0,0,0,0,0,0
Officechairs.com,14342,0,0,0,0,0,0,0
"California Commerce Club, Inc.",15085,0,0,0,0,0,0,0
Home Show Consultants,15135,0,0,0,0,0,0,0
Diamond Ranch Academy,15092,1,0,0,1,1,0,0
Portola Hotel & Spa at Monterey Bay,15142,0,0,0,0,0,0,0
Endurance Auto Protection,15235,0,0,0,0,0,0,0
"CyPower, LLC",15153,0,0,0,0,0,0,0
Country Outfitter,15303,0,0,0,0,0,0,0
THE HAYS DAILY NEWS,15317,0,0,0,0,0,0,0
Scott Brown for United States Senate Committee Inc.,15503,0,0,0,0,0,0,0
United Emergency Animal Clinic,15446,0,0,0,0,0,0,0
"JAYBIRD GEAR, LLC",15510,0,0,0,0,0,0,0
Cumberland University,15635,0,0,0,0,0,0,0
Yaz Lawsuit Help,12919,0,0,0,0,0,0,0
"National Council of State Boards of Nursing, Inc.",14693,0,0,0,0,0,0,0
The Hospital of Central Connecticut,15095,0,0,0,0,0,0,0
"Dreaming Tree Technology, Inc.",14725,0,0,0,0,0,0,0
"Arby's Restaurant Group, Inc.",15100,0,0,1,1,0,0,1
Oxfam International,15002,0,0,0,0,0,0,0
Sinclair Intimacy Institute,14959,0,0,0,0,0,0,0
"Makita U.S.A., Inc.",15027,0,0,0,0,0,0,0
American Clean Skies Foundation,14059,0,0,0,0,0,0,0
Stonewall Kitchen,14334,0,0,0,0,0,0,0
Noren Products Incorporated,14066,0,0,0,0,0,0,0
Alton Regional Convention & Visitors Bureau,14761,0,0,0,0,0,0,0
VISIT SARASOTA COUNTY (VSC),15134,0,0,0,0,0,0,0
Pizzeria Uno Corporation,15170,0,0,0,0,0,0,0
MegaPath Corporation,14802,14,1,0,15,0.933333333,0.066666667,0
Starlight Theatre,14357,0,0,0,0,0,0,0
Glasses.com,15234,0,0,0,0,0,0,0
"Gallucci v. Boiron, Inc. Settlement Website",15236,0,0,0,0,0,0,0
ALEX Corporation,15304,0,0,0,0,0,0,0
"Manheim, Inc.",15368,0,0,0,0,0,0,0
Spreadshirt Inc.,15502,0,0,0,0,0,0,0
DForDomains,15504,0,0,0,0,0,0,0
"Small Can Be Big, LLC",15568,0,0,0,0,0,0,0
Provida Life Sciences,15636,0,0,0,0,0,0,0
Newark Food Service & Restaurant Equipment,14692,0,0,0,0,0,0,0
"Rowley’s Results Unlimited, LLC",15042,0,0,0,0,0,0,0
Automobili Lamborghini S.p.A.,14774,0,0,0,0,0,0,0
"MoreDirect, Inc.",15103,0,0,0,0,0,0,0
"car2go N.A., LLC",14992,0,0,0,0,0,0,0
"CytoSport, Inc.",14735,0,0,1,1,0,0,1
Fiat Dealerships,14324,7,0,1,8,0.875,0,0.125
World Industries,15028,0,0,0,0,0,0,0
Nissan,15160,175,3,50,228,0.76754386,0.013157895,0.219298246
American Bridge 21st Century,14549,0,0,0,0,0,0,0
Millennia Atlantic University,15167,0,0,0,0,0,0,0
HCA West Florida Division,14799,0,0,0,0,0,0,0
Conner Creek Academy East Elementary,15296,0,0,0,0,0,0,0
Advanced Turbine Engine Company,15242,0,0,0,0,0,0,0
Dupré Logistics,15310,0,0,0,0,0,0,0
Holabird Sports,15435,6,0,0,6,1,0,0
"Iacono Research, LLC.",15321,0,0,0,0,0,0,0
TonyClifton.net,15453,0,0,0,0,0,0,0
"Willowsford, L.L.C.",15571,0,0,0,0,0,0,0
Price Self Storage,14711,0,0,0,0,0,0,0
Bike World,14716,0,0,0,0,0,0,0
"Prize, LLC",14775,0,0,0,0,0,0,0
Paddy Maguire's Ale House,15045,0,0,0,0,0,0,0
iParty,14307,0,0,0,0,0,0,0
interKnowledge Corp.,15050,0,0,0,0,0,0,0
The North Carolina Museum of Art Foundation,14309,0,0,0,0,0,0,0
Twin Cities Gateway,14786,1,0,0,1,1,0,0
Tuscany Tile,14950,0,0,0,0,0,0,0
Cause of Action,15009,0,0,0,0,0,0,0
Lou’s Antiques & Fine Furnishings,14750,0,0,0,0,0,0,0
CubeSmart,14541,0,0,0,0,0,0,0
magicJack Plus,14348,0,0,0,0,0,0,0
ultimatedownloadaccelerator.com,15143,0,0,0,0,0,0,0
P&K Equipment,15243,0,0,0,0,0,0,0
Sugar Lake Lodge,15245,0,0,0,0,0,0,0
The Rangehood Store,15311,0,0,0,0,0,0,0
McSwain Carpets & Floors,15254,0,0,0,0,0,0,0
Planet Minecraft,15318,0,0,1,1,0,0,1
Roma Bank,15452,0,0,0,0,0,0,0
eb5 Corporation,15511,0,0,0,0,0,0,0
Wave2 Media Solutions LLC,15008,0,0,0,0,0,0,0
Cumberland Packing Corp.,14533,4,0,5,9,0.444444444,0,0.555555556
"American Stroke Association, Inc.",15026,4,0,0,4,1,0,0
"Indy Racing League, LLC",15137,0,0,0,0,0,0,0
"ThinkGeek, Inc.",14801,0,0,0,0,0,0,0
Jemella LTD,15226,0,0,0,0,0,0,0
Arizona Republic,15151,0,0,0,0,0,0,0
The Lowry,15237,0,0,0,0,0,0,0
"ShadeTree Cool Living, LLC",15294,0,0,0,0,0,0,0
"Gwinnett Hospital System, Inc.",15244,0,0,0,0,0,0,0
The U.S. Navy Recruiting Command,15512,0,0,0,0,0,0,0
Apress,13969,0,0,0,0,0,0,0
Norwin Hills Shopping Center,14858,0,0,0,0,0,0,0
Brigade Enterprises Ltd,14869,0,0,0,0,0,0,0
"Stratford School, Inc.",14863,0,0,0,0,0,0,0
Crescent Ballroom,14856,0,0,0,0,0,0,0
Banc de Binary,14855,0,0,0,0,0,0,0
Red Pocket Mobile,14862,0,0,0,0,0,0,0
Dr Pepper Snapple Group,14870,1,0,2,3,0.333333333,0,0.666666667
The Screen Shop,14865,0,0,0,0,0,0,0
"Murals Your Way. Environmental Graphics, LLC.",14088,0,0,0,0,0,0,0
Operation Blessing International,12884,0,0,0,0,0,0,0
Thanksgiving Point Institute,13167,0,0,0,0,0,0,0
"Accountability in Government, Inc.",14873,0,0,0,0,0,0,0
NCTA,13871,0,0,0,0,0,0,0
Proficient City Ltd.,15175,3,0,0,3,1,0,0
"From You Flowers, LLC",14877,0,0,0,0,0,0,0
Hope Springs Movie,14879,0,0,0,0,0,0,0
"MyBuys, Inc.",15184,0,0,0,0,0,0,0
UMB Financial Corporation,12899,1,0,1,2,0.5,0,0.5
DFDS Seaways,14809,0,0,0,0,0,0,0
"Spirit Airlines, Inc.",15183,0,0,0,0,0,0,0
"The Slate Group, LLC.",14811,0,0,0,0,0,0,0
"Godfrey Entertainment, Inc.",14886,0,0,0,0,0,0,0
First Entertainment Credit Union,15186,0,0,0,0,0,0,0
Al Arabiya News Channel,14883,1,0,0,1,1,0,0
Outdoor Research,14885,0,0,0,0,0,0,0
WHYY Inc.,14808,0,0,0,0,0,0,0
Small and Sons Oil Distribution Company,13569,0,0,0,0,0,0,0
"BDO USA, LLP.",13186,1,0,0,1,1,0,0
Associated Dairies and Farm Stores Ltd.,14876,0,0,0,0,0,0,0
ballup.com,15188,0,0,0,0,0,0,0
Kao Health and Nutrition LLC.,15176,0,0,0,0,0,0,0
Tucson Padres,14608,0,0,0,0,0,0,0
Ocean City Maryland Convention and Visitors Bureau and Department of Tourism,13550,0,0,0,0,0,0,0
OneRoof Energy,14020,0,0,0,0,0,0,0
CREDIT SUISSE GROUP AG,14817,0,0,0,0,0,0,0
SecureAuth Corporation,14816,0,0,0,0,0,0,0
Coventry Homes,14611,0,0,0,0,0,0,0
healthzone.ca,13701,0,0,0,0,0,0,0
Pure Restorations,14818,0,0,0,0,0,0,0
MAGIX AG,13450,0,0,0,0,0,0,0
Seafair,14607,0,0,0,0,0,0,0
Powwownow,14252,0,0,0,0,0,0,0
INSEAD,14035,0,0,0,0,0,0,0
ClearChoice Dental Implant Centers,14205,0,0,0,0,0,0,0
The Weather Network,14118,0,0,0,0,0,0,0
Downlogram,14820,0,0,0,0,0,0,0
"Songza Media, Inc.",13901,0,0,0,0,0,0,0
Centurion Media Group Inc.,14822,0,0,0,0,0,0,0
Orange Brand Services Limited,13584,0,0,0,0,0,0,0
Intel-GE Care Innovations LLC.,13771,0,0,0,0,0,0,0
NewYorkDebtRelief.org,13552,0,0,0,0,0,0,0
VISI Incorporated,14286,0,0,0,0,0,0,0
Musical Instrument Museum,13918,0,0,0,0,0,0,0
timescity.com,13452,0,0,0,0,0,0,0
Classic Home Brands Furniture,14454,0,0,0,0,0,0,0
4shared.com,12916,0,0,1,1,0,0,1
The Mann Center for the Performing Arts,14688,0,0,0,0,0,0,0
"Citrus Lane, Inc.",15698,0,0,0,0,0,0,0
Medical Group of Tampa Bay,14889,0,0,0,0,0,0,0
Blackhawk Plastic Surgery,15579,0,0,0,0,0,0,0
University of Mary,14894,0,0,0,0,0,0,0
"Gleim the Jeweler, Inc.",15189,0,0,0,0,0,0,0
"PNG Telecommunications, Inc.",15343,0,0,0,0,0,0,0
WinePress Publishing,14619,0,0,0,0,0,0,0
Casual Gaming Brands LLC,14616,0,0,0,0,0,0,0
"MODELKARMA USA, LLC",15330,0,0,0,0,0,0,0
"Neurobrands, LLC",14626,0,0,0,0,0,0,0
AR15 Scopes,15196,0,0,0,0,0,0,0
Akzo Nobel Paints LLC,15333,0,0,0,0,0,0,0
Southern Railway Limited,15777,0,0,0,0,0,0,0
Regional Tourism Organization #3,15194,0,0,0,0,0,0,0
Bands for Freedom,15580,0,0,0,0,0,0,0
Flex Alert,15700,0,0,0,0,0,0,0
Greater Pittsburgh Community Food Bank,15466,0,0,1,1,0,0,1
Jordan Valley Conservation Gardens Foundation,15331,0,0,0,0,0,0,0
"Kudzu Tactical, LLC",15180,0,0,0,0,0,0,0
Greater Galena Marketing Initiative,15212,0,0,0,0,0,0,0
Contemporary Arts Center New Orleans,15332,0,0,0,0,0,0,0
"N3 Oceanic, Inc.",15707,0,0,0,0,0,0,0
Riverbend Music Center,14893,0,0,0,0,0,0,0
"OPHIA Learning, LLC.",14620,0,0,0,0,0,0,0
Guoman Hotels Group Limited,14815,0,0,0,0,0,0,0
"Dotomi, LLC",15269,0,0,0,0,0,0,0
The Methodist Hospital System,15205,0,0,0,0,0,0,0
"Eat'n Park Hospitality Group, Inc.",15191,0,0,0,0,0,0,0
Mathis Brothers Furniture,14622,0,0,0,0,0,0,0
VSO,15768,0,0,0,0,0,0,0
Fremont Hearing Aid Center,15762,0,0,0,0,0,0,0
"OSL Group, LLC",14621,0,0,0,0,0,0,0
Santa Cruz Bicycle,15773,0,0,0,0,0,0,0
General Mills,15476,171,20,63,254,0.673228346,0.078740157,0.248031496
GBC MS Settlement Website,15325,0,0,0,0,0,0,0
OnlineAthens,15709,0,0,0,0,0,0,0
Gyro,14612,0,0,0,0,0,0,0
eTeacher Ltd.,15597,2,0,2,4,0.5,0,0.5
Smokeless Image,15341,0,0,0,0,0,0,0
Easy Speed PC,15701,0,0,0,0,0,0,0
Use.com Corporation,15592,0,0,1,1,0,0,1
Fulton Homes Corp.,15193,0,0,0,0,0,0,0
Savings.com Inc.,15787,0,0,0,0,0,0,0
"SurvivalFood.com, LLC",15697,0,0,0,0,0,0,0
Rose Pest Control,15195,0,0,0,0,0,0,0
Sharif Jewelers,15769,0,0,0,0,0,0,0
Laureate Education Inc.,15784,0,0,0,0,0,0,0
Modern Man Media LLC.,15831,1,0,0,1,1,0,0
Da Vinci Bridal,15475,0,0,0,0,0,0,0
"The House of Marley, LLC.",15473,0,0,0,0,0,0,0
123gaming Limited,15337,0,0,0,0,0,0,0
Evergreen Packaging Inc.,15577,0,0,0,0,0,0,0
Phish,15257,0,0,0,0,0,0,0
Coconut Bay Beach Resort & Spa,15702,0,0,0,0,0,0,0
Falling Overnight Movie,15619,0,0,0,0,0,0,0
HockeyShot.ca,15711,0,0,0,0,0,0,0
"Cascade Designs, Inc.",15480,0,0,0,0,0,0,0
"Mart Franchise Venture, LLC",15192,0,0,0,0,0,0,0
TAXI,15262,0,0,0,0,0,0,0
Profitable Play Limited,15264,0,0,0,0,0,0,0
Rugby Football Union,15206,0,0,0,0,0,0,0
Dallas Area Rapid Transit,14624,0,0,0,0,0,0,0
Home Consignment Center,15713,0,0,0,0,0,0,0
Beekman Beer Garden Beach Club,15609,0,0,0,0,0,0,0
"Jaguar Land Rover North America, LLC",15696,7,2,17,26,0.269230769,0.076923077,0.653846154
EquityBuild Finance Inc.,15600,0,0,0,0,0,0,0
"IF MANAGEMENT, INC.",15275,0,0,0,0,0,0,0
Tourism Partnership of Niagara,15578,0,0,0,0,0,0,0
VTech Holdings Ltd.,15356,11,1,8,20,0.55,0.05,0.4
"I.T.N.T., S.R.L.",15730,0,0,0,0,0,0,0
The City University of New York,15461,1,0,0,1,1,0,0
Optimax,15790,0,0,0,0,0,0,0
Nucor Corporation,15349,0,0,0,0,0,0,0
Sendspace,15843,0,0,0,0,0,0,0
Goldberg Jones,15771,0,0,0,0,0,0,0
The Egyptian Theatre,15765,0,0,0,0,0,0,0
Inventing.Com,15208,0,0,0,0,0,0,0
zuhugames.com,15851,0,0,0,0,0,0,0
Quality 1st Basement Systems,15828,0,0,0,0,0,0,0
Art Center College of Design,15766,0,0,0,0,0,0,0
Delta Blood Bank,15724,0,0,0,0,0,0,0
MLUXexchange,15334,0,0,0,0,0,0,0
Premier Communities,15606,0,0,0,0,0,0,0
Komoona,15260,0,0,0,0,0,0,0
"St. Martin’s Press, LLC.",15792,0,0,0,0,0,0,0
Winunited Ltd.,15497,0,0,0,0,0,0,0
Sony Pictures Entertainment,15204,0,0,1,1,0,0,1
Made.com Design Limited,15842,0,0,0,0,0,0,0
Columbus Zoo and Aquarium,15345,0,0,0,0,0,0,0
Sault Ste. Marie Convention & Visitors Bureau,15358,0,0,0,0,0,0,0
"Natural Wellbeing, Inc.",15830,0,0,0,0,0,0,0
Carlson Rezidor Hotel Group,15827,4,0,0,4,1,0,0
"Constellation Energy Resources, LLC",15214,0,0,0,0,0,0,0
"LY Retail, LLC.",15622,0,0,0,0,0,0,0
"Yogurtland Franchising, Inc.",15737,0,0,0,0,0,0,0
Friends of Marjorie Decker,15583,0,0,0,0,0,0,0
Myron L Company,15477,0,0,0,0,0,0,0
Worthington Direct,15726,0,0,0,0,0,0,0
National Camera Exchange & Video,15357,0,0,0,0,0,0,0
"Law ElderLaw, LLP",15490,0,0,0,0,0,0,0
modernlivingtoday.com Inc.,15469,0,0,0,0,0,0,0
"MTR Gaming Group, Inc.",15354,0,0,0,0,0,0,0
New River Auto Mall,15259,0,0,0,0,0,0,0
Canada Deposit Insurance Corporation,15594,0,0,0,0,0,0,0
Alabama Department of Conservation and Natural Resources,15744,0,0,0,0,0,0,0
"Credit.com, Inc.",15482,0,0,0,0,0,0,0
"Al Sears, M.D.",15584,0,0,0,0,0,0,0
iwowcase Limited,15860,0,0,0,0,0,0,0
Victorinox Swiss Army,15891,0,0,0,0,0,0,0
Imperial Oil,15859,0,0,0,0,0,0,0
Qwaya Technology AB,15266,0,0,0,0,0,0,0
"MyPlay Direct, Inc.",15267,0,0,0,0,0,0,0
Wisconsin State Fair Park,15858,0,0,0,0,0,0,0
RapidAdvance,15866,0,0,0,0,0,0,0
"NASH Cascadia Verde, LLC",15722,0,0,1,1,0,0,1
"Radius HDD Direct, LLC.",15348,0,0,0,0,0,0,0
Mount Vernon Ladies' Association,15712,0,0,0,0,0,0,0
NetDoctor.co.uk Limited,15869,0,0,0,0,0,0,0
Pocono Raceway,15892,0,0,0,0,0,0,0
"JN Productions, LLC",15837,0,0,0,0,0,0,0
"Empire Vision Centers, Inc.",15626,0,0,0,0,0,0,0
Portland Luggage Company,15601,0,0,0,0,0,0,0
"Portland Trail Blazers Fan Shop, Inc.",15741,0,0,0,0,0,0,0
Utah Festival Opera & Musical Theatre,15786,0,0,0,0,0,0,0
Shoeless Joe's Sports Grill,16112,0,0,0,0,0,0,0
Emmis Communications Corporation,15216,0,0,0,0,0,0,0
dollring.com,15492,0,0,0,0,0,0,0
National Association of RV Parks and Campgrounds,15785,0,0,0,0,0,0,0
Edmonds Arts Festival,15484,0,0,0,0,0,0,0
Luray-Page County Chamber of Commerce,15751,0,0,0,0,0,0,0
Kayne Kaufman Media LLC,15614,0,0,0,0,0,0,0
"Raxco Software, Inc.",15743,0,0,0,0,0,0,0
"Flight Options, LLC.",15893,0,0,1,1,0,0,1
The National Intervention for Drugs and Alcohol (NIDA),15815,0,0,0,0,0,0,0
Hirschfeld Properties LLC,15470,0,0,0,0,0,0,0
"Shepherd Smith Edwards & Kantas LTD, LLP",15485,0,0,0,0,0,0,0
Richard Attias & Associates,15798,0,0,0,0,0,0,0
Shoreline Community College,15595,0,0,0,0,0,0,0
MasterControl Inc.,15850,0,0,0,0,0,0,0
Build A Sign LLC,15733,0,0,0,0,0,0,0
"Mallygirl, LLC",15807,3,0,1,4,0.75,0,0.25
Bell Lifestyle Products Inc.,15270,0,0,0,0,0,0,0
"Jiffy Lube International, Inc.",15980,26,2,1,29,0.896551724,0.068965517,0.034482759
"AMS Vans, Inc.",15720,0,0,0,0,0,0,0
BluesGuitarMaster.com,15873,0,0,0,0,0,0,0
"Eastman Outdoors, Inc.",16187,0,0,0,0,0,0,0
PUATraining Ltd.,15883,0,0,0,0,0,0,0
"Sequenom Center for Molecular Medicine, Inc.",15359,0,0,0,0,0,0,0
Forbes Media LLC,15740,0,0,1,1,0,0,1
Louisville Convention&Visitors Bureau,16198,0,0,0,0,0,0,0
Nacogdoches Convention & Visitors Bureau,15611,0,0,0,0,0,0,0
"In-O-Vate Technologies, Inc.",15727,0,0,0,0,0,0,0
North Shore Music Theatre,15479,0,0,0,0,0,0,0
"Edgenet, Inc.",15719,0,0,0,0,0,0,0
INSCALE GmbH,15915,0,0,0,0,0,0,0
Dart Group PLC,15800,0,0,0,0,0,0,0
ResultFirst,15729,0,0,0,0,0,0,0
CarPriceSecrets.com,15797,0,0,0,0,0,0,0
REVA,15493,0,0,0,0,0,0,0
MSP Northern America S.a.r.l.,15958,0,0,1,1,0,0,1
MySiteApp Ltd.,15801,0,0,0,0,0,0,0
2013 U.S. Senior Open,15994,0,0,0,0,0,0,0
Cineworld Mobile,15853,0,0,0,0,0,0,0
"SwellPath, Inc.",15868,0,0,0,0,0,0,0
"Inkfarm.com, Inc.",15276,0,0,0,0,0,0,0
PremiumRaspberryKetone.com,15277,0,0,0,0,0,0,0
Meriwest Credit Union,15613,0,0,0,0,0,0,0
"WordStream, Inc.",15500,0,0,0,0,0,0,0
Quantrell Auto Group,16183,0,0,0,0,0,0,0
Sunovion Pharmaceuticals Inc.,15803,4,0,7,11,0.363636364,0,0.636363636
Savoy Restaurant,15750,0,0,0,0,0,0,0
Shurfine Markets,16115,0,0,0,0,0,0,0
"Classmate, L.L.C.",15876,0,0,0,0,0,0,0
"CarBuyCo, LLC",15844,0,0,0,0,0,0,0
MetroPCS Dallas Marathon,15845,0,0,0,0,0,0,0
"iEntertaiment Network, Inc.",15495,0,0,0,0,0,0,0
Loyola University Health System,16201,0,0,0,0,0,0,0
"Ugly Hedgehog, Inc.",16202,0,0,0,0,0,0,0
TQLeads LLC,15284,0,0,0,0,0,0,0
Working Media Inc.,15855,0,0,0,0,0,0,0
"My Service Pride, Inc.",15910,0,0,0,0,0,0,0
"Prime Time Sports, LLC",16001,0,0,0,0,0,0,0
Arriva plc.,15863,0,0,0,0,0,0,0
Tech Gear Zone,15998,0,0,0,0,0,0,0
University of Virginia Darden School of Business,16002,0,0,0,0,0,0,0
Cirro Energy,15961,0,0,0,0,0,0,0
Lifelong AIDS Alliance,15973,0,0,0,0,0,0,0
America’s Choice,15894,0,0,0,0,0,0,0
"YES, PRIME MINISTER Show",15620,0,0,0,0,0,0,0
Heeling Sports,15977,0,0,0,0,0,0,0
thriXXX software GmbH,15847,0,0,0,0,0,0,0
"T3Media, Inc.",15898,0,0,0,0,0,0,0
Direct Digital LLC,16099,1,0,0,1,1,0,0
"Naked Apartments, Inc.",15890,1,0,0,1,1,0,0
DUNLOP SPORTS CO. LTD.,16301,0,0,0,0,0,0,0
ALLVOI,15486,0,0,0,0,0,0,0
Pirelli & C. S.p.A.,16174,1,0,0,1,1,0,0
Pacific Cannery Lofts,15805,0,0,0,0,0,0,0
Provident Housing Limited,15852,0,0,0,0,0,0,0
"Stansberry & Associates Investment Research, LLC.",15809,7,0,1,8,0.875,0,0.125
Dooney & Bourke,16151,0,0,0,0,0,0,0
Polaris Industries Inc.,15748,13,4,1,18,0.722222222,0.222222222,0.055555556
EDHEC Business School,15488,0,0,0,0,0,0,0
"Specialty Reports, Inc.",16176,0,0,0,0,0,0,0
Off Broadway Shoe Warehouse,15962,0,0,0,0,0,0,0
Fifthroom,16205,0,0,0,0,0,0,0
"Northwest Natural Products, Inc.",15968,0,0,0,0,0,0,0
Small Luxury Hotels of the World,15965,0,0,0,0,0,0,0
"Dublin Irish Festival in Dublin, Ohio",16192,0,0,0,0,0,0,0
SeamlessCellular,16024,0,0,0,0,0,0,0
Pressflex LLC,15854,0,0,0,0,0,0,0
Central Texas College,15905,0,0,0,0,0,0,0
"GOOD Worldwide, LLC.",15963,0,0,1,1,0,0,1
Gold West Country,15496,0,0,0,0,0,0,0
The Registration System,16166,0,0,0,0,0,0,0
LuxuryHomeOutlet.com,15990,0,0,0,0,0,0,0
"PlasmaNet, Inc.",14875,2,0,4,6,0.333333333,0,0.666666667
Atlantic Spine Center,14812,0,0,0,0,0,0,0
Asian Ideas,14859,0,0,0,0,0,0,0
Performance Bicycle,15182,0,0,0,0,0,0,0
Lake County YMCA,14861,0,0,0,0,0,0,0
"Digital River, Inc.",15906,0,0,0,0,0,0,0
"Citizen/124 West 23rd Street, LLC",16255,0,0,0,0,0,0,0
Massachusetts School of Professional Psychology,14613,0,0,0,0,0,0,0
Mercer University,14615,0,0,0,0,0,0,0
OfficeMax Incorporated,16241,0,0,0,0,0,0,0
First Bank,16102,0,0,0,0,0,0,0
Boone Titanium Rings,15923,0,0,0,0,0,0,0
Gamma Telecom Limited,15699,0,0,0,0,0,0,0
Central Arizona Project,15197,0,0,0,0,0,0,0
SPIL GAMES B.V.,15812,0,0,0,0,0,0,0
FLW Outdoors,16029,0,0,0,0,0,0,0
Baileigh Industrial,15918,0,0,0,0,0,0,0
Palladium Group Inc,16148,0,0,0,0,0,0,0
NEXGEN Software Services,14892,0,0,0,0,0,0,0
"Strayer Education, Inc.",16366,0,0,0,0,0,0,0
Thoughtful Women,15896,0,0,0,0,0,0,0
The Oakland Raiders,15177,0,0,0,0,0,0,0
"Avalanche, LLC",14857,0,0,0,0,0,0,0
Brown University,15916,0,0,0,0,0,0,0
"Valassis Communications, Inc.",15187,6,0,1,7,0.857142857,0,0.142857143
Molson Coors Brewing Company (UK) Limited,15875,0,0,0,0,0,0,0
Urban Green Energy Inc.,15813,0,0,0,0,0,0,0
National Chamber Foundation,14874,0,0,0,0,0,0,0
U.S. Department of Housing and Urban Development,16104,0,0,0,0,0,0,0
LeafGuard of the Midlands,16117,0,0,0,0,0,0,0
Brandsforce,15964,0,0,0,0,0,0,0
The Consumer Healthcare Products Association (CHPA),16194,1,0,0,1,1,0,0
Solutions Crew GmbH,15745,0,0,0,0,0,0,0
Certified Transmission,15640,0,0,0,0,0,0,0
Horizon Publishing Company,14819,0,0,0,0,0,0,0
Ann Arbor Area Convention and Visitors Bureau,14625,0,0,0,0,0,0,0
White Cloud Electronic Cigarettes,14872,0,0,0,0,0,0,0
Entrepreneur Wine Club,15880,0,0,0,0,0,0,0
Empire Guitars,15198,0,0,0,0,0,0,0
TBS Factoring Service LLC,14887,0,0,0,0,0,0,0
jenniferweiner.com,15914,0,0,0,0,0,0,0
Rutgers University,14860,0,0,0,0,0,0,0
Amberton University,16158,0,0,0,0,0,0,0
Geeks.com,15747,0,0,0,0,0,0,0
Cathedral City Auto Center,15983,0,0,0,0,0,0,0
Robert Half International Inc.,15199,0,0,0,0,0,0,0
Welding Rodeo,15909,0,0,0,0,0,0,0
American National Insurnace Company,16107,0,0,0,0,0,0,0
GFI Digital Inc.,16037,0,0,0,0,0,0,0
Times Business Solutions Limited,16106,0,0,0,0,0,0,0
Patheos,16309,0,0,0,0,0,0,0
OncoGenex Pharmaceuticals Inc.,16200,0,0,0,0,0,0,0
New York City Blinds,16155,0,0,0,0,0,0,0
Phillips Tire Company,16251,0,0,0,0,0,0,0
AllAmericanDish,16038,0,0,0,0,0,0,0
ArthroSurface,15752,0,0,0,0,0,0,0
Thumper Pond,16193,0,0,0,0,0,0,0
USA Water Polo,14864,0,0,0,0,0,0,0
Kennesaw State University Coles College of Business,16250,0,0,0,0,0,0,0
Brookline Bank,14884,0,0,0,0,0,0,0
La Casa Azul Restaurant,15991,0,0,0,0,0,0,0
The Bakersfield Californian,14891,0,0,0,0,0,0,0
Organogenesis,15754,0,0,0,0,0,0,0
Kiz Studios,15581,0,0,0,0,0,0,0
Genebase Systems,16132,0,0,0,0,0,0,0
Mixed In Key LLC,15586,0,0,0,0,0,0,0
"Sample Chaos, LLC",16173,0,0,0,0,0,0,0
FitnessBlowout.com,15912,0,0,0,0,0,0,0
Carolina Biological Supply Company,15588,0,0,0,0,0,0,0
"Zebley Mehalov & White, P.C.",15695,0,0,0,0,0,0,0
"Refinance Myself, Inc.",15887,0,0,0,0,0,0,0
Carpathia Hosting Inc.,15323,0,0,0,0,0,0,0
"nomorerack Retail Group, Inc.",14610,81,4,2,87,0.931034483,0.045977011,0.022988506
The Baptist Standard Publishing Company,14867,0,0,0,0,0,0,0
"C&H Sugar Company, Inc.",16373,0,0,0,0,0,0,0
Sherman Health,15886,0,0,0,0,0,0,0
Priscilla Queen of the Desert - The Musical,15327,0,0,0,0,0,0,0
Berger and Green,15353,0,0,0,0,0,0,0
Seminole Casino Hollywood,15911,0,0,0,0,0,0,0
MikeScotti.com,15913,0,0,0,0,0,0,0
Atlantis Casino Resort Spa,15995,0,0,0,0,0,0,0
OhioMeansJobs.com,16109,0,0,0,0,0,0,0
Vacation Getaway Destinations,16178,0,0,0,0,0,0,0
Getabl Inc.,16180,0,0,0,0,0,0,0
Vae Victis Games,15464,0,0,0,0,0,0,0
SoftSheen-Carson,16111,0,0,1,1,0,0,1
EatOutForFree.net,16000,0,0,0,0,0,0,0
"IZEA, Inc.",15181,0,0,0,0,0,0,0
Brenham / Washington County Chamber and CVB,16252,0,0,0,0,0,0,0
Arvato Digital Services LLC,15178,0,0,0,0,0,0,0
Via Mobility Services,16179,0,0,0,0,0,0,0
WithinReach,14606,0,0,0,0,0,0,0
Association of Accounting Technicians,14878,0,0,0,0,0,0,0
Donald J. Boudreaux,16248,0,0,0,0,0,0,0
"Hutch Media, LLC",16130,0,0,0,0,0,0,0
"T-H Marine Supplies, Inc.",15329,0,0,0,0,0,0,0
Mazda Raceway Laguna Seca,16113,0,0,0,0,0,0,0
The Weston Firm,16137,0,0,0,0,0,0,0
Paranorman Movie,14627,0,0,0,0,0,0,0
"Pitchfork Media, Inc.",16190,0,0,0,0,0,0,0
Yelloh! Village,14882,0,0,0,0,0,0,0
Mo's Place,16298,0,0,0,0,0,0,0
"Bluehost, Inc.",16239,0,0,0,0,0,0,0
SISTER ACT - The Musical,16122,0,0,0,0,0,0,0
Impact Battery,15763,0,0,0,0,0,0,0
Ontario Citizens’ Council,16135,0,0,0,0,0,0,0
AdReactor,16196,0,0,0,0,0,0,0
Sports Backers,16145,0,0,0,0,0,0,0
Secret Escapes Limited,15465,0,0,0,0,0,0,0
"The Rundown, Inc.",16204,0,0,0,0,0,0,0
"Michigan International Speedway, Inc.",16134,0,0,0,0,0,0,0
Williamsville Wellness,15201,0,0,0,0,0,0,0
Encore Audio / Video,16242,0,0,0,0,0,0,0
Mercy Health (Cincinnati),15888,0,0,1,1,0,0,1
Cobra Labs,15200,0,0,0,0,0,0,0
"SpaceCraft, Inc.",15462,0,0,0,0,0,0,0
"G & G Landscape & Development, Inc.",16300,0,0,0,0,0,0,0
"GLOCK, Inc.",15209,4,1,0,5,0.8,0.2,0
"LAMPTRONIX Co., Ltd.",15975,0,0,0,0,0,0,0
Roche Bobois,15587,0,0,0,0,0,0,0
Democratic National Committee,16147,0,0,0,0,0,0,0
"Abilities Expo, Inc.",15576,0,0,0,0,0,0,0
"Radio Time, Inc.",16175,1,1,0,2,0.5,0.5,0
"Timex Group USA, Inc.",15996,0,0,0,0,0,0,0
THE UNITED STATES POLO ASSOCIATION,15344,0,0,0,0,0,0,0
YieldMetrics Inc.,15779,1,0,0,1,1,0,0
Nexen Tire USA,16303,0,0,0,0,0,0,0
The Federation for American Immigration Reform (FAIR),16156,0,0,0,0,0,0,0
FasterBetterPC,14813,4,0,1,5,0.8,0,0.2
Del Frisco's Restaurant Group,15263,0,0,0,0,0,0,0
The Kessler Collection,16167,0,0,0,0,0,0,0
"GET IT Mobile, Inc.",16181,0,0,0,0,0,0,0
Global Personals Limited,15993,0,0,0,0,0,0,0
"Red Mango, Inc",16203,0,0,0,0,0,0,0
NewSchool of Architecture + Design,15599,0,0,0,0,0,0,0
"Amplify Public Affairs, LLC",16244,0,0,0,0,0,0,0
Pet Amber Alert,15780,0,0,0,0,0,0,0
BeamaLife Corporation,15278,0,0,0,0,0,0,0
"Single Malt Media, LLC",16004,0,0,0,0,0,0,0
"STAGE 29 PRODUCTIONS, LLC.",15704,0,0,0,0,0,0,0
Rent Reporters.com,14814,0,0,0,0,0,0,0
Restwell Mattress Factory,15185,0,0,0,0,0,0,0
C.& E. FEIN GmbH,15211,0,0,0,0,0,0,0
C.A.R.E Addiction Recovery,15992,0,0,0,0,0,0,0
National Immigrant Integration Conference,16168,0,0,0,0,0,0,0
Morgan Properties,15605,0,0,0,0,0,0,0
BRASH BROTHERS Inc.,16253,0,0,0,0,0,0,0
"The Real Estate Group, LLC",16243,0,0,0,0,0,0,0
"Echo Media, Inc",16367,0,0,0,0,0,0,0
WOW Oralcare,15829,0,0,0,0,0,0,0
ArrestWarrantsRecords.com_LLC,15794,0,0,0,0,0,0,0
Lewis University,16140,0,0,0,0,0,0,0
Vircom Inc.,16125,0,0,0,0,0,0,0
"Higgenbotham Auctioneers International, LTD, Inc.",16124,0,0,0,0,0,0,0
Michigan Farmers CARE,16368,0,0,0,0,0,0,0
Moon Valley Nurseries,15825,0,0,0,0,0,0,0
The Children's Place,16006,0,0,0,0,0,0,0
"Tanger Factory Outlet Centers, Inc.",14810,0,0,0,0,0,0,0
"Trōphikōs, LLC",15795,0,0,0,0,0,0,0
Linda Parks For Congress,15487,0,0,0,0,0,0,0
PropertyTube,15265,0,0,0,0,0,0,0
"Allied Asset Advisors, Inc.",15708,0,0,0,0,0,0,0
Lovely Molly Movie,15361,0,0,0,0,0,0,0
Seabreeze Amusement Park,15862,0,0,0,0,0,0,0
Inspirations Studio,15582,0,0,0,0,0,0,0
Trumer Pilsner Brewing Company,16098,0,0,0,0,0,0,0
Global Conference Partners,15922,0,0,0,0,0,0,0
Smowtion Co.,16297,0,0,0,0,0,0,0
"1st Lake Properties, Inc.",16139,0,0,0,0,0,0,0
Buffalo Bills Inc.,16126,0,0,0,0,0,0,0
ShoppingNetZone,16030,0,0,0,0,0,0,0
GeniusFrequency.Com,15610,0,0,0,0,0,0,0
The Possession Movie,16207,0,0,0,0,0,0,0
"Opus NWR, LLC",15969,0,0,0,0,0,0,0
Hoka One One,15988,0,0,0,0,0,0,0
Quantum Corporation,16163,0,0,0,0,0,0,0
General Nutrition Corporation (GNC),16258,4,0,2,6,0.666666667,0,0.333333333
Quinte Broadcasting Company Ltd.,16210,0,0,0,0,0,0,0
Adventure Fit LLC.,16165,0,0,0,0,0,0,0
Ecotricity,16259,0,0,0,0,0,0,0
"Pannell Kerr Forster of Texas, P.C.",16170,0,0,0,0,0,0,0
Abbott Press,15352,0,0,0,0,0,0,0
Winchendon Furniture,16245,0,0,0,0,0,0,0
The Bean,15627,0,0,0,0,0,0,0
Travelscream,15789,0,0,0,0,0,0,0
ScaleXtreme Inc.,16143,0,0,0,0,0,0,0
Creative Safety Supply,15802,0,0,0,0,0,0,0
"Terra Networks, S.A.",16008,0,0,0,0,0,0,0
Vertex,16160,0,0,0,0,0,0,0
Brooklyn Bead Box,15861,0,0,0,0,0,0,0
Transportation Corridor Agencies,16374,0,0,0,0,0,0,0
NYU Langone Medical Center,16310,0,0,0,0,0,0,0
Flue and Flame,16256,0,0,0,0,0,0,0
Tantrum Ltd.,15629,0,0,0,0,0,0,0
"Sociedad Estatal para la Gestión de la Innovación y las Tecnologías Turísticas, S.A.",15902,0,0,0,0,0,0,0
Newell Rubbermaid Inc,16105,5,0,0,5,1,0,0
"Empower Network, LLC",15755,0,0,0,0,0,0,0
Syngenta Corporation,15819,0,0,0,0,0,0,0
"1-800-Pack-Rat, LLC",15987,1,0,0,1,1,0,0
Beachway Therapy Center,16005,0,0,0,0,0,0,0
The Hoseasons Group Limited,16305,0,0,0,0,0,0,0
Swisscom AG,16162,0,0,0,0,0,0,0
GRECOTEL HOTELS & RESORTS,15872,0,0,0,0,0,0,0
"Salonceuticals, Inc.",15997,0,0,0,0,0,0,0
"Viralheat, Inc.",16131,0,0,0,0,0,0,0
"M5 Networks, Inc.",16206,0,0,0,0,0,0,0
NCR Corporation,16136,0,0,0,0,0,0,0
Banggood Ltd.,16138,0,0,0,0,0,0,0
ZAGGORA LTD,16304,0,0,0,0,0,0,0
Denver Art Museum,16161,0,0,0,0,0,0,0
BeachStreetUSA,16365,0,0,0,0,0,0,0
Vintage Hotels,15764,0,0,0,0,0,0,0
Department of Foreign Affairs - Republic of the Philippines,15703,0,0,0,0,0,0,0
firstStreet,15460,0,0,0,0,0,0,0
GoldMax USA,15585,0,0,0,0,0,0,0
C & J Clark International Ltd,15203,0,0,0,0,0,0,0
AdTaxi Networks,15778,0,0,0,0,0,0,0
Sagee Manor,15471,0,0,0,0,0,0,0
Ewing Marion Kauffman School,15210,0,0,0,0,0,0,0
Budget Van Lines Inc.,15346,0,0,0,0,0,0,0
Advantage Fixtures Retail Group,15271,0,0,0,0,0,0,0
The Body Shop International plc,15603,4,2,1,7,0.571428571,0.285714286,0.142857143
Friendswood Development Company,15788,0,0,0,0,0,0,0
"NetMarkets, LLC",15839,0,0,0,0,0,0,0
ClickAway Corporation,15478,0,0,0,0,0,0,0
"Clarus Marketing Group, LLC.",15618,0,0,0,0,0,0,0
Fantasy Springs Resort Casino,15721,0,0,0,0,0,0,0
MarketShare Partners,15811,0,0,0,0,0,0,0
Republican National Committee,15217,0,0,0,0,0,0,0
Yamaha Corporation,15877,0,0,0,0,0,0,0
Bring It On The Musical LLC.,15864,0,0,0,0,0,0,0
Bard College,15871,0,0,0,0,0,0,0
"Orbit Baby, Inc.",16028,0,0,0,0,0,0,0
"Gannaway Web Holdings, LLC",15753,0,0,0,0,0,0,0
Moonrise Kingdom Movie,15881,0,0,0,0,0,0,0
"Norfolk Festevents, Ltd.",16039,0,0,0,0,0,0,0
Islander Resort Florida Keys,15820,0,0,1,1,0,0,1
Mon Cheri Bridals,15921,0,0,0,0,0,0,0
Florida City Gas,15822,0,0,0,0,0,0,0
"Remington Arms Company, LLC",16121,0,0,0,0,0,0,0
Domain Holdings Limited,15979,0,0,0,0,0,0,0
"Westport Volunteer Emergency Medical Service, Inc.",16188,0,0,0,0,0,0,0
theForexInsider.com,16128,0,0,0,0,0,0,0
Instant Check Mate LLC.,16120,43,1,0,44,0.977272727,0.022727273,0
"Philadelphia Media Network, Inc.",16257,3,2,0,5,0.6,0.4,0
"Communications Workers of America, AFL-CIO, CLC.",16254,0,0,0,0,0,0,0
The Schawbel Corporation,16307,0,0,0,0,0,0,0
Arizona Secretary of State,16154,0,0,0,0,0,0,0
SMOG LLC.,15202,0,0,0,0,0,0,0
San Marcos Convention and Visitor Bureau,15360,0,0,0,0,0,0,0
Jurys Inn Group Ltd.,15336,0,0,0,0,0,0,0
Digital Projection International,15728,0,0,0,0,0,0,0
"Ourstage, Inc.",15463,0,0,0,0,0,0,0
"HelloLife, LLC",15621,1,0,0,1,1,0,0
"A.J. Dwoskin and Associates, Inc.",15770,0,0,0,0,0,0,0
"Open E Cry, LLC",15796,0,0,0,0,0,0,0
Oklahoma National Guard,15772,0,0,0,0,0,0,0
Carlow University,15285,0,0,0,0,0,0,0
Caliper International,15468,0,0,0,0,0,0,0
Georgia Aquarium,15735,2,0,0,2,1,0,0
ToolKing.com,15593,0,0,0,0,0,0,0
The New York Academy of Sciences,15268,0,0,0,0,0,0,0
H.Samuel Jeweller,15602,0,0,0,0,0,0,0
"The Organizer Guys, Inc.",15604,0,0,0,0,0,0,0
Coldwell Banker Real Estate LLC.,15838,0,0,6,6,0,0,1
Viacom 18 Media Pvt. Ltd.,15736,0,0,0,0,0,0,0
The Little Potato Company,15895,0,0,0,0,0,0,0
"Protection One Alarm Monitoring, Inc.",15804,0,0,0,0,0,0,0
Natmag-Rodale Ltd,15870,0,0,0,0,0,0,0
Bellevue Chamber of Commerce,15970,0,0,0,0,0,0,0
Soffer Organization,16036,0,0,0,0,0,0,0
Novosoft LLC.,16238,0,0,0,0,0,0,0
"Daekyo America, Inc",16240,0,0,0,0,0,0,0
ElectraWorks Limited,15746,0,0,0,0,0,0,0
"Ascena Retail Group, Inc.",16197,0,0,0,0,0,0,0
Smart Careers LLC,16306,0,0,0,0,0,0,0
Kopi Ltd.,15810,0,0,0,0,0,0,0
Global Network Ventures Ltd.,16172,0,0,0,0,0,0,0
Rap Swagger,15903,0,0,1,1,0,0,1
"Jensen-Lewis Company, Inc.",16370,0,0,0,0,0,0,0
Dial One Replacement Window Specialists,15814,0,0,0,0,0,0,0
Npower Limited,15878,0,0,0,0,0,0,0
Liberty Tax Service,15821,0,0,0,0,0,0,0
NeilAbramsonAuthor,15889,0,0,0,0,0,0,0
"Applied Motion Products, Inc.",15978,3,1,0,4,0.75,0.25,0
Angeles Health,16114,0,0,0,0,0,0,0
PORGY AND BESS on Broadway,16246,0,0,0,0,0,0,0
Treasure Hunt Coins,16003,0,0,0,0,0,0,0
"California Forensic Medical Group, Inc.",16146,0,0,0,0,0,0,0
"Youjoy.com, LLC.",16164,0,0,0,0,0,0,0
Zinn Cycles Inc.,16171,0,0,0,0,0,0,0
Hampton University,16372,0,0,0,0,0,0,0
Bell Media Inc.,15774,2,0,3,5,0.4,0,0.6
Puget Sound Offices of Emergency Management,15472,0,0,0,0,0,0,0
"Premier Cleaning Services, Inc.",15474,0,0,0,0,0,0,0
American Animal Movie,15274,0,0,0,0,0,0,0
"Alex and Ani, LLC",15723,0,0,0,0,0,0,0
Alternative Energy Store Inc.,15793,0,0,0,0,0,0,0
eSmart Media Ltd.,15625,0,0,0,0,0,0,0
Valeant Pharmaceuticals North America LLC.,15806,0,0,0,0,0,0,0
Lorain Port Authority,15959,0,0,0,0,0,0,0
"Homewatch International, Inc.",15808,0,0,1,1,0,0,1
The REALTOR,16025,0,0,0,0,0,0,0
North Florida TPO,15874,0,0,0,0,0,0,0
Orlando City Soccer Club,15908,0,0,0,0,0,0,0
"Aria Systems, Inc.",16108,0,0,0,0,0,0,0
MerchDirect,16110,0,0,0,0,0,0,0
CFC Worldwide Short Film Festival (WSFF),15974,0,0,0,0,0,0,0
Partners in Care,15823,0,0,0,0,0,0,0
Rust-Oleum Corporation,16144,0,0,0,0,0,0,0
Texas Department of Agriculture,16157,0,0,0,0,0,0,0
"Confi-Chek, Inc.",16159,5,0,0,5,1,0,0
ShareBuilder Corporation,15781,26,1,16,43,0.604651163,0.023255814,0.372093023
"ResortQuest International, LLC.",15782,0,0,0,0,0,0,0
Yorktown University,15717,0,0,0,0,0,0,0
The Flood Control District of Maricopa County,15718,0,0,1,1,0,0,1
Grand Performances,15481,0,0,0,0,0,0,0
MilitaryHealthReport.com,15617,0,0,0,0,0,0,0
Indomina Group,15731,0,0,0,0,0,0,0
Screen Australia,15732,0,0,0,0,0,0,0
Mediative,15899,0,0,0,0,0,0,0
"WaveDivision Holdings, LLC",15867,0,0,0,0,0,0,0
"Abbey Road Programs, Inc.",15882,0,0,0,0,0,0,0
National Rail UK,15885,0,0,0,0,0,0,0
"Total Beauty Media, Inc.",15917,0,0,2,2,0,0,1
"PriceGrabber.com, Inc.",16185,1,0,1,2,0.5,0,0.5
The Campaign Movie,16118,0,0,0,0,0,0,0
ACHICA,16299,0,0,0,0,0,0,0
The George Washington University Online High School,14705,0,0,0,0,0,0,0
Xetum LLC,16437,4,0,0,4,1,0,0
La Catena in Roselle Ristorante,15761,0,0,0,0,0,0,0
Weston Town Center,16438,0,0,0,0,0,0,0
"Mindset Digital, LLC.",16435,0,0,0,0,0,0,0
SHOP.CA Network Inc.,16433,0,0,0,0,0,0,0
Texas Bay Area Credit Union,16431,0,0,0,0,0,0,0
Betabrand Corporation,16440,0,0,0,0,0,0,0
Horizon at Ridge Hill LLC,16436,0,0,0,0,0,0,0
RØDE Microphones,14603,0,0,0,0,0,0,0
Louisiana Campaign for Tobacco-Free Living,14771,0,0,0,0,0,0,0
reviewexpert.org,14937,0,0,0,0,0,0,0
Belle & Clive,14990,0,0,0,0,0,0,0
"American Association of Physician Specialists, Inc.",15375,0,0,0,0,0,0,0
"Nastel Technologies, Inc.",14305,0,0,0,0,0,0,0
"Foreclosure.com / ForeclosureFreeSearch, Inc.",15374,0,0,0,0,0,0,0
VFW,14037,1,0,0,1,1,0,0
"Bloomin' Brands, Inc.",15647,0,0,0,0,0,0,0
Gun Lake Tribal Gaming Authority,14520,0,0,0,0,0,0,0
Green Coffee Pure,15649,0,0,0,0,0,0,0
"Ending Spending, Inc.",15652,0,0,0,0,0,0,0
"KANA Software, Inc.",15384,0,0,0,0,0,0,0
"K•Swiss, Inc.",15387,0,0,0,0,0,0,0
Sparks Steak House,15381,0,0,0,0,0,0,0
"Ridge Web Properties, LLC",16379,0,0,0,0,0,0,0
Methodist Homes Corporation,14821,0,0,0,0,0,0,0
"Mars, Incorporated",15382,104,14,21,139,0.748201439,0.100719424,0.151079137
Pioneer Playhouse,16213,0,0,0,0,0,0,0
Quizir,16019,0,0,0,0,0,0,0
"Right Turn, Inc.",15664,0,0,0,0,0,0,0
JR Motorsports,16388,0,0,0,0,0,0,0
Symphony Silicon Valley,14623,0,0,0,0,0,0,0
Office Furniture Outlet,15662,0,0,0,0,0,0,0
Pennsylvania State University,15574,0,0,0,0,0,0,0
One Step Ahead Baby,16220,0,0,0,0,0,0,0
"For Life Products, Inc.",16223,0,0,0,0,0,0,0
Solar Inc.,15340,0,0,0,0,0,0,0
South Florida Federal Credit Union,16022,0,0,0,0,0,0,0
A.F. Sterling Homes,15589,0,0,0,0,0,0,0
"ALLI, Alliance of Action Sports, LLC",15591,0,0,0,0,0,0,0
Service d’information du Gouvernement,15342,0,0,0,0,0,0,0
Byers’ Leaf Guard,15776,0,0,0,0,0,0,0
Index Corporation,15272,0,0,0,0,0,0,0
Innovative Neurotronics,15840,0,0,0,0,0,0,0
"Broadcast Interactive Media, LLC",15608,1,0,0,1,1,0,0
"Activision, Inc.",16398,22,1,17,40,0.55,0.025,0.425
"Orabrush, Inc.",15531,0,0,0,0,0,0,0
House Foods America Corporation,15658,0,0,0,0,0,0,0
ABB Inc.,15355,0,0,0,0,0,0,0
MainStreet Bank,16384,0,0,0,0,0,0,0
"Blurb, Inc.",15791,18,6,4,28,0.642857143,0.214285714,0.142857143
Bacardi Global Brand Limited,16224,6,0,2,8,0.75,0,0.25
Northwestern College,15725,0,0,0,0,0,0,0
Dashlane Inc.,16392,0,0,0,0,0,0,0
CTN Digital,15533,0,0,0,0,0,0,0
"Northwire, Inc.",16443,0,0,0,0,0,0,0
Georgia-Pacific LLC,15539,25,9,4,38,0.657894737,0.236842105,0.105263158
The Port Authority of New York and New Jersey,15541,0,0,0,0,0,0,0
PacificSource Health Plans,15534,0,0,0,0,0,0,0
ACD Systems International Inc.,16235,0,0,0,0,0,0,0
"Jazz at Lincoln Center, Inc.",16021,0,0,0,0,0,0,0
Texts From Last Night Inc.,15645,0,0,0,0,0,0,0
Chris Dudley Foundation,16455,0,0,0,0,0,0,0
Lake View Hotel,16450,0,0,0,0,0,0,0
Whiskey River Houston,16453,0,0,0,0,0,0,0
PKF Pacific Hawaii LLP,16016,0,0,0,0,0,0,0
First Commonwealth Financial Corporation,16237,0,0,0,0,0,0,0
The Clean Air Campaign,16216,0,0,0,0,0,0,0
"B&G Foods, Inc.",15386,0,0,0,0,0,0,0
Rally House,16233,0,0,0,0,0,0,0
"GNH Productions, Inc.",16502,0,0,0,0,0,0,0
Dairy Crest Ltd,16567,0,0,0,0,0,0,0
eWAY Europe Ltd,16517,0,0,0,0,0,0,0
Ace Air,15663,0,0,0,0,0,0,0
Tax Tiger,15665,0,0,0,0,0,0,0
Vancouver WA Real Estate & Homes Relocation,16221,0,0,0,0,0,0,0
Idea Softworks LLC.,15666,0,0,0,0,0,0,0
The Corporate Executive Board Company,16495,0,0,0,0,0,0,0
"Uniworld River Cruises, Inc.",16558,0,0,0,0,0,0,0
"Virool, Inc.",15547,0,0,0,0,0,0,0
Fair Saint Louis Foundation,15540,0,0,0,0,0,0,0
"Capitol Supply, Inc.",16215,0,0,0,0,0,0,0
The Washington County Visitors Association,16559,0,0,0,0,0,0,0
SuccessEtc.com LLC,15668,0,0,0,0,0,0,0
USA TODAY Charitable Foundation,16569,0,0,0,0,0,0,0
Coalition Against the Deceptive Food Labeling Scheme,16510,0,0,0,0,0,0,0
AmFamSeminar.org,15545,0,0,0,0,0,0,0
The Tesh Media Group,15551,0,0,0,0,0,0,0
"TechInsurance Group, LLC",16576,0,0,0,0,0,0,0
Degree Prime,15552,0,0,0,0,0,0,0
LensWay Inc.,16219,0,0,0,0,0,0,0
Yes for Children & Families,15655,0,0,0,0,0,0,0
Pioneer Services,16234,0,0,0,0,0,0,0
BigRebel Media LLC,15555,0,0,0,0,0,0,0
Cincinnati USA Regional Chamber and Cincinnati Regional Tourism Network,16222,0,0,0,0,0,0,0
International Auto Parts Inc.,16212,0,0,0,0,0,0,0
Grossinger Auto Group,16560,0,0,0,0,0,0,0
"Pet Best, Inc.",16389,0,0,0,0,0,0,0
BMO Financial Group,16454,0,0,0,0,0,0,0
EQAL Inc.,16387,0,0,0,0,0,0,0
American Resources Action Network,16566,0,0,0,0,0,0,0
"Operative Media, Inc.",15669,0,0,0,0,0,0,0
"GREE, Inc.",16229,0,0,0,0,0,0,0
"Kazaana, Inc.",16562,0,0,0,0,0,0,0
"Birkbeck, University of London",16456,0,0,0,0,0,0,0
"Follett of Canada, Inc.",16511,0,0,0,0,0,0,0
"Confio, Inc.",16377,0,0,0,0,0,0,0
"Learning Ally, Inc.",16527,0,0,0,0,0,0,0
Auto Transport Depot,15537,0,0,0,0,0,0,0
National Express Online,16231,0,0,0,0,0,0,0
"Zeel Networks, Inc.",16575,0,0,0,0,0,0,0
Citizens United,16565,0,0,0,0,0,0,0
Szul,15671,0,0,0,0,0,0,0
Say No to Bell Canada,16512,0,0,0,0,0,0,0
MI-Connection,16228,0,0,0,0,0,0,0
Republican Governors Association,16516,0,0,0,0,0,0,0
Registry Rebates LLC,16451,0,0,0,0,0,0,0
KeyedIn Solutions,16573,0,0,0,0,0,0,0
"MyWebCareer, Inc.",16401,0,0,0,0,0,0,0
Mech Tech Institute,16526,0,0,0,0,0,0,0
Airline Seat Company Limited / Canadian Affair,16522,0,0,0,0,0,0,0
Kayser-Roth Corporation,16524,0,0,0,0,0,0,0
Outpost Natural Foods,15656,0,0,0,0,0,0,0
Moroccan National Tourist Office,16570,0,0,0,0,0,0,0
Michigan State Housing Development Authority (MSHDA),16564,0,0,0,0,0,0,0
ZeniMax Media Inc.,16556,0,0,0,0,0,0,0
INTUR - NICARAGUA TOURISM BOARD,16523,0,0,0,0,0,0,0
Physicians Plus Insurance Corporation,15554,0,0,0,0,0,0,0
HomeServe PLC,16519,12,0,1,13,0.923076923,0,0.076923077
ES London Limited,16514,0,0,0,0,0,0,0
roshhashanah.leket.org,16521,0,0,0,0,0,0,0
LeadFormix Inc.,15390,0,0,0,0,0,0,0
Activeris Software,16226,0,0,0,0,0,0,0
Utah State Fair,16394,0,0,0,0,0,0,0
Performance Fabrics Inc,16445,0,0,0,0,0,0,0
Met Office,16509,0,0,0,0,0,0,0
Suncoast Schools Federal Credit Union,15623,0,0,0,0,0,0,0
"Sun-Times Media, LLC",15489,0,0,0,0,0,0,0
Regions Financial Corporation,15857,11,2,0,13,0.846153846,0.153846154,0
Stan James,15491,0,0,0,0,0,0,0
"TC Global, Inc.",15957,0,0,0,0,0,0,0
Community Supermarket,16027,0,0,0,0,0,0,0
Servis,16040,0,0,0,0,0,0,0
"FUNimation Productions, Ltd.",15976,12,0,1,13,0.923076923,0,0.076923077
Saint John's Health Center,16191,0,0,0,0,0,0,0
Bezecom Ltd.,16208,0,0,0,0,0,0,0
SAVE.CA,16142,0,0,0,0,0,0,0
Gulf Shores Rentals,16308,0,0,0,0,0,0,0
Sunday Bikes,16376,0,0,0,0,0,0,0
Ralph Lauren Media LLC,15657,0,0,0,0,0,0,0
"BMC Software, Inc.",15659,0,0,0,0,0,0,0
"Stream Global Services, Inc.",15389,0,0,0,0,0,0,0
Griffin Capital Funding,15391,0,0,0,0,0,0,0
Digital Brands Inc.,16227,0,0,0,0,0,0,0
Serenata Flowers,16408,0,0,0,0,0,0,0
Harrods Limited,16508,0,0,0,0,0,0,0
Jafrum Internatinal Inc.,16561,0,0,0,0,0,0,0
The Book of Mormon Musical,16525,0,0,0,0,0,0,0
"Allure Bridals, Inc.",15598,2,0,1,3,0.666666667,0,0.333333333
Maintenance Connection,15715,0,0,0,0,0,0,0
Nextbook Inc.,15716,0,0,0,0,0,0,0
"James Hardie Products, Inc.",15833,0,0,0,0,0,0,0
411 Pain,15834,0,0,0,0,0,0,0
Vanderkamp Center,15215,0,0,0,0,0,0,0
Crown Vision Center,15280,0,0,0,0,0,0,0
BasketballRenegades.com,15483,0,0,0,0,0,0,0
Lewis Operating Corp.,15616,0,0,0,0,0,0,0
Freegun Underwear,15865,0,0,0,0,0,0,0
Alpari (UK) Limited,15498,0,0,0,0,0,0,0
Shelton Capital Management,15901,0,0,0,0,0,0,0
In-Home Supportive Services Program,15966,0,0,0,0,0,0,0
OffGamers Limited,16101,0,0,0,0,0,0,0
IvySkin USA,15884,0,0,0,0,0,0,0
"Roberts Hawaii, Inc.",15984,0,0,0,0,0,0,0
Lawrence Hall Lincoln,16116,0,0,1,1,0,0,1
"Brown & Crouppen, P.C.",16119,0,0,0,0,0,0,0
Bury Tourist Information Centre,16369,0,0,0,0,0,0,0
Gamesys Limited,16434,0,0,0,0,0,0,0
ColorCopper.com,15648,0,0,0,0,0,0,0
Kansas City T-Bones,15380,0,0,0,0,0,0,0
"Owner In-site, LLC.",15757,0,0,0,0,0,0,0
"SL360, Inc.",15759,0,0,0,0,0,0,0
"Atkins Nutritionals, Inc.",15642,0,0,0,0,0,0,0
Shift Racing Inc.,16010,0,0,0,0,0,0,0
NetDragon Websoft Inc.,16378,0,0,1,1,0,0,1
"Freije Treatment Systems, Inc.",15525,0,0,0,0,0,0,0
"Katz, Abosch, Windesheim, Gershman & Freedman, P.A.",16391,0,0,0,0,0,0,0
Creative Labs,16225,0,0,0,0,0,0,0
C.R. Smith Museum,16442,0,0,0,0,0,0,0
Mercury News Media Center,16393,0,0,0,0,0,0,0
PNC Arena,16444,0,0,0,0,0,0,0
"Daily Express, Inc.",16432,0,0,0,0,0,0,0
"Mattress Firm, Inc.",15646,0,0,3,3,0,0,1
Fiberlink Communications Corporation,16382,3,0,0,3,1,0,0
"Juice Pub, LLC",16214,0,0,0,0,0,0,0
"Cloudbreak Group, LLC",16446,0,0,0,0,0,0,0
America’s Cup Event Authority LLC,16396,0,0,0,0,0,0,0
Cox & Kings Limited,16496,0,0,0,0,0,0,0
The Truck Shop,16407,0,0,0,0,0,0,0
Southwest Airlines Co,15546,20,12,5,37,0.540540541,0.324324324,0.135135135
Sprig Health Inc.,16557,0,0,0,0,0,0,0
Royal Air Force,16571,0,0,0,0,0,0,0
Champion Energy Services LLC,15527,0,0,0,0,0,0,0
PhoneIndia.com,15670,0,0,0,0,0,0,0
Marist College,15672,0,0,0,0,0,0,0
"TourGigs, LLC.",15538,0,0,0,0,0,0,0
"iCIMS, Inc.",16497,0,0,0,0,0,0,0
Destination Network,16404,0,0,1,1,0,0,1
"St. Joseph's Home Health, Inc.",16406,0,0,0,0,0,0,0
Centaur Media Plc.,16506,0,0,0,0,0,0,0
"ClearChoice Management Services, LLC",15661,0,0,0,0,0,0,0
"Met-Rx Nutrition, Inc.",15529,0,0,0,0,0,0,0
Kurt Andersen,16395,0,0,0,0,0,0,0
"AdaptiveBlue, Inc.",16399,0,0,0,0,0,0,0
MegaCloud Ltd.,16499,0,0,0,0,0,0,0
DRL Limited,16504,0,0,0,0,0,0,0
Nugenics International LLC,16563,0,0,0,0,0,0,0
Amigo Loans Ltd.,16572,0,0,0,0,0,0,0
"H.J. Heinz Company, L.P.",16574,13,0,4,17,0.764705882,0,0.235294118
Bay Alarm Company,15650,0,0,0,0,0,0,0
California Olive Ranch,16018,0,0,0,0,0,0,0
"Western Land Realty, Inc.",16217,0,0,0,0,0,0,0
"Pittsburgh Arena Operating, LP",15667,0,0,1,1,0,0,1
streetinvasion.com,15532,0,0,0,0,0,0,0
Targeted Solutions Online,16232,0,0,0,0,0,0,0
Valley National Bank,16236,0,0,1,1,0,0,1
"Cayman Airways, Ltd.",16400,0,0,0,0,0,0,0
"U4IA GAMES, INC.",16503,0,0,0,0,0,0,0
Webfusion Ltd.,16518,0,0,0,0,0,0,0
Long Tall Sally Ltd,15378,0,0,0,0,0,0,0
"Dominion Dental Services, Inc.",15653,0,0,0,0,0,0,0
everydaydeal.org,15385,0,0,0,0,0,0,0
New York Code & Design Academy,15660,0,0,0,0,0,0,0
Summit Tax Service,15535,0,0,0,0,0,0,0
Workforce Freedom Initiative,16457,0,0,0,0,0,0,0
Exxon Mobil Corporation,16507,0,0,0,0,0,0,0
"FragranceNet.com, Inc.",15377,1,0,0,1,1,0,0
British Cycling Federation,16011,0,0,0,0,0,0,0
Southern Connecticut Jobs,16013,0,0,0,0,0,0,0
"Synergy HomeCare Franchising, LLC",15654,0,0,1,1,0,0,1
"etouches, Inc",16390,0,0,0,0,0,0,0
SunTrust Richmond Marathon,16447,0,0,0,0,0,0,0
BigRock,16449,0,0,0,0,0,0,0
Instructables.com,15543,1,0,0,1,1,0,0
London School of Business & Finance,16515,0,0,0,0,0,0,0
jimbop.com,15383,0,0,0,0,0,0,0
Ann & Robert H. Lurie Children's Hospital of Chicago,16015,0,0,0,0,0,0,0
CipSoft GmbH,16383,0,0,0,0,0,0,0
Cortlands Garage,16452,0,0,0,0,0,0,0
Elegant Audio/Video,16402,0,0,0,0,0,0,0
Graduate Prospects Ltd.,16501,0,0,0,0,0,0,0
Appoxee Ltd,15548,0,0,0,0,0,0,0
"REAL REAL, INC.",16520,36,0,2,38,0.947368421,0,0.052631579
The Buffalo News,15467,0,0,0,0,0,0,0
National Review Online,15832,0,0,0,0,0,0,0
"GridGain Systems, Inc.",15714,0,0,0,0,0,0,0
KPMG LLP (Canada),15213,0,0,0,0,0,0,0
"Elk & Elk Co., Ltd.",15835,0,0,0,0,0,0,0
PolicyBazaar,15281,0,0,0,0,0,0,0
Washington Renaissance Arts and Education Society,15282,0,0,0,0,0,0,0
Silent Furnace Productions,15849,0,0,0,0,0,0,0
Elwood Staffing,15799,0,0,0,0,0,0,0
Bersani Jewelry,15499,0,0,0,0,0,0,0
"Grove/Atlantic, Inc.",15900,0,0,0,0,0,0,0
Legal & General Group plc,15749,0,0,0,0,0,0,0
Missouri Military Academy,15817,0,0,0,0,0,0,0
"Softipic, LLC.",15818,0,0,0,0,0,0,0
MyClassicGarage,16035,0,0,0,0,0,0,0
Barbados Tourism Authority,16182,0,0,0,0,0,0,0
"Exmark Manufacturing Company, Inc.",16199,0,0,0,0,0,0,0
Cloves Seattle,16249,0,0,0,0,0,0,0
"The Berry Company, LLC",15999,0,0,0,0,0,0,0
Peltz Shoes,16149,0,0,0,0,0,0,0
Rolls-Royce plc,16150,0,0,0,0,0,0,0
"AtomicOnline, LLC",16017,6,0,2,8,0.75,0,0.25
"Rexel, Inc.",16385,0,0,0,0,0,0,0
Jordan Hospital,16386,0,0,0,0,0,0,0
Junk my Car LLC.,16403,0,0,0,0,0,0,0
Butlins Skyline Ltd,16500,0,0,0,0,0,0,0
Savant Systems LLC,15549,0,0,0,0,0,0,0
"Experimental Aircraft Association, Inc.",15550,0,0,0,0,0,0,0
"Gartner, Inc.",16568,0,0,0,0,0,0,0
Ben Garelick Jewelers,15376,0,0,0,0,0,0,0
College of Business and Technology,15644,0,0,0,0,0,0,0
Business Insurance Now,16012,0,0,0,0,0,0,0
"The Denver Post, LLC.",15526,0,0,0,0,0,0,0
Robot & Frank Movie,16230,0,0,0,0,0,0,0
Resident Evil Movie,16498,0,0,0,0,0,0,0
Cleveland Society for Human Resource Management (CSHRM),15544,0,0,0,0,0,0,0
"Survey Sampling International, LLC.",16405,0,0,0,0,0,0,0
TOA Technologies,16505,0,0,0,0,0,0,0
SEAT S.A.,16555,0,0,0,0,0,0,0
Thunder Valley Casino Resort,14522,0,0,0,0,0,0,0
HarbourFrontCentre.com,14320,0,0,0,0,0,0,0
Business In You Campaign,14739,0,0,0,0,0,0,0
Special Operations (OPSEC) Political Committee,16410,0,0,0,0,0,0,0
"Lexyl Travel Technologies, LLC",16412,0,0,0,0,0,0,0
TIL LIfestyle Marketing + Events,16411,0,0,0,0,0,0,0
"GoldToeMoretz, LLC",16413,3,0,0,3,1,0,0
parkcitygreatgetaway.com,13471,0,0,0,0,0,0,0
TeleportMyJob.com Limited,16415,0,0,0,0,0,0,0
First Financial,13473,0,0,1,1,0,0,1
The Morikami Museum and Japanese Gardens,13470,0,0,0,0,0,0,0
The Taft Museum of Art,16420,0,0,0,0,0,0,0
Transworld Media,16422,0,0,0,0,0,0,0
"PrepareWise, LLC.",16414,0,0,0,0,0,0,0
WeeWorld,13474,0,0,0,0,0,0,0
Union Leasing Inc.,16421,0,0,0,0,0,0,0
abbeyblog.me,13481,0,0,0,0,0,0,0
"TurnKey Internet, Inc.",16419,0,0,0,0,0,0,0
Metropolitan Tucson Convention & Visitors Bureau,13482,0,0,0,0,0,0,0
Mansome Movie,16428,0,0,0,0,0,0,0
Etnies,13487,0,0,0,0,0,0,0
Waltons Funeral Homes,13486,0,0,0,0,0,0,0
Mormon's Secret,13488,0,0,0,0,0,0,0
"Flatout, Inc.",16429,0,0,0,0,0,0,0
Free The Children,13489,0,0,0,0,0,0,0
The Save USA Wind Jobs Coalition,13490,0,0,0,0,0,0,0
"Amylin Pharmaceuticals, Inc.",16418,0,0,0,0,0,0,0
LavaLife.com,13477,3,0,0,3,1,0,0
Dale Carnegie Training,16426,0,0,0,0,0,0,0
The Co-operative Bank p.l.c.,16675,0,0,0,0,0,0,0
"The American Automobile Association, Inc. (AAA)",13472,50,1,13,64,0.78125,0.015625,0.203125
Osage Casino,16423,0,0,0,0,0,0,0
"CrossFit, Inc.",13479,0,0,0,0,0,0,0
EURAXESS Links,16677,0,0,0,0,0,0,0
PhotoFrames.net,16430,0,0,0,0,0,0,0
Holy Spirit Health System,16623,0,0,0,0,0,0,0
Clydesdale Bank PLC,16698,0,0,0,0,0,0,0
Ted Baker Limited,16682,0,0,0,0,0,0,0
"Investors Online Media, LLC.",16697,0,0,0,0,0,0,0
KBF Enterprises Ltd.,16705,0,0,0,0,0,0,0
Fitness First,16694,0,0,0,0,0,0,0
Feast Portland,16679,0,0,0,0,0,0,0
GetItFree.us,13475,7,0,3,10,0.7,0,0.3
Kollmorgen,16690,0,0,0,0,0,0,0
First Community Credit Union,16681,0,0,0,0,0,0,0
Business Industry Political Action Committee,16691,0,0,0,0,0,0,0
la Comisión de Promoción del Perú,16683,0,0,0,0,0,0,0
"Staples, Inc.",13478,35,3,6,44,0.795454545,0.068181818,0.136363636
Vatterott College Online,16619,1,0,0,1,1,0,0
SSE Group,16696,0,0,0,0,0,0,0
"Democracy Works, Inc.",16620,0,0,0,0,0,0,0
Freshpet,16618,0,0,0,0,0,0,0
"SoundCure, Inc.",16707,1,0,0,1,1,0,0
Herzing University,16702,0,0,0,0,0,0,0
"Victor Technologies International, Inc.",16685,1,0,0,1,1,0,0
Mimecast Services Ltd.,16703,0,0,0,0,0,0,0
Time Inc.,16695,9,1,2,12,0.75,0.083333333,0.166666667
BuySellAds.com Inc.,16684,1,0,0,1,1,0,0
Upstate SC Alliance,16704,0,0,0,0,0,0,0
Sophos Ltd.,16687,2,0,0,2,1,0,0
GooodJob,16701,0,0,0,0,0,0,0
Lightlife Foods,16680,0,0,0,0,0,0,0
Litle & Co.,16427,0,0,0,0,0,0,0
"AdvancePierre Foods, Inc.",16676,0,0,0,0,0,0,0
Home Skinovations Inc.,16678,0,0,0,0,0,0,0
AudioGO Ltd.,16693,0,0,0,0,0,0,0
The Security Service,16617,0,0,0,0,0,0,0
Topgrade Sportswear Limited,16700,0,0,0,0,0,0,0
Evergreen Speedway,16425,0,0,0,0,0,0,0
"Molly Maid, Inc.",13483,0,0,0,0,0,0,0
Jaunt,13485,0,0,0,0,0,0,0
Nutricia Limited,16625,0,0,0,0,0,0,0
Red Sea Holidays UK Ltd.,16621,0,0,0,0,0,0,0
LAG GUITARS,13491,0,0,0,0,0,0,0
iWeb Inc.,16699,0,0,0,0,0,0,0
Co-op Group Travel 1 Limited,16706,0,0,0,0,0,0,0
"TJX Companies, Inc.",16708,0,0,1,1,0,0,1
Sysomos Inc.,16686,1,1,0,2,0.5,0.5,0
"EarlyShares.com, Inc.",16689,0,0,0,0,0,0,0
Ultimate Medical Academy,16624,0,0,0,0,0,0,0
Westminster College,16688,0,0,0,0,0,0,0
Bridge Pedal Inc.,15105,0,0,0,0,0,0,0
"HealthCentral Network, Inc.",15107,0,0,0,0,0,0,0
National Holistic Institute,15674,0,0,0,0,0,0,0
Woodson & James Angus Beef,14052,0,0,0,0,0,0,0
UPrinting.com,14537,0,0,0,0,0,0,0
Ogilvy PR,16314,0,0,0,0,0,0,0
UserTesting.com,16321,0,0,0,0,0,0,0
"Russell Warner, Inc.",15926,0,0,0,0,0,0,0
WNYSkydiving,16319,0,0,0,0,0,0,0
"Credit Sesame, Inc.",15930,0,0,0,0,0,0,0
Visual Media Solutions,15024,0,0,0,0,0,0,0
"Nexstar Broadcasting, Inc.",15934,0,0,0,0,0,0,0
"AG Marketing & Entertainment, Inc.",16326,0,0,0,0,0,0,0
Andkon Arcade,15073,0,0,0,0,0,0,0
"Bloodhound Investment Research, Inc.",15935,0,0,0,0,0,0,0
"NAI/Merin Hunter Codman, Inc.",14754,0,0,0,0,0,0,0
"Parker McDonald, P.C.",15939,0,0,0,0,0,0,0
"Chickasaw Country, LLC",16335,0,0,0,0,0,0,0
"Humphrey, Farrington & McClain, P.C.",15938,0,0,0,0,0,0,0
Arizona Society for Human Resources Management,16328,0,0,0,0,0,0,0
"Consolidated Edison, Inc.",16336,42,0,0,42,1,0,0
Harding's Markets,14756,0,0,0,0,0,0,0
lowcost travel group,16465,0,0,0,0,0,0,0
TSYS Merchant Solutions,14788,0,0,0,0,0,0,0
Western Appliance,15941,0,0,0,0,0,0,0
"BBAM, LLC",16468,0,0,0,0,0,0,0
"MundoFOX Broadcasting, LLC",14790,0,0,0,0,0,0,0
Green Mountain College,16349,0,0,0,0,0,0,0
"Menin Hotels, Inc",15171,0,0,0,0,0,0,0
Artin’s Grill,15680,0,0,0,0,0,0,0
Psychology Colleges,16357,0,0,0,0,0,0,0
The Message Church,16316,0,0,0,0,0,0,0
"American Musical Supply, Inc.",16630,0,0,0,0,0,0,0
Bio‐Oil,16341,0,0,1,1,0,0,1
Anglican Home Improvements,16466,0,0,0,0,0,0,0
CarFinance Capital LLC.,16323,0,0,0,0,0,0,0
Breitling Oil and Gas Corporation,15945,0,0,0,0,0,0,0
Umpqua Dairy,16350,0,0,0,0,0,0,0
PaperDirect,16330,0,0,0,0,0,0,0
"The Walt Disney Family Museum, LLC",16327,0,0,0,0,0,0,0
"Outbid.com, Inc.",15947,0,0,0,0,0,0,0
Buy Emergency Foods,15558,0,0,0,0,0,0,0
Wild Blueberry Association of North America,16356,0,0,0,0,0,0,0
Networx Systems LLC,16461,0,0,0,0,0,0,0
Debbie Wasserman Schultz for Congress,16628,0,0,0,0,0,0,0
Bill & Melinda Gates Foundation,16353,0,0,0,0,0,0,0
University of Virginia School of Continuing and Professional Studies,16358,0,0,0,0,0,0,0
"Smilebox, Inc.",16643,1,0,0,1,1,0,0
Reality Squared Games Inc.,16538,15,1,1,17,0.882352941,0.058823529,0.058823529
Environmental Protection Agency,15956,0,0,0,0,0,0,0
"Restoration Hardware, Inc.",16636,3,0,0,3,1,0,0
Astoria-Warrenton Area Chamber of Commerce,16530,0,0,0,0,0,0,0
Stop This Insanity Inc.,16809,0,0,0,0,0,0,0
Bayer AG,16334,0,0,0,0,0,0,0
Del-Air,15940,0,0,0,0,0,0,0
Versant Corp.,15937,0,0,0,0,0,0,0
JD Motors,16046,0,0,0,0,0,0,0
Odeon Cinemas Holdings Limited,16535,0,0,0,0,0,0,0
"Speedway Motors, Inc.",16808,0,0,0,0,0,0,0
DiscountTVLamps.com,16044,0,0,0,0,0,0,0
NOW Pensions,15564,0,0,0,0,0,0,0
"LearnNow, LLC.",16347,0,0,0,0,0,0,0
Merrimack College,16362,0,0,0,0,0,0,0
Jose's Blue Sombrero Restaurant,15951,0,0,0,0,0,0,0
EuroMedia,16872,0,0,0,0,0,0,0
First Greater Western Limited,16533,0,0,0,0,0,0,0
"Domo, Inc.",16536,5,0,0,5,1,0,0
Littlestar Services Ltd,16874,10,0,2,12,0.833333333,0,0.166666667
ALEX JONES INFOWARS STORE,16486,2,0,0,2,1,0,0
ITV Consumer Limited,16877,0,0,0,0,0,0,0
Infinite Game Publishing Inc.,16534,3,0,0,3,1,0,0
Encompass Insurance,16067,0,0,0,0,0,0,0
"IRON Solutions, Inc.",16043,0,0,0,0,0,0,0
"Leavitt, Yamane, & Soldner",15567,0,0,0,0,0,0,0
The Sierra Club,16480,0,0,0,0,0,0,0
OnlineSPX.com LLC,16942,0,0,0,0,0,0,0
Salt Lake Behavioral Health,15676,0,0,0,0,0,0,0
Custom Electronic Design & Installation Association,16052,0,0,0,0,0,0,0
Greenwich School of Management,16741,0,0,0,0,0,0,0
Popular Inc.,15677,0,0,1,1,0,0,1
Which? Group,16641,0,0,0,0,0,0,0
Central Bancompany,16885,0,0,0,0,0,0,0
SS JEREMIAH O'BRIEN,16045,0,0,0,0,0,0,0
Music Choice,15559,0,0,0,0,0,0,0
"Detroit Entertainment, L.L.C.",16479,0,0,0,0,0,0,0
Groupement International d’Informatique et de Santé,16478,0,0,0,0,0,0,0
Heidi for Senate,16710,0,0,0,0,0,0,0
"SimpliSafe, Inc.",15562,0,0,0,0,0,0,0
Manchester Airport plc.,16487,0,0,0,0,0,0,0
Reed Business Information Ltd (newscientist.com),16477,0,0,0,0,0,0,0
Technology Review,16047,0,0,0,0,0,0,0
Castelrock Communities,16069,0,0,0,0,0,0,0
Heafey Heafey Hoffmann Dworak & Cutler,15687,0,0,0,0,0,0,0
ResMed Corp.,16802,0,0,0,0,0,0,0
Swallow Hill Music,16058,0,0,0,0,0,0,0
Wolf Trap Foundation for the Performing Arts,15948,0,0,0,0,0,0,0
KnowBase Networks,16488,0,0,0,0,0,0,0
MEGA Brands Inc.,16884,0,0,0,0,0,0,0
EDWARD ALBEE’S WHO’S AFRAID OF VIRGINIA WOOLF,16547,0,0,0,0,0,0,0
Stampin' Up!,16548,0,0,0,0,0,0,0
Lester's Inc.,16491,0,0,0,0,0,0,0
JulieGarwood.com,16060,0,0,0,0,0,0,0
David Lee for San Francisco District 1 Supervisor,16930,0,0,0,0,0,0,0
Fragrance Direct,15686,0,0,0,0,0,0,0
artillery4men.com,15952,0,0,0,0,0,0,0
Centrepoint Soho,16887,0,0,0,0,0,0,0
Independent Newspapers Ireland Ltd.,16554,0,0,0,0,0,0,0
ANR INT Inc.,16742,0,0,0,0,0,0,0
The Malvern School,16351,0,0,0,0,0,0,0
AVAS Corporation,15688,0,0,0,0,0,0,0
Loyola University Chicago,16642,0,0,0,0,0,0,0
Suncadia,16541,0,0,0,0,0,0,0
"Medifast, Inc.",16352,39,1,0,40,0.975,0.025,0
bet365,16542,0,0,1,1,0,0,1
Green Tea LLC,16544,0,0,0,0,0,0,0
OPUBCO Communications Group,16054,0,0,1,1,0,0,1
Bradford O'Keefe Funeral Homes,15683,0,0,0,0,0,0,0
Fresh Healthy Vending LLC,16805,0,0,0,0,0,0,0
"Linkage, Inc.",16056,0,0,0,0,0,0,0
"South Beach Skincare, Inc.",16074,0,0,0,0,0,0,0
playcow.com,16873,0,0,0,0,0,0,0
"LifeMed Media, Inc.",16880,0,0,0,0,0,0,0
Johnston Press plc,16492,0,0,0,0,0,0,0
"General Cigar Co., Inc.",16543,0,0,0,0,0,0,0
ShareThis Inc.,16545,0,0,0,0,0,0,0
"ImaginAsian Entertainment, Inc.",16494,0,0,0,0,0,0,0
ACCOR Group,16634,0,0,0,0,0,0,0
"National Entertainment Collectibles Association, Inc. (NECA)",16891,0,0,0,0,0,0,0
Newton Running Company,16637,0,0,0,0,0,0,0
HecklerSpray.com,16879,0,0,0,0,0,0,0
PerezHilton.com,16065,0,0,0,0,0,0,0
Forum Software Reviews,16941,0,0,0,0,0,0,0
"Pelican Products, Inc.",16066,0,0,0,0,0,0,0
Sunspot Tours Ltd,16801,0,0,0,0,0,0,0
Philadelphia Eagles,16869,0,0,0,0,0,0,0
NAC Vitamins Inc.,16937,0,0,0,0,0,0,0
Druva Inc.,16549,1,0,1,2,0.5,0,0.5
"Small Business Action Committee Pac, No on 30/Yes on 32",16888,0,0,0,0,0,0,0
"Boston Proper, Inc.",16892,1,0,0,1,1,0,0
Barnes Realty,16325,0,0,0,0,0,0,0
Falcon Waterfree Technologies,16342,0,0,0,0,0,0,0
Redhook Ale Brewery,16042,0,0,0,0,0,0,0
DraftKings Inc.,15689,1,0,1,2,0.5,0,0.5
"OpenTable, Inc.",16059,0,0,0,0,0,0,0
"STACK Media, Inc.",16644,0,0,1,1,0,0,1
"Massive Dynamics, Inc.",16810,0,0,0,0,0,0,0
"NGP VAN, Inc.",16459,0,0,0,0,0,0,0
Innovative Health Solutions LLC,16344,0,0,0,0,0,0,0
Candid Collections Limited,16627,0,0,0,0,0,0,0
KeyLime Cove Indoor Waterpark Resort,15557,0,0,0,0,0,0,0
Shoeboxed Inc.,16476,0,0,0,0,0,0,0
"Kofax, Inc.",16361,0,0,0,0,0,0,0
Gutter Helmet,16057,0,0,0,0,0,0,0
Columbus Chamber of Commerce,16493,0,0,1,1,0,0,1
Yes on Prop. 30,16876,0,0,0,0,0,0,0
Traveler Guitar,16878,3,0,0,3,1,0,0
Bauer Consumer Media,16893,0,0,0,0,0,0,0
Kiddie Academy of Warminster,16346,0,0,0,0,0,0,0
"Great Southern Wood Preserving, Inc.",16471,0,0,0,0,0,0,0
The Private Clinic,16632,0,0,0,0,0,0,0
Riverview Hospital,15560,0,0,0,0,0,0,0
ONE Distribution S.a.r.l,15685,0,0,0,0,0,0,0
StirlingFreePower.com,16482,0,0,0,0,0,0,0
Northcliffe Media Limited,16539,0,0,0,0,0,0,0
Cloudyn Ltd.,16064,0,0,0,0,0,0,0
CarWoo! Inc.,16489,0,0,0,0,0,0,0
John Mills Ltd.,16800,0,0,0,0,0,0,0
"Red River Securities, LLC",16071,0,0,0,0,0,0,0
Hull University Business School,16807,0,0,0,0,0,0,0
Incisive Media Limited,16875,0,0,0,0,0,0,0
New England Inns & Resorts Association,16882,0,0,0,0,0,0,0
HCL Infosystems Ltd.,15929,0,0,0,0,0,0,0
Hershey Harrisburg Visitors Bureau,15931,0,0,0,0,0,0,0
"Work World America, Inc.",16329,0,0,0,0,0,0,0
College of Arts and Architecture at Penn State,16331,0,0,0,0,0,0,0
The WEBstaurant Store,16338,0,0,0,0,0,0,0
The Picture People,16340,0,0,0,0,0,0,0
Alfa Romeo UK,16631,0,0,0,0,0,0,0
Everything Everywhere Limited,16529,0,0,0,0,0,0,0
"Experian Information Solutions, Inc.",16633,37,1,10,48,0.770833333,0.020833333,0.208333333
"Rumble Entertainment, Inc.",16531,0,0,0,0,0,0,0
Allan M. Walker Insurance Agency,16363,0,0,0,0,0,0,0
"Davinci Meetingrooms, LLC",15561,0,0,0,0,0,0,0
YouView TV Ltd.,16640,0,0,0,0,0,0,0
SmartVault Corporation,16540,0,0,0,0,0,0,0
Department of Defense Lodging,16072,0,0,0,0,0,0,0
"CODA Automotive, Inc.",16806,0,0,0,0,0,0,0
"Carlisle Wide Plank Floors, Inc",16931,0,0,0,0,0,0,0
life-localized.com,16317,0,0,0,0,0,0,0
"McMahon, Kublick & Smith, P.C.",15932,0,0,0,0,0,0,0
DOMA Theatre Co,15949,0,0,0,0,0,0,0
American Humane Association,15681,0,0,0,0,0,0,0
Tiësto,15682,0,0,0,0,0,0,0
"Boyojoy Network Technology CO.,LTD.",16635,0,0,0,0,0,0,0
JustFamily Inc.,16485,0,0,0,0,0,0,0
"ChaCha Search, Inc.",16550,0,0,0,0,0,0,0
Chef by Request,16553,0,0,0,0,0,0,0
Tulane University,16868,0,0,0,0,0,0,0
Nottingham Trent University,16871,0,0,0,0,0,0,0
"SAY Media, Inc.",16935,0,0,0,0,0,0,0
"NetworkGlobal Companies, Inc.",16332,0,0,0,0,0,0,0
Casthely Orthodontics,16464,0,0,0,0,0,0,0
Minnesota Department of Natural Resources,16339,0,0,0,0,0,0,0
Kaseya International Limited,15946,0,0,0,0,0,0,0
"Maui Condo and Home, LLC",15678,0,0,0,0,0,0,0
Adrian Flux Insurance Services,16532,0,0,0,0,0,0,0
NALEO Educational Fund,16639,0,0,0,0,0,0,0
"Kessler Enterprise, Inc.",16364,0,0,0,0,0,0,0
Michael J. Fox Foundation,16546,0,0,0,0,0,0,0
Giving.com Limited,16889,0,0,0,0,0,0,0
Gossip Cop Media,16939,0,0,0,0,0,0,0
Vale,16315,0,0,0,0,0,0,0
"Third Door Media, Inc.",16322,0,0,0,0,0,0,0
Bullet for Adolf,16345,0,0,0,0,0,0,0
Invesco Canada Ltd.,15679,0,0,0,0,0,0,0
ASAP Ventures Ltd,16481,0,0,0,0,0,0,0
"F.T. Publications, Inc",16881,0,0,0,0,0,0,0
Metropolis International Group Limited,16890,0,0,0,0,0,0,0
Südtirol Marketing Gesellschaft KGmbH,15927,0,0,0,0,0,0,0
National Accident Helpline Ltd.,15936,0,0,0,0,0,0,0
Kadish Twersky Injury Attorneys,16463,0,0,0,0,0,0,0
TSL Education Limited,16472,0,0,0,0,0,0,0
Johnston Publishing Ltd.,16474,0,0,0,0,0,0,0
Levitt Shell at Overton Park,15563,0,0,0,0,0,0,0
Texas Conservatives Fund,16063,0,0,0,0,0,0,0
TCG Ltd,16933,0,0,0,0,0,0,0
British Sky Broadcasting Group plc,16940,0,0,0,0,0,0,0
Wegmans Food Markets,15933,0,0,0,0,0,0,0
"Idea Design Studio, Inc.",16333,0,0,0,0,0,0,0
Ending Spending Action Fund,16469,0,0,0,0,0,0,0
"Monster Worldwide, Inc.",16470,2,2,5,9,0.222222222,0.222222222,0.555555556
World Singles LLC.,15684,1,0,0,1,1,0,0
PatriotsBusinessBlueprint.com,16051,0,0,0,0,0,0,0
Aldermore Bank PLC,16483,0,0,0,0,0,0,0
"Goldline International, Inc.",15566,1,0,2,3,0.333333333,0,0.666666667
The Happiness Project,16870,0,0,0,0,0,0,0
Imation Corp,16934,0,0,0,0,0,0,0
Citizens for Kim Wyman - GOP,16938,0,0,0,0,0,0,0
Floyd Nutrition LLC,16318,0,0,0,0,0,0,0
Heidi Klum Company LLC.,16467,0,0,0,0,0,0,0
Blue Cross Blue Shield of Michigan,15950,0,0,1,1,0,0,1
Music Industry Blueprint,16050,0,0,0,0,0,0,0
IronSource Israel Ltd.,16803,0,0,0,0,0,0,0
Markem-Imaje,16804,0,0,0,0,0,0,0
DistinctMedia,16936,22,1,1,24,0.916666667,0.041666667,0.041666667
Latin Trade Group,16312,0,0,0,0,0,0,0
Léman Manhattan Preparatory School,16462,0,0,0,0,0,0,0
Plus500,16337,0,0,0,0,0,0,0
Speck Products,15944,4,1,2,7,0.571428571,0.142857143,0.285714286
Amnesty International,16348,0,0,0,0,0,0,0
National Theatre,15955,0,0,0,0,0,0,0
OneFamily,16355,0,0,0,0,0,0,0
The Words Movie,16473,0,0,0,0,0,0,0
The Alliance for Pioneer Square,16537,0,0,0,0,0,0,0
"First United Realty, Inc.",16062,0,0,0,0,0,0,0
Marshfield Fair,16073,0,0,0,0,0,0,0
Giants Ridge Golf & Ski Resort,14354,0,0,0,0,0,0,0
Candelas,14854,0,0,0,0,0,0,0
SO LUXURY HMC,15639,0,0,0,0,0,0,0
Ulpan Aviv,15393,0,0,0,0,0,0,0
Washington Conservation Voters Action Fund,16944,0,0,0,0,0,0,0
Center for Union Facts,14871,0,0,0,0,0,0,0
The Ggame Institute,16812,0,0,0,0,0,0,0
IGG ONLINE GAMES,16945,1,0,0,1,1,0,0
"CenterPoint Energy Services, Inc.",16947,0,0,0,0,0,0,0
Toenail Fungus Specialist,15406,0,0,0,0,0,0,0
Wisconsin for Falk,15173,0,0,0,0,0,0,0
W. W. Norton & Company,15408,0,0,0,0,0,0,0
G-Star Inc.,16819,0,0,0,0,0,0,0
South Florida Commuter Services,14807,0,0,0,0,0,0,0
Paranormal Activity 4 Movie,16948,0,0,0,0,0,0,0
Trinity Mirror Plc,16822,0,0,0,0,0,0,0
"Davis, Hibbitts & Midghall, Inc.",14888,0,0,0,0,0,0,0
Travel Weekly Group Ltd.,16955,0,0,0,0,0,0,0
Limelight Hotel,14605,0,0,0,0,0,0,0
RegWonder,16824,0,0,0,0,0,0,0
Palm Beach Atlantic University,15412,0,0,0,0,0,0,0
Council for Disability Awareness,16816,0,0,0,0,0,0,0
YES ON 38,16830,0,0,0,0,0,0,0
"TIMZON, LLC",15409,0,0,0,0,0,0,0
"GovX, Inc.",15405,1,0,0,1,1,0,0
"Fare Buzz, Inc.",15396,0,0,0,0,0,0,0
"BermanBraun Interactive, LLC",16958,0,0,0,0,0,0,0
SK Europe BV,15419,0,0,0,0,0,0,0
The Lotus Group,16960,0,0,0,0,0,0,0
Synth-tec Inc.,15413,0,0,0,0,0,0,0
California Department of Public Health,15397,0,0,0,0,0,0,0
GayCities Inc.,16966,0,0,0,0,0,0,0
"TextureMedia, Inc.",16834,0,0,0,0,0,0,0
Motorola Mobility LLC,15418,113,48,3,164,0.68902439,0.292682927,0.018292683
Dermal Meds,16866,0,0,0,0,0,0,0
"Savannahnow.com (Morris Publishing Group, LLC)",15410,0,0,0,0,0,0,0
Malaysia Airlines,16826,0,0,0,0,0,0,0
Appinions Inc.,16837,0,0,0,0,0,0,0
David Lloyd Leisure Ltd.,15420,0,0,0,0,0,0,0
Markco Media Ltd.,16849,0,0,0,0,0,0,0
Today's Military,16833,0,0,0,0,0,0,0
"Shenzhen Dan Hong Hao Tian E-commerce Co., Ltd",16828,0,0,0,0,0,0,0
"Michael M, Inc.",16841,0,0,0,0,0,0,0
Commission on the Promotion of Peru,16983,0,0,0,0,0,0,0
Comenity LLC,15426,0,0,0,0,0,0,0
TWLV Gaming Limited,16817,0,0,0,0,0,0,0
Value Retail PLC,16961,0,0,0,0,0,0,0
M. Graham & Co.,15429,0,0,0,0,0,0,0
Center Parcs Ltd,16848,0,0,0,0,0,0,0
IDG World Expo,15430,0,0,0,0,0,0,0
MIG Capital (Europe) Limited,16972,0,0,0,0,0,0,0
IConsumerKnowledge,16648,0,0,0,0,0,0,0
ITW Global Brands,16077,0,0,0,0,0,0,0
Lakeland,17058,0,0,0,0,0,0,0
Oddee,16957,0,0,1,1,0,0,1
Graeter’s Manufacturing Company,15434,0,0,0,0,0,0,0
Atlantic Media Co.,16969,0,0,0,0,0,0,0
"OraSure Technologies, Inc.",16843,1,0,0,1,1,0,0
New York Comic Con,17065,0,0,0,0,0,0,0
"AMR Direct, LLC",16963,2,1,0,3,0.666666667,0.333333333,0
U.S. Chamber Institute for Legal Reform,17131,0,0,0,0,0,0,0
Heathrow Airport Limited,16990,0,0,0,0,0,0,0
BetOnline.ag,16087,0,0,0,0,0,0,0
surveycabana.com,15414,1,0,0,1,1,0,0
"Netflix, Inc.",16977,86,6,11,103,0.834951456,0.058252427,0.106796117
JOE GARCIA FOR CONGRESS,16647,0,0,0,0,0,0,0
The ConsumerREVIEW.com Network,16655,1,0,1,2,0.5,0,0.5
ETX Capital,16979,0,0,0,0,0,0,0
Delimiter,17124,0,0,0,0,0,0,0
"Wrike, Inc.",16081,0,0,0,0,0,0,0
The Hole Movie,16835,0,0,0,0,0,0,0
Davidson Realty Inc.,16086,0,0,0,0,0,0,0
Jewellery Quarter Bullion Ltd.,16660,0,0,0,0,0,0,0
"Tampa Media Group, Inc",17099,0,0,1,1,0,0,1
Body By Bison,16825,0,0,0,0,0,0,0
"JAG Footwear, Accessories and Retail Corporation",16851,0,0,0,0,0,0,0
Suzuki,16991,0,0,1,1,0,0,1
PrimoHoagies Inc.,15423,0,0,0,0,0,0,0
"FoodShouldTasteGood, Inc.",16968,0,0,0,0,0,0,0
Nexternal,17083,6,0,0,6,1,0,0
Hello Direct,17167,0,0,0,0,0,0,0
EDF Energy London Eye,16856,0,0,0,0,0,0,0
Commonwealth Learning Center,16085,0,0,0,0,0,0,0
American Society for Training & Development,17090,0,0,0,0,0,0,0
The Grubb Company,17155,0,0,0,0,0,0,0
BDW Trading Limited,16654,0,0,0,0,0,0,0
Green Coffee Ultra,15425,0,0,0,0,0,0,0
Creneau International USA Inc.,16998,0,0,0,0,0,0,0
MahiFX Ltd.,16864,0,0,0,0,0,0,0
The Ambassador Theatre Group Limited,16971,0,0,0,0,0,0,0
IAFF FIREPAC,17108,0,0,0,0,0,0,0
Micromine Pty Ltd,16962,0,0,0,0,0,0,0
Milestone AV Technologies,17176,0,0,0,0,0,0,0
BrainHealthKit.com,16853,0,0,0,0,0,0,0
Hagerstown Convention Visitors Bureau,15424,0,0,0,0,0,0,0
HealthBoards.com,16854,0,0,0,0,0,0,0
Combe Incorporated,16858,0,0,0,0,0,0,0
"Golfland Entertainment Centers, Inc.",16091,0,0,0,0,0,0,0
Home Retail Group,16995,0,0,0,0,0,0,0
"Life is Good, Inc.",16090,0,0,0,0,0,0,0
"MDHearingAid, Inc.",15421,0,0,0,0,0,0,0
Kotz Heating & Air Conditioning,16651,0,0,0,0,0,0,0
The Share Centre Limited,16656,0,0,0,0,0,0,0
UnfriendApp,16996,0,0,0,0,0,0,0
puertoricogetaways.com,15428,0,0,0,0,0,0,0
Timber Ridge at Talus,16658,0,0,0,0,0,0,0
Spring Grove,16985,0,0,1,1,0,0,1
"Wright Medical Technology, Inc.",16852,0,0,0,0,0,0,0
"Moonshadow eCommerce, Inc.",17010,0,0,0,0,0,0,0
WowWee Group Limited,17003,0,0,0,0,0,0,0
Pearl.com LLC,17126,0,0,0,0,0,0,0
Today’s Home Inc.,17149,0,0,0,0,0,0,0
Solutions From Science,16988,0,0,0,0,0,0,0
Home Office (UK),16980,0,0,0,0,0,0,0
RM Books Limited,17154,0,0,0,0,0,0,0
Stena Line Limited,16984,0,0,0,0,0,0,0
Easy Forex Trading Ltd,16994,0,0,1,1,0,0,1
"Film Independent, Inc.",17092,0,0,0,0,0,0,0
The Carvel Corporation,16089,0,0,0,0,0,0,0
Vitabiotics Ltd.,17059,0,0,0,0,0,0,0
B&Q plc,17158,0,0,0,0,0,0,0
Pacific Legal Foundation,17103,0,0,0,0,0,0,0
Ebuyer Ltd,16857,0,0,0,0,0,0,0
OAF LLC,17001,0,0,0,0,0,0,0
Blessed Herbs,17104,0,0,0,0,0,0,0
HEI/GC Hollywood & Vine Condominium LLC,17009,0,0,0,0,0,0,0
MagnetStreet,17062,0,0,0,0,0,0,0
Huntington Beach Marketing and Visitors Bureau,16982,0,0,0,0,0,0,0
EUROLEAGUE PROPERTIES S.A.,17066,0,0,0,0,0,0,0
Express Gold Cash,17002,0,0,0,0,0,0,0
Last Minute Network Limited,17076,0,0,0,0,0,0,0
Curbed.com LLC,17060,0,0,2,2,0,0,1
Octagon Developments Ltd.,17070,0,0,0,0,0,0,0
RichMen Incorporated,17128,0,0,0,0,0,0,0
"The Light Group, Inc",17057,0,0,0,0,0,0,0
Maytag Corporation,17134,29,18,8,55,0.527272727,0.327272727,0.145454545
Royal Opera House,17161,0,0,0,0,0,0,0
University of Central Lancashire,17168,0,0,0,0,0,0,0
Gleeson Homes Ltd,17005,0,0,0,0,0,0,0
Chaplin the Musical,17125,0,0,0,0,0,0,0
Hainan Airlines,17123,6,2,0,8,0.75,0.25,0
Juice Beauty,17082,0,0,0,0,0,0,0
Qype Limited,17100,0,0,0,0,0,0,0
Ferrari,17130,2,0,0,2,1,0,0
DIYchef.com,17084,0,0,0,0,0,0,0
Curtin University,17077,0,0,0,0,0,0,0
nanoRep Technologies LTD,17145,0,0,0,0,0,0,0
Boots UK Limited,17148,0,0,0,0,0,0,0
"The Daily Holdings, Inc.",17096,0,0,0,0,0,0,0
French National Railways (SNCF),17159,0,0,0,0,0,0,0
"ThermoSpas Hot Tub Products, Inc.",17109,1,0,0,1,1,0,0
British Heart Foundation,17138,0,0,0,0,0,0,0
Insight Cuba,17172,0,0,0,0,0,0,0
"Changewave, Inc.",17088,0,0,0,0,0,0,0
Diet Revolutionn,17152,0,0,0,0,0,0,0
"Personal Retailing, Inc.",17102,0,0,0,0,0,0,0
"Praise.com, Inc.",17105,0,0,0,0,0,0,0
"Ross Stores, Inc.",17164,44,4,9,57,0.771929825,0.070175439,0.157894737
"Lytro, Inc.",17079,0,0,0,0,0,0,0
Sainsbury,17143,0,0,0,0,0,0,0
Arcadia Group Brands Limited,17094,0,0,0,0,0,0,0
mySupermarket Limited,17160,0,0,0,0,0,0,0
JustFab (UK) Limited,17162,0,0,1,1,0,0,1
The Oranges Movie,16744,0,0,0,0,0,0,0
The UNITE Group Plc,16827,0,0,0,0,0,0,0
[x+1] Origin,16959,0,0,0,0,0,0,0
"Mediaite, LLC",16846,0,0,0,0,0,0,0
Strathclyde Fire & Rescue,16978,0,0,0,0,0,0,0
Premera Blue Cross,16661,1,0,0,1,1,0,0
Hankook Tire America Corp.,17146,1,0,0,1,1,0,0
EMP-Survival,17093,0,0,0,0,0,0,0
Connecticut Office of Tourism,17095,0,0,0,0,0,0,0
zeebox,17163,0,0,0,0,0,0,0
Hargreaves Lansdown PLC,16951,0,0,0,0,0,0,0
Hologic Inc.,16952,0,0,0,0,0,0,0
"Snap My Life, Inc.",16820,0,0,0,0,0,0,0
"ERC Services, Inc.",15416,0,0,0,0,0,0,0
MicroCap,16970,0,0,0,0,0,0,0
Interactive Investor Plc.,16652,0,0,0,0,0,0,0
Nuclear Media LLC,17069,0,0,0,0,0,0,0
Pratt Institute,17137,0,0,0,0,0,0,0
iPhone-Unlocker-Pro,17087,0,0,1,1,0,0,1
Royal National Lifeboat Institution,17169,0,0,0,0,0,0,0
Netbasic Limited,16953,0,0,0,0,0,0,0
Caldwell Consumer Health LLC,16821,6,0,0,6,1,0,0
OutSystems,16082,0,0,0,0,0,0,0
The Glimmerglass Festival,15431,0,0,0,0,0,0,0
lowcarbmagazine.com,15432,0,0,0,0,0,0,0
Little Black Bag,16653,0,0,0,0,0,0,0
Appliances Online Pty Ltd,17068,0,0,0,0,0,0,0
"Minyanville Media, Inc.",17071,0,0,0,0,0,0,0
Sanlam,17135,0,0,0,0,0,0,0
Flipquotes.com,17153,0,0,0,0,0,0,0
Executive Information Service of the Office of the First Minister and Deputy First Minister,16946,0,0,0,0,0,0,0
"Soteria Systems, LLC",16829,0,0,0,0,0,0,0
"UCM/SREP-Corporate Woods, LLC",16076,0,0,0,0,0,0,0
American Indian College Fund,16976,0,0,0,0,0,0,0
"Freedom Communications, Inc.",16859,0,0,1,1,0,0,1
ShipCarsNow,16993,0,0,0,0,0,0,0
Masterfile Corporation,17061,0,0,0,0,0,0,0
The Seattle Marathon Association,17063,0,0,0,0,0,0,0
Sylvane Inc.,17127,0,0,0,0,0,0,0
Heller for Senate,17129,0,0,0,0,0,0,0
KentuckyOne Health,17078,0,0,1,1,0,0,1
Bellalabs,17080,0,0,0,0,0,0,0
The Pharmaceutical Research and Manufacturers of America (PhRMA),17144,0,0,0,0,0,0,0
AirTreks,17110,0,0,0,0,0,0,0
William Greenberg Desserts,15403,0,0,0,0,0,0,0
Ducati Motor Holding S.p.A.,16950,5,0,0,5,1,0,0
"TLA Entertainment Group, Inc.",16832,0,0,0,0,0,0,0
ProMexico,16078,0,0,0,0,0,0,0
Las Vegas Chamber of Commerce,16646,0,0,0,0,0,0,0
Brother UK Limited,16839,0,0,0,0,0,0,0
Weinberger Law Group LLC,17000,0,0,0,0,0,0,0
CarInsureMe.com,17007,0,0,0,0,0,0,0
Protect Working Families,17064,0,0,0,0,0,0,0
"Barefoot Books, Inc.",17150,0,0,0,0,0,0,0
Scenic Tours,17157,0,0,1,1,0,0,1
"Wandertec, Inc.",17107,0,0,0,0,0,0,0
"Maven Marketing, LLC",17175,9,0,0,9,1,0,0
Fordham University,16863,3,0,0,3,1,0,0
"Transformations Treatment Center, Inc",16838,0,0,0,0,0,0,0
Pacific Pillows,15427,0,0,0,0,0,0,0
Le Creuset UK Limited,16867,0,0,0,0,0,0,0
Dunster House Ltd.,16974,0,0,0,0,0,0,0
"Family Heating, Cooling & Electrical, Inc.",17006,0,0,1,1,0,0,1
Driver Solutions Network,17008,1,0,0,1,1,0,0
Venture Marketing Group Limited,17133,0,0,0,0,0,0,0
Joy & Grace Music,17140,0,0,0,0,0,0,0
The Rhythm Organism LLC,17142,0,0,0,0,0,0,0
"BestOfVegas.com, LLC.",17097,0,0,0,0,0,0,0
"Flavorpill Productions, LLC",17174,0,0,0,0,0,0,0
"NHPMN Management, LP",15400,0,0,0,0,0,0,0
"Anschutz Entertainment Group, Inc.",16818,4,0,1,5,0.8,0,0.2
"Luxottica Retail North America, Inc.",16954,0,0,0,0,0,0,0
Gorman Real Estate,15417,0,0,0,0,0,0,0
"Golf Experiences, LLC",16836,1,0,0,1,1,0,0
Game Retail Limited,16650,0,0,0,0,0,0,0
Napa Valley Vintners,16986,0,0,0,0,0,0,0
GTE Financial,17004,0,0,0,0,0,0,0
Island Insurance Companies,17136,0,0,0,0,0,0,0
Wanderspot LLC,17085,0,0,0,0,0,0,0
Mackinac Island Tourism Bureau,17086,0,0,0,0,0,0,0
"Mr. Light, Inc.",17171,0,0,0,0,0,0,0
JUST-EAT.CO.UK LTD,16814,0,0,0,0,0,0,0
"Coed Media Group, LLC",16964,0,0,0,0,0,0,0
Immediate Media Company Limited,16850,0,0,0,0,0,0,0
"Concierge Auctions, LLC.",16657,0,0,0,0,0,0,0
Philippine Daily Inquirer,16989,0,0,1,1,0,0,1
US Money Reserve,17132,0,0,0,0,0,0,0
Howard Hanna Real Estate Services,17075,0,0,0,0,0,0,0
MyoNatural,17089,0,0,0,0,0,0,0
America's Cup Event Authority LLC,16813,0,0,0,0,0,0,0
Agriculture and Horticulture Development Board,16815,0,0,0,0,0,0,0
TheCelebrityCafe.com LLC,16956,0,0,0,0,0,0,0
The Donmar Warehouse,15411,0,0,0,0,0,0,0
APL Federal Credit Union,16079,0,0,0,0,0,0,0
Trunk Club Inc.,16847,7,1,0,8,0.875,0.125,0
YES on 1240 Washington Coalition for Public Charter Schools,16649,0,0,0,0,0,0,0
"Caelo Media, LLC",16981,0,0,0,0,0,0,0
"The Refrigeration School, Inc.",17081,0,0,0,0,0,0,0
Alliance Trust PLC,17147,0,0,0,0,0,0,0
Hearing-Aid.com,17151,0,0,0,0,0,0,0
PartyGalaxy.com,15395,0,0,0,0,0,0,0
Commonwealth of Pennsylvania,15322,0,0,0,0,0,0,0
Indiegogo Inc.,15190,15,2,0,17,0.882352941,0.117647059,0
FilesFrog Downloads,15573,6,0,2,8,0.75,0,0.25
"Bandwidth.com, Inc.",15324,0,0,0,0,0,0,0
"The Related Companies, L.P.",16746,0,0,1,1,0,0,1
English Heritage,16750,0,0,0,0,0,0,0
Greenwich Hospital,15575,0,0,0,0,0,0,0
Multiplay Networks Limited,16749,0,0,0,0,0,0,0
The Polyclinic,16751,0,0,0,0,0,0,0
Huntington Theatre Company,16896,0,0,0,0,0,0,0
Perkins School for the Blind,15456,0,0,0,0,0,0,0
"Aereo, Inc",17015,67,8,0,75,0.893333333,0.106666667,0
learndirect Ltd,17017,0,0,0,0,0,0,0
Dominican University,15458,0,0,0,0,0,0,0
Ladbrokes plc,16758,0,0,0,0,0,0,0
Massachusetts College of Pharmacy and Health Sciences,15256,0,0,0,0,0,0,0
College Overview,15339,0,0,0,0,0,0,0
Samuel Curtis Johnson Graduate School of Management,16748,0,0,0,0,0,0,0
REFERENCE MEDIA INC.,15826,0,0,0,0,0,0,0
TUI Travel plc,16755,0,0,0,0,0,0,0
Glenn Auto Mall,16716,0,0,0,0,0,0,0
DivaMall.tv,16752,0,0,0,0,0,0,0
SEE GROUP LIMITED,15258,0,0,0,0,0,0,0
Design Institute of San Diego,15207,0,0,0,0,0,0,0
Classic Pianos,16719,0,0,0,0,0,0,0
Athletic Xtreme,16901,0,0,0,0,0,0,0
Sainsbury’s Guernsey PCC Limited,16720,0,0,0,0,0,0,0
"Ultratec, Inc.",15273,0,0,0,0,0,0,0
Find My School,17119,0,0,0,0,0,0,0
"Alpha Beta Benefits, LLC.",15607,0,0,0,0,0,0,0
Scandalous the Musical,17037,0,0,0,0,0,0,0
"Adiamor, Inc.",15856,0,0,0,0,0,0,0
Pennsylvania Hypnosis Center,15624,0,0,0,0,0,0,0
St. Louis Resurfacing,15960,0,0,0,0,0,0,0
"Advance Devices, Inc.",16026,1,0,0,1,1,0,0
TransWorld SKATEboarding,15907,0,0,0,0,0,0,0
London South Bank University,15756,0,0,0,0,0,0,0
Centene Corporation,15373,0,0,0,0,0,0,0
InterWebSphere,15641,0,0,0,0,0,0,0
Citroën,16009,0,0,0,0,0,0,0
ChinaOnTV inc.,16375,0,0,0,0,0,0,0
WedOnWeb.net,16211,0,0,0,0,0,0,0
Special Olympics Oregon,15524,0,0,0,0,0,0,0
"Kenan Advantage Group, Inc.",16441,0,0,0,0,0,0,0
St. Bonaventure University,16409,0,0,0,0,0,0,0
Merritt Hospitality,13469,0,0,0,0,0,0,0
Ski Colorado,16692,0,0,0,0,0,0,0
Unitus Community Credit Union,15673,0,0,0,0,0,0,0
Farm Bureau Insurance,16311,0,0,0,0,0,0,0
Amanda Palmer,17028,0,0,0,0,0,0,0
"Medical Informatics Engineering, Inc.",16903,0,0,0,0,0,0,0
Centura Health,16734,10,0,0,10,1,0,0
Teachers Assurance,17030,0,0,0,0,0,0,0
The House I Live In Movie,17205,0,0,0,0,0,0,0
"Hollywood Network, Inc.",17038,0,0,0,0,0,0,0
"Regal Assets, LLC",16756,0,0,0,0,0,0,0
Muller Quaker Dairy LLC,16916,0,0,0,0,0,0,0
Bohemia Interactive a.s.,16770,0,0,0,0,0,0,0
Bredbury Hall Hotel and Country Club,17022,0,0,0,0,0,0,0
The United Food and Commercial Workers International Union,16718,0,0,0,0,0,0,0
EchoLight Studios,16722,0,0,0,0,0,0,0
BAE Systems plc,17117,0,0,0,0,0,0,0
Domain San Diego,17051,0,0,0,0,0,0,0
North Lanarkshire’s Working,16898,0,0,0,0,0,0,0
Internaxx Bank,17032,0,0,0,0,0,0,0
"Have a Sweet Life, Inc.",16915,0,0,0,0,0,0,0
Elliott Wave International,16759,0,0,0,0,0,0,0
XOXO LLC,16906,0,0,0,0,0,0,0
"Serious Eats, LLC",17052,15,0,10,25,0.6,0,0.4
Bourne Leisure Ltd,16905,0,0,0,0,0,0,0
LRB Ltd,17036,0,0,0,0,0,0,0
Saxo Bank,17031,0,0,0,0,0,0,0
EmpireCovers,17190,0,0,0,0,0,0,0
Immigration Direct,17027,0,0,0,0,0,0,0
Boeing Classic,17116,0,0,0,0,0,0,0
East Coast Main Line Company Limited,16922,0,0,0,0,0,0,0
"Country Curtains, Inc.",17033,0,0,0,0,0,0,0
The Student Room Group Ltd.,17013,0,0,0,0,0,0,0
Moneysupermarket.com Financial Group Limited,16913,0,0,0,0,0,0,0
Black Enterprise,17215,0,0,0,0,0,0,0
MamaPop LLC,17255,0,0,0,0,0,0,0
192.com Limited,16921,0,0,0,0,0,0,0
Corbus Inc.,16914,0,0,0,0,0,0,0
Friends of Jack Connelly,17219,0,0,0,0,0,0,0
"TUGUU, S.L.U.",16728,5,0,1,6,0.833333333,0,0.166666667
Germanwings,16912,0,0,1,1,0,0,1
Desjardins Group,17191,0,0,0,0,0,0,0
IRSTaxLevyRelief.org,17252,0,0,0,0,0,0,0
Best Credit Repair Companys,16669,0,0,0,0,0,0,0
"Fresh Direct, LLC.",16735,0,0,0,0,0,0,0
"Ranch and Home Supply, LLC.",16721,1,0,1,2,0.5,0,0.5
Sargento Foods Inc,17217,0,0,0,0,0,0,0
The List Ltd.,16729,0,0,0,0,0,0,0
"Brightwurks, Inc.",17203,0,0,0,0,0,0,0
S&P Dow Jones Indices LLC,16730,0,0,0,0,0,0,0
Opsgear Inc.,17113,0,0,0,0,0,0,0
3rd Ward,17196,0,0,0,0,0,0,0
Data & Audio-Visual Enterprises Wireless Inc.,17195,0,0,0,0,0,0,0
Pearson College Ltd,16763,0,0,0,0,0,0,0
Arena Illustration,17047,0,0,0,0,0,0,0
Play Faire Productions,16779,0,0,0,0,0,0,0
PrinterBase Ltd,17055,0,0,0,0,0,0,0
Millersville University,16787,0,0,0,0,0,0,0
The British Library Board,17204,0,0,0,0,0,0,0
"Lucky Money, Inc.",17249,0,0,0,0,0,0,0
Wind Creek Casino & Hotel,17319,0,0,0,0,0,0,0
"Sprout Social, Inc.",17253,0,0,0,0,0,0,0
Green Coffee Bean Max,17269,9,1,10,20,0.45,0.05,0.5
"Backupify, Inc.",17337,0,0,0,0,0,0,0
Stand With Servicewomen,17056,0,0,0,0,0,0,0
Crain Communications Inc.,17040,0,0,0,0,0,0,0
uSwitch Limited,17313,0,0,0,0,0,0,0
Duke’s Chowder House,17270,0,0,0,0,0,0,0
"Sourcefire, Inc.",17226,2,0,0,2,1,0,0
"Buoyweather, Inc.",17236,0,0,0,0,0,0,0
Ing. Punzenberger COPA-DATA GmbH,17272,0,0,0,0,0,0,0
Performics,17026,0,0,0,0,0,0,0
Heart Internet Limited,16792,0,0,0,0,0,0,0
"Fire Rock Products, LLC",16771,0,0,0,0,0,0,0
Tourism Authority of Thailand,16269,0,0,0,0,0,0,0
"Freescale Semiconductor, Inc.",16666,0,0,1,1,0,0,1
Breeders’ Cup Limited,17250,0,0,0,0,0,0,0
NewHomeDifference.org,17194,0,0,0,0,0,0,0
ReadMob Technologies (HK) Limited,16780,0,0,0,0,0,0,0
San Franciscans for Fair Taxes and Better City Services,17315,0,0,0,0,0,0,0
The Leisure Pass Group Limited,17437,0,0,0,0,0,0,0
OEMPCWorld,16268,0,0,0,0,0,0,0
MBNA Europe Bank Limited,16794,0,0,0,0,0,0,0
viagogo AG,17043,0,0,0,0,0,0,0
Wilmington and Beaches CVB,17041,0,0,0,0,0,0,0
Coveo Solutions Inc.,17377,0,0,0,0,0,0,0
Kilimanjaro Live Limited,16766,0,0,0,0,0,0,0
American Giant,17387,0,0,0,0,0,0,0
"InsideView, Inc.",17044,0,0,0,0,0,0,0
GoodGradesGuide.com,17198,0,0,0,0,0,0,0
Caldwell for Mayor,17388,0,0,0,0,0,0,0
"Rocket Matter, LLC.",17258,0,0,0,0,0,0,0
DealExtreme,17045,0,0,0,0,0,0,0
University of Derby,17352,0,0,0,0,0,0,0
UFXMarkets,16584,0,0,0,0,0,0,0
Super PAC for America,17216,0,0,0,0,0,0,0
"EZLinks Golf, Inc.",17369,0,0,0,0,0,0,0
Home Learning College,17279,0,0,0,0,0,0,0
cheapcarinsurancetrick.com,17438,0,0,0,0,0,0,0
Liberty Ltd,17042,0,0,0,0,0,0,0
"Bill.com, Inc",17355,0,0,0,0,0,0,0
"Kent Nutrition Group, Inc.",17248,0,0,0,0,0,0,0
Davenport University,16733,3,2,0,5,0.6,0.4,0
Jellyfish Online Marketing Ltd.,16782,0,0,0,0,0,0,0
Regents of the University of Minnesota,17309,0,0,0,0,0,0,0
Silent Furnace,17224,0,0,0,0,0,0,0
Imperial War Museums (IWM),17201,0,0,0,0,0,0,0
"4CONTROL Media, Inc.",17436,0,0,0,0,0,0,0
Green Man Gaming Limited,17370,0,0,0,0,0,0,0
East Midlands Airport Limited,16788,0,0,0,0,0,0,0
Northumbria University,17354,0,0,0,0,0,0,0
Bank of Ireland Group,16773,0,0,0,0,0,0,0
"Haggen, Inc.",17317,0,0,0,0,0,0,0
Benesse America Inc.,16275,0,0,0,0,0,0,0
"InterCall, Inc.",16284,0,0,0,0,0,0,0
SpiritHoods,17326,0,0,0,0,0,0,0
National Education Association,16774,0,0,0,0,0,0,0
Landmark Collection,17209,0,0,0,0,0,0,0
XLN Telecom Limited,16798,0,0,0,0,0,0,0
"JVL Ventures, LLC",17310,0,0,0,0,0,0,0
NGC Europe Limited,16673,0,0,0,0,0,0,0
Children's Cancer Association,17402,0,0,0,0,0,0,0
DIANA VREELAND,16790,0,0,0,0,0,0,0
Aggregate Industries Limited,17381,0,0,0,0,0,0,0
Cardiff Metropolitan University,17266,0,0,0,0,0,0,0
aProvenProduct.com,17314,0,0,0,0,0,0,0
Silverstone Circuits Limited,17406,0,0,0,0,0,0,0
CALA Management Limited,16277,0,0,0,0,0,0,0
"Comfort Medical Medical, LLC",17241,0,0,0,0,0,0,0
"StyleCaster, Inc.",17208,0,0,0,0,0,0,0
The Independent Institute,16262,0,0,0,0,0,0,0
DownloadWiz.com,17324,2,0,0,2,1,0,0
Duluth Trading Company,16600,0,0,0,0,0,0,0
"Right Stuf, Inc.",17229,0,0,0,0,0,0,0
"List Partners, Inc.",16672,0,0,0,0,0,0,0
Yes on Proposition 33,17305,0,0,0,0,0,0,0
Exposures Online,16793,0,0,0,0,0,0,0
Sogame,17371,0,0,0,0,0,0,0
Cupcake Vineyards,17455,0,0,1,1,0,0,1
HDIS Inc.,17334,0,0,0,0,0,0,0
Coral Group Trading Ltd,16579,0,0,0,0,0,0,0
Hooya Digital Ltd.,17555,0,0,0,0,0,0,0
Muscle Meals Inc,17294,0,0,0,0,0,0,0
Grand Prix of Baltimore,16261,0,0,0,0,0,0,0
MI Money Ltd.,16580,0,0,0,0,0,0,0
COOLDOWNLOADMANAGER.COM,17306,0,0,0,0,0,0,0
Institute of Advanced Motorists,17384,0,0,0,0,0,0,0
"FindTheBest.com, Inc.",16601,0,0,0,0,0,0,0
urevive,17391,0,0,0,0,0,0,0
Southern California Earthquake Center,17383,0,0,0,0,0,0,0
Colleen O'Brien For Michigan Supreme Court,17264,0,0,0,0,0,0,0
"Free Image Editor, LLC",17303,0,0,0,0,0,0,0
The Stage Media Company Limited,17232,0,0,0,0,0,0,0
Baker College Online,17247,0,0,0,0,0,0,0
GNP Company,17452,0,0,0,0,0,0,0
MicroStrategy Inc.,17394,3,2,0,5,0.6,0.4,0
"ACT Teleconferencing, Inc.",17239,0,0,0,0,0,0,0
Treasury Vault LLC,17329,0,0,0,0,0,0,0
"Liftopia, Inc.",17281,0,0,0,0,0,0,0
"Entertonement, Inc.",17620,0,0,0,0,0,0,0
SKYFALL Movie,17351,0,0,0,0,0,0,0
The Balvenie Distillery Company Limited,17246,0,0,0,0,0,0,0
Kids Live Safe,17623,0,0,0,0,0,0,0
English National Opera,17325,0,0,0,0,0,0,0
Gold Medal Travel Group Plc,16674,0,0,0,0,0,0,0
Netherlands Flower Bulb Information Center,16581,0,0,0,0,0,0,0
Ravensworth Digital Services Limited,17556,0,0,0,0,0,0,0
Trans-Uber Publishing,17636,0,0,0,0,0,0,0
Adventist Health,17283,8,2,0,10,0.8,0.2,0
The Artist Movie,17687,0,0,0,0,0,0,0
The Hunger Games Movie,17690,0,0,0,0,0,0,0
Beko plc,17231,0,0,0,0,0,0,0
Leon Max Inc.,17392,1,0,0,1,1,0,0
"Delta Defense, LLC",16292,7,1,0,8,0.875,0.125,0
Vintage Wine Estates,17654,0,0,0,0,0,0,0
Finance & Business Training (FBT),17211,0,0,0,0,0,0,0
Anyvan Ltd.,17462,0,0,0,0,0,0,0
"Thane International, Inc.",17265,0,0,0,0,0,0,0
Freesat (UK) Ltd,17275,0,0,0,0,0,0,0
Alitalia - Compagnia Aerea Italiana S.p.A.,17290,0,0,0,0,0,0,0
Audiofly Pty Ltd.,17240,0,0,0,0,0,0,0
Backyard Liberty,17772,0,1,0,1,0,1,0
Tune Hotels.com (BVI) Limited,17628,0,0,0,0,0,0,0
"Medallion Media Group, Inc.",16279,0,0,0,0,0,0,0
VMR Products LLC.,17341,0,0,0,0,0,0,0
Fat Face Limited,17374,0,0,0,0,0,0,0
University of Toledo,17645,0,0,0,0,0,0,0
Le Petit Fils de L.U. Chopard & Cie SA,17260,0,0,0,0,0,0,0
Hotel Transylvania Movie,16588,0,0,0,0,0,0,0
"Gift Card Impressions, LLC",17904,0,0,0,0,0,0,0
"JOBY, Inc.",17638,0,0,0,0,0,0,0
Vivid Seats Ltd.,16578,2,0,0,2,1,0,0
Yesup Ecommerce Solutions Inc.,17292,0,0,0,0,0,0,0
Mount Airy Casino Resort,16281,0,0,0,0,0,0,0
"Alloy Merchandise, LLC",18021,0,0,0,0,0,0,0
WANN,16288,0,0,0,0,0,0,0
The University of Abertay Dundee,17637,0,0,0,0,0,0,0
The Intouchables Movie,17688,0,0,0,0,0,0,0
"RareInk, Inc.",17441,0,0,0,0,0,0,0
Any Day Now Movie,17747,0,0,0,0,0,0,0
Million Dollar Quartet Musical,17756,0,0,0,0,0,0,0
The Codemasters Software Company Limited,16590,0,0,0,0,0,0,0
"Curves International, Inc.",18022,0,0,0,0,0,0,0
Big Yellow Self Storage Company Ltd.,16582,0,0,0,0,0,0,0
Rice Select,17280,0,0,0,0,0,0,0
WellPet LLC,16290,6,0,0,6,1,0,0
Trivago International,17449,2,0,1,3,0.666666667,0,0.333333333
Pure Green Coffee,17350,1,0,0,1,1,0,0
Y R Central,17656,3,0,0,3,1,0,0
The Environment Agency,17348,0,0,0,0,0,0,0
FX Global Markets,17770,0,0,0,0,0,0,0
Bloomfield for Congress,17311,0,0,0,0,0,0,0
Shelley Berkley for Senate,16797,0,0,0,0,0,0,0
Bonaventure Funeral Home,16274,0,0,0,0,0,0,0
Wanderlust Movie,17773,0,0,0,0,0,0,0
"Bridgestone Americas Tire Operations, LLC.",16278,5,0,3,8,0.625,0,0.375
Angelcare Monitors Inc.,17451,0,0,0,0,0,0,0
A Haunted House Movie,17755,0,0,0,0,0,0,0
"Vocus PRW Holdings, LLC",16276,2,0,0,2,1,0,0
Manchester City Football Club Limited,17376,0,0,0,0,0,0,0
"Citizens United Productions No. 3, LLC",16591,0,0,0,0,0,0,0
"Lane Bryant, Inc.",17412,9,1,0,10,0.9,0.1,0
Heelys Inc.,17764,0,0,0,0,0,0,0
GMO Cloud America Inc.,17262,0,0,0,0,0,0,0
Quidsi Solutions LLC,17881,0,0,0,0,0,0,0
"Studio One Networks, Inc.",17887,0,0,0,0,0,0,0
"Special Operations OPSEC Education Fund, Inc.",17448,0,0,0,0,0,0,0
British Empire Securities and General Trust plc.,17949,0,0,0,0,0,0,0
The American Cancer Society Cancer Action Network (ACS CAN),17373,0,0,0,0,0,0,0
"Taos Ski Valley, Inc.",18091,0,0,0,0,0,0,0
Clark Labs,17458,0,0,0,0,0,0,0
Syneron Beauty Inc.,18089,0,0,0,0,0,0,0
Dallas Museum of Art,17291,0,0,0,0,0,0,0
Jim Graves for Congress Committee,16613,0,0,0,0,0,0,0
Gate 1 Travel,18090,0,0,0,0,0,0,0
CJ E&M CORPORATION,17184,0,0,0,0,0,0,0
Vue Entertainment Limited,17228,0,0,0,0,0,0,0
"Opper Sports, Inc",16615,0,0,0,0,0,0,0
Snitch Movie,18015,0,0,0,0,0,0,0
Sheffield Hallam University,17641,0,0,0,0,0,0,0
"Rigzone.com, Inc.",16280,0,0,0,0,0,0,0
"Direct Wines, Inc.",17331,4,0,2,6,0.666666667,0,0.333333333
Cloggs (UK) Limited,18205,0,0,0,0,0,0,0
Glutino Food Group,17558,0,0,0,0,0,0,0
The Expendables 2 Movie,17691,0,0,0,0,0,0,0
Red Bull GmbH,17230,15,0,6,21,0.714285714,0,0.285714286
Post Office Limited,16610,0,0,0,0,0,0,0
Backbone Connect Ltd.,17652,0,0,0,0,0,0,0
Boardwalk Beach Resort,17359,0,0,0,0,0,0,0
"Sport Events, LLC.",17648,0,0,0,0,0,0,0
Okemo Mountain Resort,18096,0,0,0,0,0,0,0
"Boomers and Beyond, Inc.",17649,0,0,0,0,0,0,0
NAVTEQ,17181,0,0,0,0,0,0,0
NursingDegreeHub.com,16272,0,0,0,0,0,0,0
On the Road Movie,17751,0,0,0,0,0,0,0
British Film Institute,17393,0,0,0,0,0,0,0
Dan Hotels Corporation Ltd.,17766,0,0,0,0,0,0,0
"Bragstr.com, LLC",17328,0,0,0,0,0,0,0
Home Shopping Review,17883,0,0,0,0,0,0,0
San Diego Gas & Electric Company,17399,0,0,0,0,0,0,0
Wickes Corporation,17891,0,0,0,0,0,0,0
Shop Direct Home Shopping Limited,18104,9,1,5,15,0.6,0.066666667,0.333333333
Chrome Industries,16599,0,0,0,0,0,0,0
Dow AgroSciences LLC,17460,0,0,0,0,0,0,0
"Dermalogica, Inc.",17812,0,0,0,0,0,0,0
IPC Media Limited,17277,2,0,0,2,1,0,0
TheFatBurningHormone.com,17902,1,1,0,2,0.5,0.5,0
Dallas Symphony Orchestra,17882,0,0,0,0,0,0,0
Social Body Club,17298,0,0,0,0,0,0,0
Dennis Publishing Ltd,17408,0,0,0,0,0,0,0
Aquatic Co.,17560,0,0,0,0,0,0,0
"Adelard and Edwards, Inc.",17888,0,0,0,0,0,0,0
Fuels America,17410,0,0,1,1,0,0,1
"Asthmatx, Inc.",18207,3,0,0,3,1,0,0
"OpenDNS, Inc.",16282,0,0,0,0,0,0,0
"Freedomsoft, LLP",17897,10,1,0,11,0.909090909,0.090909091,0
Forces Reunited Ltd.,16608,0,0,0,0,0,0,0
The Last Exorcism Part II Movie,18016,0,0,0,0,0,0,0
Randox Toxicology Ltd.,17894,0,0,0,0,0,0,0
Performance Fabrics Incorporated,17635,0,0,0,0,0,0,0
Foodmaxx Supermarkets,17909,0,0,0,0,0,0,0
10Finder,16598,0,0,0,0,0,0,0
FinanceReports.co,18020,4,1,0,5,0.8,0.2,0
First Insurance Company of Hawaii,16094,0,0,0,0,0,0,0
Greener Scotland - The Scottish Government,17903,0,0,0,0,0,0,0
"The Second City, Inc.",16605,0,0,0,0,0,0,0
"Difference Unites Us, Inc.",17905,0,0,0,0,0,0,0
Quintiles Inc.,17409,0,0,0,0,0,0,0
Maxis Bhd,18095,0,0,0,0,0,0,0
Rite Aid Corporation,17619,9,3,1,13,0.692307692,0.230769231,0.076923077
"YouDocs Beauty, Inc.",17400,0,1,0,1,0,1,0
"Debmar/Mercury, LLC",17459,0,0,0,0,0,0,0
ScottishPower Energy Retail Ltd.,16616,0,0,0,0,0,0,0
No Labels,17624,0,0,0,0,0,0,0
West Seattle Coins and Bellevue Rare Coins,18026,0,0,0,0,0,0,0
Artizone,18092,0,0,0,0,0,0,0
Mobile Interactive Group,17559,0,0,0,0,0,0,0
"IndustrialSupplies.com, LLC",17626,0,0,0,0,0,0,0
Halls Motorsports,16296,0,0,0,0,0,0,0
"Instructure, Inc.",17955,2,0,0,2,1,0,0
TBC Corporation,17908,0,0,0,0,0,0,0
"Acquisition Media, LLC",16592,0,0,0,0,0,0,0
Shop Radio Cast,17627,0,0,0,0,0,0,0
Frankenweenie Movie,17758,0,0,0,0,0,0,0
"Redd Entertainment, LLC.",18110,0,0,0,0,0,0,0
Association of Chartered Certified Accountants,18112,0,0,0,0,0,0,0
"Cooperative for Assistance and Relief Everywhere, LLC (CARE)",17396,0,0,0,0,0,0,0
"Ventus Medical, Inc.",16594,0,0,0,0,0,0,0
Bathrooms.com,17364,0,0,0,0,0,0,0
The New York International Latino Film Festival,16294,0,0,0,0,0,0,0
IREO Management Pvt. Ltd.,17411,0,0,0,0,0,0,0
The Tabard Theatre Company,17630,0,0,0,0,0,0,0
"Spanfeller Media Group, Inc",18138,0,0,0,0,0,0,0
"GrowthForce, LLC.",18201,0,0,0,0,0,0,0
Lincoln Movie,17696,0,0,0,0,0,0,0
Cash Generator Ltd,17632,0,0,0,0,0,0,0
Honeywell International Inc.,17762,0,0,0,0,0,0,0
"Capriza, Inc.",17634,0,0,0,0,0,0,0
"Urgent Care MSO, LLC",16747,0,0,0,0,0,0,0
Career Point College,17885,0,0,0,0,0,0,0
Arsenal Broadband Limited,17898,0,0,0,0,0,0,0
Watchismo LLC.,18141,0,0,0,0,0,0,0
Kno Inc.,17947,0,0,0,0,0,0,0
Optima E-Cigarette,18206,0,0,0,0,0,0,0
UNAT Direct Insurance Management Limited,18079,0,0,0,0,0,0,0
Momondo,18081,0,0,0,0,0,0,0
The Citadel,17693,0,0,0,0,0,0,0
"California Cinema Investments, Inc.",18098,0,0,0,0,0,0,0
Parental Guidance Movie,17752,0,0,0,0,0,0,0
Garden Buildings Direct,17951,0,0,0,0,0,0,0
Not Fade Away Movie,17750,0,0,0,0,0,0,0
Lancaster General Health,17959,0,0,1,1,0,0,1
San Luis Obispo County,17893,0,0,0,0,0,0,0
Springs Preserve,17953,0,0,0,0,0,0,0
SalesNexus LLC,18093,0,0,0,0,0,0,0
"Mike's Camera, Inc.",18102,2,0,0,2,1,0,0
Piedmont Medical Center,18100,0,0,0,0,0,0,0
ZoomerMedia Limited,18083,0,0,0,0,0,0,0
Memjet,18111,0,0,0,0,0,0,0
Humber Institute of Technology & Advanced Learning,18109,0,0,0,0,0,0,0
Old Dominion University,18143,0,0,0,0,0,0,0
"STRONGHOLD.COM, LLC",18145,0,0,0,0,0,0,0
The Las Vegas Review-Journal,18209,0,0,0,0,0,0,0
Iceland Foods Ltd.,18094,0,0,0,0,0,0,0
The Green Coffee Bean Extract,16713,0,0,0,0,0,0,0
Mattress One,16715,0,0,0,0,0,0,0
DuckDuckGo,17115,0,0,0,0,0,0,0
Lund International,16917,0,0,0,0,0,0,0
Vonage,16724,6,0,0,6,1,0,0
Tennis Warehouse,17122,0,0,0,0,0,0,0
New American Energy Opportunity Foundation (NAEOF),17192,0,0,0,0,0,0,0
Options Animal,16924,0,0,0,0,0,0,0
Denver Botanic Gardens,17049,0,0,0,0,0,0,0
Specific Media LLC,17251,0,0,0,0,0,0,0
Jamba Juice Company,17256,8,0,0,8,1,0,0
Debenhams Retail plc,16781,0,0,0,0,0,0,0
"MyLocker, LLC",16783,0,0,0,0,0,0,0
IG Markets Ltd.,17385,0,0,0,0,0,0,0
The Catholic University of America,17390,0,0,0,0,0,0,0
Glasgow Caledonian University,17349,0,0,0,0,0,0,0
DeepDiscount.com,17358,0,0,0,0,0,0,0
One Illinois,17360,0,0,0,0,0,0,0
Patriot Voices,17183,0,0,0,0,0,0,0
"Club Monaco US, LLC",17615,0,0,0,0,0,0,0
"LiquidSpace, Inc.",17617,0,0,0,0,0,0,0
Citadel Diamond Group,17692,0,0,0,0,0,0,0
Citadel Theatre Company,17694,0,0,0,0,0,0,0
Hendershot Generator,17651,0,0,0,0,0,0,0
ZACHARY PRELL INC.,17658,0,0,0,0,0,0,0
SAS Group,17660,0,0,0,0,0,0,0
The Impossible Movie,17749,0,0,0,0,0,0,0
Arizona Office of Tourism,17892,0,0,2,2,0,0,1
Leisure Consumer Products,17958,0,0,0,0,0,0,0
"BBK Healthcare, Inc.",18017,0,0,0,0,0,0,0
Family Business Resource Center,18019,0,0,0,0,0,0,0
ProSiebenSat.1 Games GmbH,18085,0,0,0,0,0,0,0
Persona World,18087,12,2,0,14,0.857142857,0.142857143,0
Vacheron Constantin,18028,0,0,0,0,0,0,0
Marquee 15,15691,0,0,0,0,0,0,0
Aon plc,17012,0,0,0,0,0,0,0
Power NI Energy Ltd,16895,0,0,0,0,0,0,0
Argos Limited,16761,0,0,0,0,0,0,0
Railtour SA,17112,0,0,0,0,0,0,0
"Fantasy Gaming Group, LLC",15693,0,0,0,0,0,0,0
GameBox! Inc.,16910,0,0,0,0,0,0,0
Henderson Global Investors Limited,17193,0,0,0,0,0,0,0
Freedom Food Ltd,16929,0,0,0,0,0,0,0
"Armstrong Garden Centers, Inc.",17261,0,0,0,0,0,0,0
Fidelity Life Association,17312,0,0,0,0,0,0,0
BiGDUG Limited,16795,0,0,0,0,0,0,0
Performersoft Inc,17327,1,0,1,2,0.5,0,0.5
The Times of Israel Ltd.,17244,0,0,0,0,0,0,0
"Just A Pinch Recipe Club, LLC.",17278,0,0,0,0,0,0,0
"Robert B. Aikens & Associates, LLC",17344,0,0,0,0,0,0,0
Evergreen State Fairgrounds,16093,0,0,0,0,0,0,0
Mr Clutch Autocentres Ltd.,17444,0,0,0,0,0,0,0
Socialcam Inc.,17395,0,0,0,0,0,0,0
TMG,17295,0,0,0,0,0,0,0
DFS Services LLC,16593,0,0,0,0,0,0,0
The Draw Shop,17397,0,0,0,0,0,0,0
"StayClassy Productions, Inc.",16291,0,0,0,0,0,0,0
St. Modwen Homes,16293,0,0,0,0,0,0,0
"clinique laboratories, llc.",13636,5,1,2,8,0.625,0.125,0.25
"PitchBook Data, Inc.",16612,0,0,0,0,0,0,0
"The Personalized Company, LLC",17631,0,0,0,0,0,0,0
Summit Business Media,17646,0,0,0,0,0,0,0
The Palm Springs Festival of Lights Parade,17695,0,0,0,0,0,0,0
BARRYMORE THEATRE,17697,0,0,0,0,0,0,0
Trollbeads A/S,17661,0,0,0,0,0,0,0
Wonga Canada Inc.,17946,0,0,0,0,0,0,0
Shearings Holidays Ltd.,18029,0,0,0,0,0,0,0
Military Officers Association of America,18097,0,0,0,0,0,0,0
Norwall PowerSystems,17019,0,0,0,0,0,0,0
National Bank of Arizona,17020,0,0,0,0,0,0,0
"Rooms To Go, Inc.",16902,49,4,1,54,0.907407407,0.074074074,0.018518519
North Kansas City Hospital,17120,0,0,0,0,0,0,0
FUJIFILM UK Limited,16919,0,0,0,0,0,0,0
Razoo Foundation,16920,0,0,0,0,0,0,0
TE Connectivity Ltd.,16769,0,0,0,0,0,0,0
Totaljobs Group Ltd,17202,0,0,0,0,0,0,0
ICICI Bank Limited,16670,0,0,0,0,0,0,0
BIOVEA,17220,0,0,0,0,0,0,0
Sioux Falls Convention and Visitors Bureau,16784,0,0,0,0,0,0,0
Ping Identity Corporation,17320,2,0,0,2,1,0,0
Grand Challenges in Global Health,17237,0,0,0,0,0,0,0
Livebookings Holdings Ltd,17238,0,0,0,0,0,0,0
The Woodlands Resort & Conference Center,16266,0,0,0,0,0,0,0
Sympoz Inc.,16583,4,0,0,4,1,0,0
GOoutdoors.co.uk,17287,0,0,0,0,0,0,0
UK Prize,16587,0,0,0,0,0,0,0
"Flatiron Media, LLC.",17302,1,0,0,1,1,0,0
Cashback.Menmedia,16602,0,0,0,0,0,0,0
"EVault, Inc.",17405,0,0,0,0,0,0,0
"ACTIVE Network, Inc.",17456,3,0,0,3,1,0,0
Rise of the Guardians Movie,17188,0,0,0,0,0,0,0
American Public Transportation Association,1612,0,0,0,0,0,0,0
Voyages Jules Verne,17655,0,0,0,0,0,0,0
TechMediaNetwork,17906,1,0,0,1,1,0,0
Texas Health Presbyterian Hospital Rockwall,17956,0,0,0,0,0,0,0
Petersen Johnson,18023,0,0,0,0,0,0,0
American Board of Medical Specialties,18088,0,0,0,0,0,0,0
Poppin,18105,4,5,1,10,0.4,0.5,0.1
upjers GmbH & Co.,18106,0,0,0,0,0,0,0
"Tripwire, Inc.",15402,0,0,0,0,0,0,0
"SportsNet New York, LLC.",15404,0,0,0,0,0,0,0
PageSuite Limited,16831,0,0,0,0,0,0,0
New York State Higher Education Services Corporation (HESC),16865,0,0,0,0,0,0,0
"PennyStocks, Inc.",16965,0,0,0,0,0,0,0
Saint Joseph’s University,16967,0,0,0,0,0,0,0
Cocosa Lifestyle Limited,16840,0,0,0,0,0,0,0
The CenterState Corporation for Economic Opportunity,16997,0,0,0,0,0,0,0
InterActive Pro Limited,16999,0,0,0,0,0,0,0
Samaritans,17067,0,0,0,0,0,0,0
InLoox,17074,0,0,0,0,0,0,0
BriefCase Inc.,17101,0,0,0,0,0,0,0
Silent Hill Revelation Movie,17165,0,0,0,0,0,0,0
OfferCombos.com,17106,0,0,0,0,0,0,0
Dr. Batras' Positive Health Clinic (UK) Ltd.,16899,0,0,0,0,0,0,0
Virgin Strauss Water UK Ltd,16731,0,0,0,0,0,0,0
"Vinport Marketing, LLC",17199,0,0,0,0,0,0,0
"TORAY INDUSTRIES, INC.",16663,0,0,0,0,0,0,0
Booking.com B.V.,16665,0,0,0,0,0,0,0
"HushHush Broadcasting, LLC",17308,0,0,0,0,0,0,0
Cosemederm Bioscience,17233,0,0,0,0,0,0,0
Castle Resorts & Hotels,16265,0,0,0,0,0,0,0
Sleek Networks Ltd,17333,0,0,0,0,0,0,0
Rural Crafts Association,17440,0,0,0,0,0,0,0
myCharge,17365,0,0,0,0,0,0,0
Pilot Pen,17367,0,0,0,0,0,0,0
Ride Snowboards,17401,0,0,0,0,0,0,0
DTE Energy Company,17301,4,0,0,4,1,0,0
Mediaweb Ltd,16604,0,0,0,0,0,0,0
Hertfordshire County Council,17642,0,0,0,0,0,0,0
"IMC, Inc.",17644,0,0,0,0,0,0,0
juvenile diab,17767,0,0,0,0,0,0,0
Puss In Boots Movie,17776,0,0,0,0,0,0,0
HotNewHipHop,17901,0,0,0,0,0,0,0
Select Blinds,18078,1,0,0,1,1,0,0
"Agenda, LLC",18103,1,0,0,1,1,0,0
Tripfyre,18144,0,0,0,0,0,0,0
Creek Casino Wetumpka,18203,0,0,0,0,0,0,0
"Pinterest, Inc.",18212,0,0,0,0,0,0,0
Infinity Box Inc.,15394,0,0,0,0,0,0,0
SilverLungs,16823,0,0,1,1,0,0,1
"Rust Consulting, Inc.",16080,0,0,0,0,0,0,0
Physicians United Plan,16973,1,0,1,2,0.5,0,0.5
Eaton Vance Investment Managers,16855,0,0,0,0,0,0,0
SAMSARA Movie,17073,0,0,0,0,0,0,0
E-consultancy.com Limited,17141,0,0,0,0,0,0,0
American Military University,17091,0,0,0,0,0,0,0
Necole Bitchie,17098,0,0,0,0,0,0,0
"HAAN Corporation, Inc.",17166,0,0,0,0,0,0,0
National Audubon Society,17173,0,0,0,0,0,0,0
Moneris Solutions Corporation,17016,0,0,0,0,0,0,0
"Tria Beauty, Inc",17023,0,0,0,0,0,0,0
"BoConcept USA, Inc.",15694,0,0,0,0,0,0,0
Associated Global Systems,17034,0,0,0,0,0,0,0
Baines & Ernst Limited,16923,0,0,0,0,0,0,0
"HelpMe, LLC",17048,0,0,0,0,0,0,0
SaveUK.net,17259,0,0,0,0,0,0,0
GREATER MSP Partnership,17223,0,0,0,0,0,0,0
Playing For Keeps Movie,17316,0,0,0,0,0,0,0
Atlas Shrugged Movie,16791,0,0,0,0,0,0,0
"Vistancia Land Holdings, LLC",17234,0,0,0,0,0,0,0
"ViaSat, Inc.",17323,0,0,0,0,0,0,0
Red 5 Studios,17273,0,0,0,0,0,0,0
"Harrison Hot Springs Resort & Spa, Inc.",17434,0,0,0,0,0,0,0
TOTALVIDPLAYER.COM,16273,0,0,0,0,0,0,0
Matalan Sporting Promise,16287,0,0,0,0,0,0,0
my.biz,1597,0,0,0,0,0,0,0
Comfortaire Direct LLC,17616,0,0,0,0,0,0,0
St. Kitts Tourism Authority,17659,0,0,0,0,0,0,0
Argo Movie,17759,0,0,0,0,0,0,0
The Watch Movie,17777,0,0,0,0,0,0,0
Citizens or Strength and Security Fund,17945,0,0,0,0,0,0,0
Mylan Specialty L.P.,17952,12,0,4,16,0.75,0,0.25
"Cox Communications, Inc.",18077,82,14,6,102,0.803921569,0.137254902,0.058823529
Michigan Education Savings Plan,18084,0,0,1,1,0,0,1
Destination Maternity Corporation,18027,0,0,0,0,0,0,0
Instituto Guatemalteco de Turismo,16714,0,0,0,0,0,0,0
Randstad,17025,1,0,0,1,1,0,0
York Racecourse Knavesmire LLP,17039,0,0,0,0,0,0,0
Montclair State University,16925,0,0,0,0,0,0,0
New Look Retailers Limited,16775,0,0,0,0,0,0,0
Yandy Lingerie,16739,0,0,0,0,0,0,0
Friendly Planet,17218,0,0,0,0,0,0,0
Vertex Pharmaceuticals Incorporated,17243,0,0,0,0,0,0,0
"LFC Internet Marketing, Inc.",17375,0,0,0,0,0,0,0
Trend 911,17332,0,0,0,0,0,0,0
University of Southampton,17343,0,0,0,0,0,0,0
"Wild Shadow Studios, Inc.",16589,0,0,0,0,0,0,0
Regional Council of Lapland,17293,0,0,0,0,0,0,0
Yes on 39,17357,0,0,0,0,0,0,0
Tourism British Columbia,17182,5,1,1,7,0.714285714,0.142857143,0.142857143
The International Chiropractic Pediatric Association,16607,0,0,0,0,0,0,0
OPONEO.PL SA,16614,0,0,0,0,0,0,0
Tuscany Now Ltd.,17618,0,0,0,0,0,0,0
eXo,17657,0,0,0,0,0,0,0
Philadelphia Chamber Music Society,17757,0,0,0,0,0,0,0
United for Medical Research,17768,0,0,0,0,0,0,0
Ono Hawaiian BBQ,17775,0,0,0,0,0,0,0
Desert Schools Federal Credit Union,17900,0,0,0,0,0,0,0
Morgan Jewelers,18211,0,0,0,0,0,0,0
Lincoln Center Theater,16897,0,0,0,0,0,0,0
Pittsburgh Renaissance Festival,16765,0,0,0,0,0,0,0
"Thing Daemon, Inc.",16772,0,0,0,0,0,0,0
The Guide Dogs for the Blind Association,17206,0,0,0,0,0,0,0
Viggle Inc.,16738,0,0,0,0,0,0,0
Flights and Packages Limited,17267,0,0,0,0,0,0,0
Stories on Stage,17242,0,0,0,0,0,0,0
FanBolt Entertainment,17274,0,0,0,0,0,0,0
Fiba,17276,0,0,0,0,0,0,0
"Lendio, Inc.",17335,0,0,0,0,0,0,0
"University of South Florida, St. Petersburg",17433,0,0,0,0,0,0,0
The Elephant Sanctuary in Tennessee,17435,0,0,0,0,0,0,0
Freemans plc,17340,0,0,0,0,0,0,0
"OpenSky, Inc.",16270,0,0,0,0,0,0,0
Qatar Financial Centre,16799,0,0,0,0,0,0,0
First Active Media Ltd,17342,0,0,0,0,0,0,0
The U District Livability Partnership,17442,0,0,0,0,0,0,0
Automated Pet Care Products Inc,16095,0,0,0,0,0,0,0
Sonoma Valley Vintners & Growers Foundation,16097,0,0,0,0,0,0,0
GFT Global Markets UK Ltd.,16597,0,0,0,0,0,0,0
Commission on the Promotion of Peru for export and tourism,17299,0,0,0,0,0,0,0
University of Stirling,16606,0,0,0,0,0,0,0
LA Film Fest,1589,0,0,0,0,0,0,0
Step Up Movie,17774,0,0,0,0,0,0,0
Iglu.com Ltd,17910,0,0,0,0,0,0,0
BANGLADS Ltd,17944,0,0,0,0,0,0,0
Golf Tailor LLC,18101,24,0,0,24,1,0,0
Designtechnica Corporation,18108,0,0,0,0,0,0,0
FreePhoneTracer.com,18142,0,0,0,0,0,0,0
Solera Networks Inc.,18210,0,0,0,0,0,0,0
Maple Syrup Media Ltd.,17018,0,0,0,0,0,0,0
RONA Inc.,16904,0,0,0,0,0,0,0
PlayOn! Sports,17118,0,0,0,0,0,0,0
HollywoodChicago.com LLC,17121,0,0,0,0,0,0,0
American Institute of Gastric Banding,16918,0,0,0,0,0,0,0
N9NE Group,16767,0,0,0,0,0,0,0
Visit Jacksonville Convention and Visitors Bureau,16768,0,0,0,0,0,0,0
Science Museum Group (London),16667,0,0,0,0,0,0,0
"Express Services, Inc.",17054,0,0,0,0,0,0,0
Comparestores.net,17221,3,0,0,3,1,0,0
"Bridgestone Multimedia Group, Inc.",17222,0,0,0,0,0,0,0
Admiral Theatre Gentlemen's Club,16785,0,0,0,0,0,0,0
"Cengage Learning, Inc.",16786,11,0,0,11,1,0,0
B2C Media Solutions Ltd.,17235,11,0,0,11,1,0,0
ConnectMe,17321,0,0,0,0,0,0,0
"Sling Media, Inc.",17271,0,0,0,0,0,0,0
Old Harbor Native Corporation,16267,0,0,0,0,0,0,0
Mothercare UK Limited,17336,0,0,0,0,0,0,0
Balsam Hill LLC,17339,0,0,0,0,0,0,0
E.ON UK plc.,17285,0,0,0,0,0,0,0
Transcontinental Inc.,17286,0,0,0,0,0,0,0
Unibet International Ltd,16585,0,0,0,0,0,0,0
Florida Medical Clinic,17389,0,0,0,0,0,0,0
Stonehouse Press,16586,0,0,0,0,0,0,0
TCF Financial,16285,0,0,0,0,0,0,0
JJ Buckley Fine Wines LLC,17403,0,0,0,0,0,0,0
Resource Development International Ltd,17304,0,0,0,0,0,0,0
ClickSoftware Technologies Ltd,17186,0,0,0,0,0,0,0
amitiza,1592,0,0,0,0,0,0,0
Real California Milk,1596,0,0,0,0,0,0,0
Celebrity Cruises,1610,21,13,6,40,0.525,0.325,0.15
Lawless Movie,17686,0,0,0,0,0,0,0
Sarah's Key Movie,17689,0,0,0,0,0,0,0
Texas Chainsaw 3D Movie,17754,0,0,0,0,0,0,0
Arbitrage Movie,17771,0,0,0,0,0,0,0
The PNC Financial Services Group Inc.,17889,5,6,0,11,0.454545455,0.545454545,0
"Wellbridge, Inc.",17957,2,0,0,2,1,0,0
Houston Convention & Visitors Bureau,17014,0,0,0,0,0,0,0
Webfusion,16757,0,0,0,0,0,0,0
"DaySpring Cards, Inc.",16900,0,0,0,0,0,0,0
"Knockaround, LLC.",17114,0,0,0,0,0,0,0
"SAGE Publications, Inc.",17189,0,0,0,0,0,0,0
downloadsmanagerpro.com,16725,0,0,0,0,0,0,0
"FatWallet, Inc.",16764,1,0,0,1,1,0,0
Altamont Summit Apartments,17200,0,0,0,0,0,0,0
The Leadership Institute,16664,0,0,0,0,0,0,0
SsangYong,17050,0,0,0,0,0,0,0
"HotelMe, LLC",17207,0,0,0,0,0,0,0
"WisdomTree Investments, Inc.",16671,0,0,1,1,0,0,1
GroupDealTools,17214,0,0,0,0,0,0,0
Trading Point of Financial Instruments Ltd,17257,0,0,0,0,0,0,0
Malwarebytes Corporation,17307,0,0,0,0,0,0,0
Boys Town,17225,0,0,1,1,0,0,1
Autobytel Inc.,16789,0,0,1,1,0,0,1
Heart and Stroke Foundation of Canada,17318,0,0,0,0,0,0,0
Portland General Electric,17268,0,0,0,0,0,0,0
Amarillo Convention & Visitor Council,16264,0,0,0,0,0,0,0
"Copart, Inc.",17382,0,0,0,0,0,0,0
Investment Diamonds LLC,17282,0,0,0,0,0,0,0
"Calvert Education Services, LLC",16271,0,0,0,0,0,0,0
Hit and Run Movie,16096,0,0,0,0,0,0,0
Thank You Ocean Campaign,16596,0,0,0,0,0,0,0
Northwest Energy Efficiency Alliance,16289,0,0,0,0,0,0,0
Development Bushiroad Inc.,17300,0,0,0,0,0,0,0
Daily Grommet,17368,0,0,0,0,0,0,0
Todd Akin for Senate,17450,0,0,0,0,0,0,0
Seymour Duncan,17407,0,0,0,0,0,0,0
"Helpshift, Inc.",17457,0,0,0,0,0,0,0
Dead Accounts the Musical,17557,0,0,0,0,0,0,0
"OshKosh B’gosh, Inc.",17625,0,0,0,0,0,0,0
"Fathead, LLC.",17643,0,0,0,0,0,0,0
"Independent Health Association, Inc.",17650,0,0,0,0,0,0,0
Giraffas,17761,0,0,0,0,0,0,0
"Atlantis Events, Inc.",17886,0,0,0,0,0,0,0
i’m SpA,17911,0,0,0,0,0,0,0
Worthington-Bronfman Ventures Inc.,17950,0,0,0,0,0,0,0
Allied Wireless Communications Corporation,17961,0,0,0,0,0,0,0
Rank Leisure Holdings Ltd.,18018,0,0,0,0,0,0,0
SmartConsumerLifeStyle,18086,0,0,0,0,0,0,0
Cozen O’Connor,18025,0,0,0,0,0,0,0
Tyne and Wear Passenger Transport Executive (Nexus),18204,0,0,0,0,0,0,0
brightsolid online publishing (US) Inc,16712,0,0,0,0,0,0,0
"The Pokémon Company International, Inc.",16727,0,0,0,0,0,0,0
Californians Against Sexual Exploitation,17197,0,0,0,0,0,0,0
RezVera,17046,0,0,0,0,0,0,0
DAP Products Inc.,16861,0,0,0,0,0,0,0
Lee Enterprises,16776,0,0,0,0,0,0,0
"Where 2 Get It, Inc.",17210,0,0,0,0,0,0,0
Shop Smart Holdings Inc.,17212,0,0,0,0,0,0,0
Kirby Allison's Hanger Project,16778,0,0,0,0,0,0,0
Mackenzie Financial Corporation,17227,0,0,0,0,0,0,0
Qpid Network,17263,6,1,0,7,0.857142857,0.142857143,0
Nuart,17378,0,0,0,0,0,0,0
Imago Techmedia,17380,0,0,0,0,0,0,0
Brooklyn Artistry & Company,17346,0,0,0,0,0,0,0
Northeast Bank,17361,0,0,0,0,0,0,0
GoingBankrupt.co.uk,17297,0,0,0,0,0,0,0
HoldMyTicket LLC.,17363,0,0,0,0,0,0,0
Builders Association of the Twin Cities (BATC),17446,0,0,0,0,0,0,0
Delta Financial Markets Limited,17178,0,0,0,0,0,0,0
Transport for London (TFL),17180,0,0,0,0,0,0,0
Consumer Cellular,1604,86,7,0,93,0.924731183,0.075268817,0
Hawkeye,17461,0,0,0,0,0,0,0
H.E. Butt Grocery Company,17463,3,0,0,3,1,0,0
San Francisco Bulls Pro Hockey,17561,0,0,0,0,0,0,0
NI Group Limited,17629,0,0,0,0,0,0,0
Let Fury Have the Hour Movie,17748,0,0,0,0,0,0,0
Cutter & Buck Inc.,17763,0,0,0,0,0,0,0
"Toptal, LLC",17765,0,0,0,0,0,0,0
Radware Ltd.,17778,0,0,0,0,0,0,0
Baubles Co.,17895,0,0,0,0,0,0,0
Marine Essentials LLC,17899,1,2,1,4,0.25,0.5,0.25
QuoteWizard.com LLC,17912,0,0,0,0,0,0,0
The National Trust for Scotland,17948,0,0,0,0,0,0,0
ezetop,18080,0,0,0,0,0,0,0
Sony (Malaysia) Sdn. Bhd.,18082,0,0,0,0,0,0,0
Big White Ski Resort,18099,0,0,0,0,0,0,0
Lombardi Publishing Corporation,18146,0,0,0,0,0,0,0
"Legrand North America, Inc.",16754,0,0,0,0,0,0,0
"VF Imagewear, Inc.",17021,0,0,0,0,0,0,0
TASC,16717,0,0,0,0,0,0,0
Maine.gov,17035,0,0,0,0,0,0,0
TAO Las Vegas,16736,0,0,0,0,0,0,0
"Russell Brands, LLC",17053,0,0,0,0,0,0,0
Air Filters Delivered LLC,16668,0,0,0,0,0,0,0
"J-B Weld, Inc.",17254,0,0,0,0,0,0,0
Bodyguard London Ltd,17322,0,0,0,0,0,0,0
"InsideSales.com, Inc.",17386,1,0,0,1,1,0,0
Unison,17289,0,0,0,0,0,0,0
Perk,17353,0,0,0,0,0,0,0
XCsunnyHair.com,17404,0,0,0,0,0,0,0
Pharmascience Inc.,17372,0,0,0,0,0,0,0
"SBR Marketing, Ltd.",16603,0,0,0,0,0,0,0
Ruche Inc.,17453,0,0,0,0,0,0,0
Anybill,17454,0,0,0,0,0,0,0
The LIVESTRONG Foundation,17621,0,0,1,1,0,0,1
anthropologie.com LLC.,17622,0,0,0,0,0,0,0
"Education 4 USA, Inc.",17639,0,0,0,0,0,0,0
"Airtrade International, Inc.",17640,0,0,0,0,0,0,0
Promised Land Movie,17753,0,0,0,0,0,0,0
Jade EServices Malaysia Sdn Bhd,17890,0,0,0,0,0,0,0
Sparx,17907,0,0,0,0,0,0,0
"Mayor's Jewelers, Inc.",17954,0,0,1,1,0,0,1
Unisys,18107,0,0,0,0,0,0,0
Canadian Affair,18139,0,0,0,0,0,0,0
OutSmart Ltd.,18140,3,0,0,3,1,0,0
Xanga,15924,0,0,0,0,0,0,0
Picaboo Corporation,16458,0,0,0,0,0,0,0
"California State University, East Bay",15943,0,0,0,0,0,0,0
Rapid City Journal,15675,0,0,0,0,0,0,0
Inspire USA Foundation,16626,0,0,0,0,0,0,0
Wm Morrison Supermarkets plc,16528,0,0,0,0,0,0,0
Linksoflondon.com Limited,17416,0,0,0,0,0,0,0
Indus Travels Inc.,15556,0,0,0,0,0,0,0
Westinghouse Electric Company LLC,16041,2,0,1,3,0.666666667,0,0.333333333
Great Health Works,16709,1,0,0,1,1,0,0
Parent Revolution,17466,0,0,0,0,0,0,0
Kyochon Corp.,15392,0,0,0,0,0,0,0
Success Academy Charter Schools,17966,1,0,0,1,1,0,0
"Denon Electronics (USA), LLC",16943,0,0,0,0,0,0,0
Flavor Napa Valley,16811,0,0,0,0,0,0,0
"McPherson's (US), Inc.",17423,0,0,0,0,0,0,0
Indomina Media,16743,0,0,0,0,0,0,0
Bernard B. Jacobs Theatre,17418,0,0,0,0,0,0,0
Simply Bridal,16862,0,0,0,0,0,0,0
Alliance for American Manufacturing (AAM),16075,0,0,0,0,0,0,0
Gary R. Lardy,16645,0,0,0,0,0,0,0
TobaccoFreeNYS.org,18118,0,0,0,0,0,0,0
"Sweet Gamer, LLC",15422,0,0,0,0,0,0,0
"SlimGenics, LLC.",18125,1,0,0,1,1,0,0
"Our Film Festival, Inc.",16745,0,0,0,0,0,0,0
Biostar Inc.,15690,0,0,0,0,0,0,0
Doorway To Value,17011,0,0,0,0,0,0,0
"SkinMedica, Inc.",16894,0,0,0,0,0,0,0
"Profinity, LLC",16711,0,0,0,0,0,0,0
Ocado Limited,17111,0,0,0,0,0,0,0
"My Pillow, Inc.",15692,0,0,0,0,0,0,0
Merit Gold & Silver,16909,0,0,0,0,0,0,0
Clarion Events,16911,0,0,0,0,0,0,0
remodelaholic.com,16762,0,0,0,0,0,0,0
Manchester United Football Club Limited,16726,0,0,0,0,0,0,0
Health Discoveries Journal,16860,0,0,0,0,0,0,0
NewsNow Publishing Limited,16928,0,0,0,0,0,0,0
KeyArena at Seattle Center,16662,0,0,0,0,0,0,0
"Retrofit, Inc.",17821,0,0,0,0,0,0,0
Total Wine & More,17970,0,0,0,0,0,0,0
The Source (Bell) Electronics Inc.,17820,0,0,0,0,0,0,0
Robin Hood Foundation,17824,1,1,0,2,0.5,0.5,0
Being Flynn Movie,17711,0,0,0,0,0,0,0
ALPS Advisors Inc.,17419,0,0,0,0,0,0,0
Robert McTear & Co (Auctioneers) Ltd,17828,0,0,0,0,0,0,0
The Automobile Association,17973,0,0,0,0,0,0,0
The Folio Society,17564,0,0,0,0,0,0,0
The Prince William County/Manassas CVB,17467,0,0,0,0,0,0,0
Covance Inc.,17814,2,0,0,2,1,0,0
Sleeman Unibroue,17822,0,0,0,0,0,0,0
"Med-Care Diabetic & Supplies, Inc.",18123,0,0,0,0,0,0,0
HSamuel Limited,18126,0,0,0,0,0,0,0
GameMazing LLC,17974,1,0,0,1,1,0,0
Anna Karenina Movie,17705,0,0,0,0,0,0,0
"Dexcom, Inc.",17483,0,0,0,0,0,0,0
"Meth Project Foundation, Inc.",17827,0,0,0,0,0,0,0
Graduate Management Admission Council,17415,0,0,0,0,0,0,0
"Salix Pharmaceuticals, Inc.",17473,0,0,0,0,0,0,0
AXA PPP healthcare Limited,18117,0,0,0,0,0,0,0
Buyapowa Limited,17815,0,0,0,0,0,0,0
Needs Beyond Medicine,17983,2,1,0,3,0.666666667,0.333333333,0
"TrainSignal, Inc.",17920,0,0,0,0,0,0,0
Alex Cross Movie,17702,0,0,0,0,0,0,0
"Simply Asia Foods, Inc.",17926,0,0,0,0,0,0,0
Queen’s University,18115,0,0,0,0,0,0,0
"Tommy Bahama R&R Holdings, Inc.",17964,0,0,0,0,0,0,0
ChinaWomenDating,18130,2,0,0,2,1,0,0
FusionHealth,18114,0,0,0,0,0,0,0
Traditional Medicinals,17816,2,0,0,2,1,0,0
"PaySimple, Inc.",18134,0,0,0,0,0,0,0
The Greensheet,17985,0,0,0,0,0,0,0
Staffordshire University,17915,0,0,0,0,0,0,0
GOV.UK,17918,0,0,0,0,0,0,0
Mai Son Joint Stock Company,18034,0,0,0,0,0,0,0
The Michigan Humane Society,17979,0,0,0,0,0,0,0
InteriorsBuyer.com,17668,0,0,0,0,0,0,0
Optimum Nutrition,17577,0,0,0,0,0,0,0
Beginners Movie,17710,0,0,0,0,0,0,0
"Mills e-Commerce Enterprises, Inc.",17582,2,0,1,3,0.666666667,0,0.333333333
Magnet Limited,17670,0,0,0,0,0,0,0
"GOLF & TENNIS PRO SHOP, INC.",18042,1,0,0,1,1,0,0
Saint Xavier University,18270,0,0,0,0,0,0,0
Xlibris Corporation,17471,0,0,0,0,0,0,0
This Means War Movie,17713,0,0,0,0,0,0,0
IsraelfilmcenterSTREAM.org,17584,0,0,0,0,0,0,0
VZI Investment Corp.,17430,0,0,0,0,0,0,0
"The Mutual Fund Store, LLC.",18116,5,0,0,5,1,0,0
Haymarket Business Publications Limited,17941,0,0,0,0,0,0,0
"eHealthInsurance Services, Inc.",17583,0,0,0,0,0,0,0
New Santa Clara Stadium,17481,0,0,0,0,0,0,0
Broken City Movie,17829,0,0,0,0,0,0,0
Tom Clancy,17942,0,0,0,0,0,0,0
Visit Spokane,17981,0,0,0,0,0,0,0
Frontier Natural Products Co-op,17570,1,0,1,2,0.5,0,0.5
London Capital Group Ltd,18409,0,0,0,0,0,0,0
"Earndit, Inc",18266,0,0,0,0,0,0,0
Parker Movie,17924,0,0,0,0,0,0,0
Floors To Your Home,17673,0,0,0,0,0,0,0
RodeoHouston,18410,0,0,0,0,0,0,0
"SenecaOne Finance, Inc.",17581,0,0,0,0,0,0,0
Hotels.com L.P.,17932,0,0,1,1,0,0,1
Pegus Research,18119,0,0,0,0,0,0,0
Noodles & Company,18420,0,0,0,0,0,0,0
Advanced Energy Economy,18413,0,0,0,0,0,0,0
"Kaiku Finance, LLC.",18049,0,0,0,0,0,0,0
WinZip Computing S.L.,17566,9,0,0,9,1,0,0
Historic Royal Palaces,18405,0,0,0,0,0,0,0
Bullet to the Head Movie,18008,0,0,0,0,0,0,0
Catholic Healthcare West,17472,0,0,0,0,0,0,0
Silver Linings Playbook Movie,17685,0,0,0,0,0,0,0
Cole-Parmer Instrument Company,17487,0,0,0,0,0,0,0
Waterstones Booksellers Limited,17826,0,0,0,0,0,0,0
Digital Deal Rev.,18417,0,0,0,0,0,0,0
Safe Haven Movie,18013,0,0,0,0,0,0,0
Horzer.us,18037,0,0,0,0,0,0,0
"New Peak Media, Inc.",17592,0,0,0,0,0,0,0
Ramco Systems,18129,0,0,0,0,0,0,0
Purdue Pharma L.P.,17937,0,0,0,0,0,0,0
Warm Bodies Movie,17993,0,0,0,0,0,0,0
"GG Digital, Inc.",18056,0,0,0,0,0,0,0
"Festival Fun Parks, LLC",17832,0,0,0,0,0,0,0
The Smith Center,18412,0,0,0,0,0,0,0
Blue Cross and Blue Shield of Illinois,18043,8,1,1,10,0.8,0.1,0.1
"HEAVEN HILL DISTILLERIES, INC.",17665,0,0,0,0,0,0,0
NVHomes,18427,0,0,0,0,0,0,0
"Santarus, Inc.",18406,0,0,0,0,0,0,0
Shot Show,18291,0,0,0,0,0,0,0
"Xcentric Ventures, LLC",18120,0,0,1,1,0,0,1
Jewlr,17594,0,0,0,0,0,0,0
Bedrooms & More,17426,0,0,0,0,0,0,0
Stevens Pass,18059,0,0,0,0,0,0,0
Exodus Travels Ltd.,18121,0,0,0,0,0,0,0
Jay Peak Resort,18128,0,0,0,0,0,0,0
Love Culture Inc.,18434,2,0,0,2,1,0,0
Sierra Providence Health Network,18122,0,0,0,0,0,0,0
"Maty's Healthy Products, LLC",17943,0,0,0,0,0,0,0
Big Giveaways Draw,17835,1,0,0,1,1,0,0
Wixawin,18131,1,0,0,1,1,0,0
Sofia The First Once Upon A Princess Movie,18466,0,0,0,0,0,0,0
Final Destination 5 Movie,18469,0,0,0,0,0,0,0
"Recruit Holdings Co., Ltd.",17841,1,0,0,1,1,0,0
"Huddler, Inc.",17917,0,0,0,0,0,0,0
Coral Interactive (Gibraltar) Limited,17605,0,0,0,0,0,0,0
University Medical Center of Southern Nevada,18273,0,0,0,0,0,0,0
RedOrbit,17852,0,0,0,0,0,0,0
"Wacom Company, Limited",17485,0,0,0,0,0,0,0
Rational Entertainment Enterprises Limited,18432,9,3,0,12,0.75,0.25,0
Ideal Classic Cars,17587,0,0,0,0,0,0,0
Bored.com,17972,1,0,0,1,1,0,0
French Connection Group Inc.,18133,0,0,0,0,0,0,0
Bart Conner and Nadia Comaneci,18426,0,0,0,0,0,0,0
"CityGrid Media, LLC",17571,0,0,0,0,0,0,0
"Inbox.com, Inc.",18050,1,0,0,1,1,0,0
Sherlock Holmes A Game of Shadows Movie,18473,0,0,0,0,0,0,0
Viewster AG,17585,0,0,0,0,0,0,0
Crerar Hotel Group Ltd,17672,0,0,0,0,0,0,0
The Benenden Healthcare Society Limited,18435,0,0,0,0,0,0,0
Tiffany Natural Pharmacy,17683,0,0,0,0,0,0,0
Presidential Inaugural Committee 2013,17990,0,0,0,0,0,0,0
Anthem Blue Cross and Blue Shield,18279,0,0,0,0,0,0,0
Stamford Hospital,17842,0,0,0,0,0,0,0
Betway Limited,17940,0,0,0,0,0,0,0
Low Income Housing Search,18031,0,0,0,0,0,0,0
Price Chopper,17844,0,0,0,0,0,0,0
Travel Counsellors,18407,0,0,0,0,0,0,0
Peirce College,18423,0,0,0,0,0,0,0
"World Golf Foundation, Inc.",18418,0,0,0,0,0,0,0
Cupcakes and Cashmere,17980,0,0,0,0,0,0,0
The Carphone Warehouse Limited,17916,0,0,0,0,0,0,0
American Osteopathic Association,17837,0,0,0,0,0,0,0
COPD Foundation Inc.,17666,0,0,0,0,0,0,0
fasterstrongerpc.net,18058,0,0,0,0,0,0,0
Royal Air Force Benevolent Fund (RAFBF),17608,0,0,0,0,0,0,0
South Beach Vaporizers,18051,0,0,0,0,0,0,0
Extremely Loud And Incredibly Close Movie,18474,0,0,0,0,0,0,0
Fang Media LLC,17934,22,0,3,25,0.88,0,0.12
Liverpool Football Club,18428,0,0,0,0,0,0,0
"FX Junction, LLC",18060,0,0,0,0,0,0,0
HOM Furniture,18217,0,0,0,0,0,0,0
CNET,18285,9,0,3,12,0.75,0,0.25
NestWise,18408,0,0,0,0,0,0,0
Colorado Window Source,18449,0,0,0,0,0,0,0
Flightbookers Limited,17929,0,0,0,0,0,0,0
Bullz-Eye,18442,0,0,0,0,0,0,0
Meta Watch Ltd.,17600,0,0,0,0,0,0,0
CBS Sports,18287,2,0,2,4,0.5,0,0.5
Joe Browns Limited,18074,0,0,0,0,0,0,0
Ohio State Buckeyes,18281,0,0,0,0,0,0,0
Central Equity Limited,18429,0,0,0,0,0,0,0
Identity Thief Movie,17991,0,0,0,0,0,0,0
"Musiclab, LLC.",17853,0,0,0,0,0,0,0
Embry-Riddle Aeronautical University,18275,0,0,0,0,0,0,0
Sound Of My Voice Movie,18306,0,0,0,0,0,0,0
3GA Ltd.,18054,0,0,0,0,0,0,0
Millennium Entertainment,17862,0,0,0,0,0,0,0
"HFM Marketing, LLC",18422,5,0,2,7,0.714285714,0,0.285714286
COGECO Inc.,18223,0,0,0,0,0,0,0
ChildFund International,17836,0,0,0,0,0,0,0
Exent Technologies Ltd.,17849,0,0,0,0,0,0,0
LEAGUE Investment Services Inc.,18069,0,0,0,0,0,0,0
"Ameristar Casinos, Inc.",17870,4,0,0,4,1,0,0
Another Earth Movie,18315,0,0,0,0,0,0,0
Changyou.com,17788,0,0,4,4,0,0,1
Belstaff Group SA,17931,0,0,0,0,0,0,0
Inogen,17491,0,0,0,0,0,0,0
Hurtigruten ASA,18444,1,0,0,1,1,0,0
Hugo Movie,17720,0,0,0,0,0,0,0
FX Network,18305,0,0,0,0,0,0,0
TurboTax,17781,0,0,0,0,0,0,0
"Big Apple Circus, Ltd.",17858,0,0,0,0,0,0,0
Marqeta Inc.,17596,0,0,0,0,0,0,0
University of Chicago Medicine,18436,0,0,0,0,0,0,0
21 And Over Movie,18453,0,0,0,0,0,0,0
Rust and Bone Movie,17728,0,0,0,0,0,0,0
Yorkshire Building Society,18592,0,0,0,0,0,0,0
University of Kent,18220,0,0,0,0,0,0,0
Luxup Holdings Limited,17580,0,0,0,0,0,0,0
Detention Movie,18460,0,0,0,0,0,0,0
Marylebone Cricket Club,18856,0,0,0,0,0,0,0
The Empire State Relief Fund,17843,0,0,0,0,0,0,0
"CA, Inc.",18228,0,0,0,0,0,0,0
CBS News,18283,0,0,0,0,0,0,0
Lazada,17856,0,0,0,0,0,0,0
Public Works and Government Services Canada,18046,1,0,2,3,0.333333333,0,0.666666667
Ruby Sparks Movie,18309,0,0,0,0,0,0,0
"TeamSnap, Inc.",18430,2,0,0,2,1,0,0
Jack Reacher Movie,17730,0,0,0,0,0,0,0
Ruyo Games Limited,18414,0,0,0,0,0,0,0
National Geographic Channel,18319,0,0,0,0,0,0,0
Take Care Health Systems LLC.,18062,0,0,0,0,0,0,0
United States Marine Corps Recruiting Command,18057,5,0,0,5,1,0,0
University of California Irvine Extension,18416,0,0,0,0,0,0,0
The National Careers Service (UK),18515,0,0,0,0,0,0,0
La Costa Oaks,18066,0,0,0,0,0,0,0
Project X Movie,18476,0,0,0,0,0,0,0
Mitchells & Butlers Leisure Retail Limited,17595,0,0,0,0,0,0,0
Guardians of Middle Earth Game,17724,0,0,0,0,0,0,0
NATL. Amusements (UK) Ltd.,17611,0,0,0,0,0,0,0
Zero Dark Thirty Movie,17726,0,0,0,0,0,0,0
Mandom Group,17873,0,0,0,0,0,0,0
Grand European Tours,18517,0,0,0,0,0,0,0
International Culinary Institute Switzerland (ICI),18874,0,0,0,0,0,0,0
American InterContinental University,18219,0,0,0,0,0,0,0
Keen Distribution,18327,0,0,0,0,0,0,0
Talaash Movie,17745,0,0,0,0,0,0,0
Health Quest,18502,1,0,2,3,0.333333333,0,0.666666667
Brick Harbor LLC,18509,0,0,0,0,0,0,0
Star Parker Patriots for Freedom PAC,18451,0,0,0,0,0,0,0
DSNR LABS,17840,3,0,0,3,1,0,0
Ralph 'n' Rich's,17684,0,0,0,0,0,0,0
"It's Possible, LLC",18781,3,0,0,3,1,0,0
Snow Flower and the Secret Fan Movie,17737,0,0,0,0,0,0,0
Let The Bullets Fly Movie,18009,0,0,0,0,0,0,0
Hitchcock Movie,18312,0,0,0,0,0,0,0
DownloadInfo Corp.,18849,0,0,0,0,0,0,0
FOX Television Stations,18300,0,0,0,0,0,0,0
Feel Good UK,18440,0,0,0,0,0,0,0
Motown The Musical,18596,0,0,0,0,0,0,0
21 Jump Street Movie,17727,0,0,0,0,0,0,0
Regional Tourism Organization 7,18071,0,0,0,0,0,0,0
Green Mountain Energy Company,17854,1,0,0,1,1,0,0
Dunelm Mill Ltd,17876,0,0,0,0,0,0,0
Ski Lake Tahoe,18792,0,0,0,0,0,0,0
The Keystone School,18512,1,4,0,5,0.2,0.8,0
Trigg Laboratories Inc.,18222,0,0,0,0,0,0,0
Kennesaw State University,18842,0,0,0,0,0,0,0
Diamond Manufacturers Ltd.,18443,0,0,0,0,0,0,0
Unitron,18851,0,0,0,0,0,0,0
The Little Clinic,18433,0,0,0,0,0,0,0
Lucky Strike New York,18513,0,0,0,0,0,0,0
West Hills Hospital,18277,0,0,0,0,0,0,0
Lucky Guy Play,18063,0,0,0,0,0,0,0
BISL Limited,18860,0,0,0,0,0,0,0
Killing Them Softly Movie,17744,0,0,0,0,0,0,0
Aliante Casino and Hotel,18215,0,1,1,2,0,0.5,0.5
The Sapphires Movie,18458,0,0,0,0,0,0,0
Jack The Giant Slayer Movie,18454,0,0,0,0,0,0,0
M3 Radio,17613,4,0,0,4,1,0,0
Artbeads.com,18438,0,0,0,0,0,0,0
Azamara Club Cruises,18065,2,0,0,2,1,0,0
Yidio LLC,17860,0,0,0,0,0,0,0
Comité Interprofessionnel du Vin de Champagne,18777,0,0,0,0,0,0,0
Hamilton Halton Brant Regional Tourism Association,18214,0,0,0,0,0,0,0
Sandhills Publishing Company,17612,0,0,0,0,0,0,0
"Springleaf Finance, Inc.",18489,0,0,0,0,0,0,0
Chasing Mavericks Movie,18311,0,0,0,0,0,0,0
The Washington Ballet,18837,0,0,0,0,0,0,0
Niner Bikes,18788,1,0,0,1,1,0,0
The University of Toledo Medical Center,18966,0,0,0,0,0,0,0
Journey Latin America Ltd,18225,0,0,0,0,0,0,0
Cloud Atlas Movie,18477,0,0,0,0,0,0,0
Nature Delivered Inc.,18844,0,0,0,0,0,0,0
Alviero Martini S.p.A.,17789,0,0,0,0,0,0,0
SnagFilms Inc,18461,0,0,0,0,0,0,0
Seminole Hard Rock Hotel and Casino Hollywood,18216,0,0,0,0,0,0,0
Savvis Communications Corporation,17786,0,0,0,0,0,0,0
McCain Foods Limited,18487,0,0,0,0,0,0,0
Meet Minneapolis,18866,0,0,0,0,0,0,0
Taken 2 Movie,18462,0,0,0,0,0,0,0
Whitman-Walker Health,18519,0,0,0,0,0,0,0
Captain America Movie,17718,0,0,0,0,0,0,0
Ifbyphone,18448,0,0,0,0,0,0,0
"The Old Palm Real Estate, LLC",18795,1,0,0,1,1,0,0
Stoker Movie,18317,0,0,0,0,0,0,0
The Kolter Group LLC,18881,0,0,0,0,0,0,0
My Week With Marilyn Movie,17739,0,0,0,0,0,0,0
Stratton Mountain Resort,17614,0,0,0,0,0,0,0
HP Hood LLC,18481,0,0,0,0,0,0,0
Dark Skies Movie,18452,0,0,0,0,0,0,0
"Camcor, Inc.",18871,0,0,0,0,0,0,0
HUNT Real Estate Corporation,18838,0,0,0,0,0,0,0
ReboundAlert,18483,0,0,0,0,0,0,0
"Fox News Network, L.L.C.",18314,0,0,0,0,0,0,0
HealthHeadlines.com,17785,7,0,2,9,0.777777778,0,0.222222222
The Art Of Getting By Movie,18313,0,0,0,0,0,0,0
Money Expert Ltd.,18504,0,0,0,0,0,0,0
Atlantic Canada Tourism Partnership,18522,0,0,0,0,0,0,0
The Change-Up Movie,18321,0,0,0,0,0,0,0
Choice Home Warranty,17859,0,0,0,0,0,0,0
3 Day Blinds Inc.,18518,2,0,0,2,1,0,0
Beasts Of The Southern Wild Movie,18316,0,0,0,0,0,0,0
Americans for Responsible Solutions PAC,18790,0,0,0,0,0,0,0
Playkix,18863,0,0,0,0,0,0,0
"Enviro Water Solutions, Inc.",18484,0,0,0,0,0,0,0
Greenbank Holidays Ltd.,18230,0,0,0,0,0,0,0
LifeBook Limited,18877,0,0,0,0,0,0,0
Survival Life,18787,0,0,0,0,0,0,0
United Utilities Group PLC,18231,0,0,0,0,0,0,0
EpicPlay LLC,17879,12,0,0,12,1,0,0
Phillip,18797,0,0,0,0,0,0,0
Fixtures Living,18796,0,0,0,0,0,0,0
College of William and Mary,17880,0,0,0,0,0,0,0
"Elfster, Inc.",18498,0,0,0,0,0,0,0
WiredViews Inc.,18836,0,0,0,0,0,0,0
Gay & Lesbian Alliance Against Defamation,18857,0,0,0,0,0,0,0
Mayors Against Illegal Guns Action Fund,17792,0,0,0,0,0,0,0
New England College,18861,0,0,0,0,0,0,0
Nextiva Inc.,18858,0,0,0,0,0,0,0
The Devil Inside Movie,17719,0,0,0,0,0,0,0
Houston Grand Opera,18783,0,0,0,0,0,0,0
Dries Buytaert,18328,0,0,0,0,0,0,0
thepoplook.com,18898,0,0,0,0,0,0,0
LynkU Limited,18594,0,0,0,0,0,0,0
The Bowery Presents,18868,0,0,0,0,0,0,0
Lotter Enterprises Limited,18521,0,0,0,0,0,0,0
TAP,17866,4,0,0,4,1,0,0
NBC News,18320,0,0,2,2,0,0,1
Warner Bros. Studio Tours,18497,0,0,0,0,0,0,0
Essex County Council,18595,0,0,0,0,0,0,0
Machine Gun Preacher Movie,17731,0,0,0,0,0,0,0
The Cowles Center,18526,0,0,0,0,0,0,0
LoveSac Alternative Furniture Co.,18862,0,0,0,0,0,0,0
Les Miserables Movie,17734,1,0,0,1,1,0,0
"West Point Builders & Developers, Inc.",18528,0,0,0,0,0,0,0
University of Leicester,18527,0,0,0,0,0,0,0
For A Good Time Call Movie,17746,0,0,0,0,0,0,0
"AMF Bowling Centers, Inc.",18714,0,0,0,0,0,0,0
Explore Minnesota Tourism,18785,0,0,0,0,0,0,0
Texas Department of Banking,18867,0,0,0,0,0,0,0
Columbus Museum of Art,18853,0,0,0,0,0,0,0
Splunk Inc.,18963,0,0,0,0,0,0,0
One Good Love LLC,18882,0,0,0,0,0,0,0
"Koch Agronomic Services, LLC.",18870,0,0,0,0,0,0,0
California Mental Health Services Authority (CalMHSA),18127,6,0,0,6,1,0,0
Intro 2020 Ltd.,17477,0,0,0,0,0,0,0
Tinker Tailor Soldier Spy Movie,17709,0,0,0,0,0,0,0
Museum of History & Industry,17977,0,0,0,0,0,0,0
Xtreme Nitro,17484,0,0,0,0,0,0,0
The Spectator (1828) Ltd.,17984,0,0,0,0,0,0,0
Hadeed Carpet,17927,0,0,0,0,0,0,0
Fun Size Movie,17677,0,0,0,0,0,0,0
Monarch Airlines Limited,18045,0,0,0,0,0,0,0
Interoute Communications Limited,17591,0,0,0,0,0,0,0
Ray Media Group,18052,1,0,3,4,0.25,0,0.75
CBS Interactive,18284,0,0,0,0,0,0,0
Parker University,17834,0,0,0,0,0,0,0
Hess Corporation,17602,2,1,0,3,0.666666667,0.333333333,0
Crazy Stupid Love Movie,18470,0,0,0,0,0,0,0
Stevens Institute of Technology,17609,0,0,0,0,0,0,0
"iCrowd, LLC",18070,0,0,0,0,0,0,0
sendsantacalls.com,18445,0,0,0,0,0,0,0
End of Watch Movie,18459,0,0,0,0,0,0,0
The Children's Institute,18488,0,0,0,0,0,0,0
J Edgar Movie,18463,0,0,0,0,0,0,0
Innovative Mattress Solutions,17784,0,0,0,0,0,0,0
Red Dawn Movie,17716,0,0,0,0,0,0,0
Canada Revenue Agency,18495,0,0,0,0,0,0,0
U Mobile Sdn Bhd,18520,0,0,0,0,0,0,0
Django Unchained Movie,17741,0,0,0,0,0,0,0
Orphans on Broadway,18845,0,0,0,0,0,0,0
"A#1 Air, Inc.",18852,0,0,1,1,0,0,1
Ineeka Tea,17965,0,0,0,0,0,0,0
Safe Step Walk-In Tubs,17427,0,0,0,0,0,0,0
"MGA Entertainment, Inc.",17429,0,0,0,0,0,0,0
Pilot Bancshares Inc.,17663,0,0,0,0,0,0,0
"Leading Edge Marketing, Inc.",17914,0,0,0,0,0,0,0
International Game Technology ('IGT'),17478,0,0,0,0,0,0,0
H. E. Butt Foundation,17480,0,0,0,0,0,0,0
Diary of a Wimpy Kid Movie,17714,0,0,0,0,0,0,0
Holy Motors Movie,17678,0,0,0,0,0,0,0
Beautiful Creatures Movie,18012,0,0,0,0,0,0,0
Atlanta Medical Center,18282,0,0,0,0,0,0,0
"InterCure, Inc.",17597,0,0,0,0,0,0,0
Hearst Media Services (Newspapers),18467,6,0,1,7,0.857142857,0,0.142857143
University of Saint Mary,18431,4,0,0,4,1,0,0
"Abydos Innovations, LLC.",18450,0,0,0,0,0,0,0
Christian Dior Couture,18480,0,0,0,0,0,0,0
North County Transit District,18482,0,0,0,0,0,0,0
"creativeLIVE, Inc.",17865,0,0,0,0,0,0,0
Jackson Hewitt,17780,0,0,0,0,0,0,0
Chipwrecked Movie,17729,0,0,0,0,0,0,0
"ALPS Distributors, Inc.",18514,0,0,0,0,0,0,0
Isuzu UK Limited,18782,0,0,0,0,0,0,0
Reno-Tahoe Marketing Committee,18784,0,0,0,0,0,0,0
foxinthepine.com,18899,0,0,0,0,0,0,0
ValueAppeal LLC,18848,0,0,0,0,0,0,0
Wendy Greuel for Mayor,18850,0,0,0,0,0,0,0
South Florida School Connection,18965,0,0,0,0,0,0,0
Dimension Data,18967,0,0,0,0,0,0,0
DownloadAngles.com,18865,3,0,0,3,1,0,0
Société Générale,17565,0,0,0,0,0,0,0
Bibby Financial Services Ltd,17967,0,0,0,0,0,0,0
McClelland & Stewart Limited,17474,0,0,0,0,0,0,0
"Annese & Associates, Inc.",17476,0,0,0,0,0,0,0
Southern Nevada Water Authority,17978,0,0,0,0,0,0,0
Danske Bank Group,18137,0,0,0,0,0,0,0
Flight Movie,17676,0,0,0,0,0,0,0
Boston Interactive,17933,0,0,0,0,0,0,0
Horizon Card Services,17935,0,0,1,1,0,0,1
"Ronald McDonald House Charities, Inc.",18269,0,0,2,2,0,0,1
Gilly Hicks,18044,3,0,0,3,1,0,0
Side Effects Movie,18010,0,0,0,0,0,0,0
bestibmdeals.com,18278,0,0,0,0,0,0,0
Hand Crafted Tasting Co.,17601,0,0,0,0,0,0,0
The Apparition Movie,18471,0,0,0,0,0,0,0
Arhaus,18437,0,0,0,0,0,0,0
Windells Camp,18067,0,0,0,0,0,0,0
Paul Gauguin Cruises,18446,0,0,0,0,0,0,0
The Hobbit Movie,18478,0,0,0,0,0,0,0
The Sessions Movie,18310,0,0,0,0,0,0,0
Mama Movie,17867,0,0,0,0,0,0,0
The Savile Row Company,18501,0,0,0,0,0,0,0
Prada S.p.A.,18503,0,0,0,0,0,0,0
Grande Communications Networks LLC,18510,3,0,0,3,1,0,0
This is 40 Movie,17733,0,0,0,0,0,0,0
Cirque du Soleil Worlds Away 3D Movie,17735,0,0,0,0,0,0,0
Taipei City Government,18778,0,0,0,0,0,0,0
New York State Department of Health,18780,26,2,18,46,0.565217391,0.043478261,0.391304348
FineAwards.com,18878,0,0,0,0,0,0,0
CHCP,17818,6,1,0,7,0.857142857,0.142857143,0
Learner's Digest International,17468,0,0,0,0,0,0,0
"Canada Dry Mott’s, Inc.",17968,0,0,0,0,0,0,0
Lovestruck Limited,17825,0,0,0,0,0,0,0
U.S. Consumer Opinion,17568,0,0,0,0,0,0,0
Kaneka Nutrients L.P.,17975,0,0,0,0,0,0,0
YellowHammer Media Group (YHMG),18136,0,0,0,0,0,0,0
City University London,17575,0,0,0,0,0,0,0
National Business Furniture,17986,0,0,0,0,0,0,0
iTunes,17675,63,6,49,118,0.533898305,0.050847458,0.415254237
The Hut.com Limited,17936,0,0,0,0,0,0,0
Herbal Magic Inc.,18268,0,0,0,0,0,0,0
Ralph Marlin,17682,0,0,0,0,0,0,0
KPN B.V.,17593,0,0,0,0,0,0,0
Ovo Energy Limited,17607,0,0,0,0,0,0,0
LGC LLC,18068,0,0,0,0,0,0,0
ShieldApps,18479,0,0,0,0,0,0,0
Chasing Ice Movie,18075,0,0,0,0,0,0,0
PTC Inc.,18529,0,0,0,0,0,0,0
The East Movie,18318,0,0,0,0,0,0,0
"Vortal Group, Inc.",17875,0,0,0,0,0,0,0
Ozonator LLC.,17793,0,0,0,0,0,0,0
"Epiq Systems, Inc.",18329,0,0,0,0,0,0,0
Guardian Savings Bank,17725,0,0,0,0,0,0,0
Windsor Brokers Ltd.,18511,0,0,0,0,0,0,0
The Guilt Trip Movie,17736,0,0,0,0,0,0,0
WE Movie,17743,0,0,0,0,0,0,0
Ponte Vedra Inn & Club,18847,0,0,0,0,0,0,0
Maybelline LLC.,18872,26,0,6,32,0.8125,0,0.1875
The Federal Trade Commission,17465,0,0,0,0,0,0,0
Renown Health,17969,0,0,0,0,0,0,0
Pro Beauty Tools,17699,0,0,0,0,0,0,0
The Perks Of Being A Wallflower Movie,17701,0,0,0,0,0,0,0
Bio-Medical Research Limited,17567,0,0,0,0,0,0,0
One Day Movie,17708,0,0,0,0,0,0,0
Travel Trade Recruitment,17976,0,0,0,0,0,0,0
Misco UK Ltd.,17667,0,0,0,0,0,0,0
The Orpheum Theatre Memphis,18135,1,0,0,1,1,0,0
CompuCom Systems Inc.,17669,4,0,0,4,1,0,0
Snowshoe Mountain Resort,18033,0,0,0,0,0,0,0
Canopies UK Ltd.,17574,0,0,0,0,0,0,0
Paper Coterie,18035,0,0,0,0,0,0,0
Univest Corporation,17576,0,0,0,0,0,0,0
A Late Quartet Movie,17674,0,0,0,0,0,0,0
Skyo,18267,0,0,0,0,0,0,0
Schreiner University,18276,0,0,0,0,0,0,0
"Kajeet, Inc.",17599,6,4,1,11,0.545454545,0.363636364,0.090909091
Shame Movie,18301,0,0,0,0,0,0,0
AmericanIdol.com,18303,0,0,1,1,0,0,1
John Dewar & Sons Company,18076,0,0,0,0,0,0,0
Supersmile,17869,0,0,0,0,0,0,0
Ziva Jewels Inc.,17874,0,0,0,0,0,0,0
Quartet Movie,17742,0,0,0,0,0,0,0
Parkview Health,18835,0,0,0,0,0,0,0
Jefferson's Restaurant,18839,0,0,0,0,0,0,0
thinkmoney Limited,18846,0,0,0,0,0,0,0
Plymouth University,18869,0,0,0,0,0,0,0
The Pasadena Playhouse,18880,0,0,0,0,0,0,0
Nevada State Bank,17971,0,0,0,0,0,0,0
Man On A Ledge Movie,17704,0,0,0,0,0,0,0
Utica College,17572,0,0,0,0,0,0,0
Running Warehouse,17921,0,0,0,0,0,0,0
Blue Cross Blue Shield of South Carolina,17922,0,0,0,0,0,0,0
"Web.com Group, Inc.",17671,50,9,0,59,0.847457627,0.152542373,0
Therafirm,17489,0,0,0,0,0,0,0
"Arbor Networks, Inc.",17586,0,0,2,2,0,0,1
ZDNET,18289,0,0,0,0,0,0,0
CBS Radio,18290,0,0,0,0,0,0,0
"Weleda, Inc.",17603,0,0,0,0,0,0,0
Orient-Express Group,17839,0,0,0,0,0,0,0
"Rent-A-Center, Inc.",17604,0,0,0,0,0,0,0
Warner Bros. Television,18472,1,0,0,1,1,0,0
Lola Versus Movie,18308,0,0,0,0,0,0,0
Cooke Communications LLC,17857,0,0,0,0,0,0,0
LTC Global,17872,0,0,0,0,0,0,0
NBC Universal Studios Home Entertainment,18322,2,1,17,20,0.1,0.05,0.85
iGATE Corporation,17790,0,0,0,0,0,0,0
Mission Pharmacal Company,18507,4,0,1,5,0.8,0,0.2
Houston Symphony,18525,0,0,0,0,0,0,0
Omni Financial Group Inc.,18793,0,0,0,0,0,0,0
"Aruba Networks, Inc",18840,0,0,0,0,0,0,0
Elitehill Trading Ltd,18843,0,0,0,0,0,0,0
"Dream World Partners, Inc.",18875,0,0,0,0,0,0,0
"VisiStat, Inc.",17425,0,0,0,0,0,0,0
The Twilight Saga Breaking Dawn - Part 1 Movie,17700,0,0,0,0,0,0,0
The Stow Company,17475,5,1,0,6,0.833333333,0.166666667,0
The Debt Movie,17707,0,0,0,0,0,0,0
Pacific Holidays Inc.,17432,0,0,0,0,0,0,0
The Republican Governors Association Washington PAN,17482,0,0,0,0,0,0,0
Sinnergy Entertainment,17925,0,0,8,8,0,0,1
St. Edward's University,18411,2,0,0,2,1,0,0
The Committee for a Responsible Federal Budget,17493,0,0,0,0,0,0,0
A Good Day to Die Hard Movie,18011,0,0,0,0,0,0,0
GameSpot,18286,0,0,0,0,0,0,0
Blue Cross Blue Shield of Texas,18061,8,0,0,8,1,0,0
Fox Sports,18293,2,0,1,3,0.666666667,0,0.333333333
Remodelista LLC,17850,0,0,0,0,0,0,0
"Internet Marketing group, Ltd.",18218,0,0,0,0,0,0,0
Virgin Active,17861,0,0,0,0,0,0,0
Horrible Bosses Movie,18486,0,0,0,0,0,0,0
"Ritani, LLC",18229,0,0,0,0,0,0,0
The Office Beer Bar and Grill,17868,0,0,0,0,0,0,0
Warner Bros. Interactive Entertainment,18493,0,0,0,0,0,0,0
The Call Movie,18593,0,0,0,0,0,0,0
trackamg.com,18779,0,0,0,0,0,0,0
Saudi Aramco,18786,0,0,0,0,0,0,0
"Herff Jones, Inc",18961,0,0,0,0,0,0,0
Room Service Deliveries,18854,0,0,0,0,0,0,0
"FoozeOn, LLC",18879,0,0,0,0,0,0,0
Lulu Software Malta Limited,17417,0,0,0,0,0,0,0
Humorswitch,17817,0,0,0,0,0,0,0
Gala Coral Group,17424,0,0,0,0,0,0,0
"AliveCor, Inc.",17919,0,0,0,0,0,0,0
Movie 43,17992,0,0,0,0,0,0,0
Workers' Voice,17492,0,0,0,0,0,0,0
"Vantage Hospitality Group, Inc.",17590,0,0,0,0,0,0,0
"Dropcam, Inc.",18419,4,1,2,7,0.571428571,0.142857143,0.285714286
Gogogogo.com,18053,0,0,0,0,0,0,0
Dead Man Down Movie,18421,0,0,0,0,0,0,0
Fox Filmed Entertainment Group (incl. Searchlight),18294,0,0,0,0,0,0,0
"GPV Entertainment, LLC",17851,2,0,0,2,1,0,0
Green Lantern Movie,18485,0,0,0,0,0,0,0
HMDX,17783,0,0,0,0,0,0,0
The Camping and Caravanning Club,18494,0,0,0,0,0,0,0
A Thousand Words Movie,17717,0,0,0,0,0,0,0
Warner Bros. Pictures,18496,0,0,0,0,0,0,0
"AeroDesigns, Inc.",17794,0,0,0,0,0,0,0
Firstmark Credit Union,18794,0,0,0,0,0,0,0
Fast Home Offer,18962,0,0,0,0,0,0,0
Weed Finder News,18855,0,0,0,0,0,0,0
Treasure Island Foods,18864,0,0,1,1,0,0,1
Towson University,17469,0,0,1,1,0,0,1
AirXcite Limited,17823,0,0,0,0,0,0,0
ARMA Global,17470,0,0,0,0,0,0,0
Park Place Dealerships,17569,1,0,0,1,1,0,0
Seeking A Friend For The End Of The World Movie,17706,0,0,0,0,0,0,0
iSNAP Education Project,17573,0,0,0,0,0,0,0
Fideicomiso de Promoción Turística de Mazatlán,17923,16,7,0,23,0.695652174,0.304347826,0
TIME dotCom Bhd,17987,0,0,0,0,0,0,0
US Beverage Advertising Corp,17988,0,0,0,0,0,0,0
Robert Morris University,17488,0,0,0,0,0,0,0
Omega Pharma Group,18038,0,0,0,0,0,0,0
priceslocker,18041,0,0,0,0,0,0,0
PureGreenCoffee.Com,17938,118,5,2,125,0.944,0.04,0.016
City Center Las Vegas,18006,0,0,0,0,0,0,0
San Diego Opera,18274,0,0,0,0,0,0,0
"Isle of Capri Casinos, Inc.",17588,0,0,0,0,0,0,0
Disney Cruise Line,18055,24,2,2,28,0.857142857,0.071428571,0.071428571
DISCOVERY Children's Museum,18424,0,0,0,0,0,0,0
CBS Local Digital Media,18288,4,0,1,5,0.8,0,0.2
University of Northern Colorado,17838,0,0,0,0,0,0,0
Apartments by Tonti,18441,0,0,0,0,0,0,0
Dave Smith Motor Group,17855,53,39,0,92,0.576086957,0.423913043,0
Phantom Movie,18455,0,0,0,0,0,0,0
Oz The Great And Powerful Movie,18456,0,0,0,0,0,0,0
Celcom Axiata Berhad,18224,0,0,0,0,0,0,0
HighEnd Pte. Ltd.,18491,0,0,0,0,0,0,0
Warner Bros. Home Entertainment,18492,0,0,0,0,0,0,0
NBC Owned Television Stations,18323,0,0,4,4,0,0,1
NBC Sports Group,18324,0,0,3,3,0,0,1
The Raven Movie,17723,0,0,0,0,0,0,0
TAG Heuer,18505,0,0,0,0,0,0,0
"Keds, LLC.",18506,0,0,0,0,0,0,0
ExFriendAlert,18591,0,0,0,0,0,0,0
The Tree of Life Movie,17738,0,0,0,0,0,0,0
Kalypso Media USA Inc,18524,0,0,0,0,0,0,0
SlashGear,18791,0,0,0,0,0,0,0
Make Meaning Inc.,18841,0,0,0,0,0,0,0
Viewer’s Voice,18960,0,0,1,1,0,0,1
Preparedness Radio Network,18859,0,0,0,0,0,0,0
Ohio Tuition Trust Authority,18873,0,0,0,0,0,0,0
Hunt & Palmer Cargo Charters Limited,17421,0,0,0,0,0,0,0
TheSingingZone.com,17422,0,0,0,0,0,0,0
Sinister Movie,17703,0,0,0,0,0,0,0
No on 32,17486,0,0,0,0,0,0,0
Ella's Kitchen (Brands) Limited,18039,0,0,0,0,0,0,0
MedExpress Urgent Care,18040,0,0,0,0,0,0,0
Hansel & Gretel Witch Hunters 3D Movie,18007,0,0,0,0,0,0,0
Banner Homes Group PLC,18271,0,0,0,0,0,0,0
American Center for Law and Justice,18272,0,0,0,0,0,0,0
Janssen Pharmaceutical Companies of Johnson & Johnson,17589,0,0,0,0,0,0,0
Transurban (USA) Operations Inc.,18425,0,0,0,0,0,0,0
Autos.ca,18439,0,0,0,0,0,0,0
A Very Harold and Kumar 3D Christmas Movie,18475,0,0,0,0,0,0,0
USHomeSecurityQuotes.com,18072,0,0,0,0,0,0,0
The Calling Movie,18457,0,0,0,0,0,0,0
Kid's Dental,18490,0,0,0,0,0,0,0
O-tus Corporation,17871,0,0,0,0,0,0,0
Rango Movie,17722,0,0,0,0,0,0,0
FreeWebsite.com,18590,0,0,0,0,0,0,0
"Rockler Companies, Inc.",18508,0,0,0,0,0,0,0
"Lahey Health System, Inc.",18789,0,0,0,0,0,0,0
Judith Leiber LLC,17414,0,0,0,0,0,0,0
Shopping Guide GmbH,17963,0,0,0,0,0,0,0
Patriot National Bank,17563,0,0,0,0,0,0,0
Arkansas Economic Development Commission,17431,0,0,0,0,0,0,0
Pariah Movie,17712,0,0,0,0,0,0,0
Teesside University,17578,0,0,0,0,0,0,0
Jack & Holly Martin & Associates,17680,0,0,0,0,0,0,0
Oregon Problem Gambling Helpline,18048,0,0,0,0,0,0,0
Axis Bank,18280,0,0,0,0,0,0,0
Yellow Pages Group (RedFlagDeals.com)Corp,18014,0,0,0,0,0,0,0
CareSpot,17831,1,0,0,1,1,0,0
The Descendants Movie,18297,0,0,0,0,0,0,0
Mexican Hass Avocado Importers Association (MHAIA),17846,5,1,1,7,0.714285714,0.142857143,0.142857143
Martha Marcy May Marlene Movie,18299,0,0,0,0,0,0,0
Digiturf.com,17848,0,0,0,0,0,0,0
Whataburger,17863,7,1,0,8,0.875,0.125,0
Snohomish County Tourism Bureau,17782,0,0,0,0,0,0,0
Follett Higher Education Group,17795,0,0,0,0,0,0,0
"Migraine Treatment Centers of America, LLC",18331,0,0,0,0,0,0,0
The Law Offices of Steidl and Steinberg,18597,0,0,0,0,0,0,0
Remington College,18833,0,0,0,0,0,0,0
Luxury Link LLC,16777,1,0,0,1,1,0,0
Cornerstone University,19027,0,0,0,0,0,0,0
California Highway Patrol,19032,0,0,0,0,0,0,0
"Puetz Evergreen Golf Course, Inc.",19025,0,0,0,0,0,0,0
Registration Transfers Ltd.,19031,0,0,0,0,0,0,0
Luxola Pte Ltd.,19028,0,0,1,1,0,0,1
De Montfort University,19026,0,0,0,0,0,0,0
Golden Village Multiplex Pte Ltd.,18465,0,0,0,0,0,0,0
Audiogon,19033,0,0,0,0,0,0,0
"Micro Electronics, Inc.",19029,3,0,0,3,1,0,0
The Parkline Condominium,19030,0,0,0,0,0,0,0
Sportpursuit Ltd,17213,0,0,0,0,0,0,0
Reservation Shop S.L.U,16796,0,0,0,0,0,0,0
Ohio Lake Erie Commission,16260,0,0,0,0,0,0,0
Early Learning Centre Limited,17496,0,0,0,0,0,0,0
Saint Lucia Tourist Board,17498,0,0,0,0,0,0,0
Autentica Cuba,17245,0,0,0,0,0,0,0
"Brown Safe Manufacturing, Inc.",17330,0,0,0,0,0,0,0
Ski Utah,17505,1,0,0,1,1,0,0
Reed Online Ltd,16577,0,0,0,0,0,0,0
Ernest Jones,18909,0,0,0,0,0,0,0
"Backblaze, Inc.",18338,0,0,0,0,0,0,0
Ross University,18973,4,0,0,4,1,0,0
TV.com,18355,0,0,0,0,0,0,0
Rapid7 LLC,17506,0,0,0,0,0,0,0
Chevrolet,18349,339,29,51,419,0.809069212,0.069212411,0.121718377
Daniels Home Center Inc.,18977,0,0,0,0,0,0,0
"Marco's Franchising, LLC.",18915,0,0,0,0,0,0,0
"CQ Roll Call, Inc.",17519,0,0,0,0,0,0,0
FirstGroup plc,17497,0,0,0,0,0,0,0
ILLVA SARONNO S.p.A.,17514,0,0,1,1,0,0,1
Associated Food Stores Inc.,18923,0,0,0,0,0,0,0
Millennial Media,18918,0,0,0,0,0,0,0
Bloomsbury Publishing Plc,18924,1,0,0,1,1,0,0
Thrive Frozen Nutrition,18911,0,0,0,0,0,0,0
SimpleTuition Inc.,17511,0,0,0,0,0,0,0
Bravo Media,18361,0,0,4,4,0,0,1
Orscheln Group,18659,1,0,1,2,0.5,0,0.5
Times Scare,17513,0,0,0,0,0,0,0
Statesman Solutions,17528,0,0,0,0,0,0,0
L. Perrigo Corporation,18932,0,0,0,0,0,0,0
Auto Discounts Sdn Bhd,18901,0,0,0,0,0,0,0
LD Entertainment,17515,0,0,0,0,0,0,0
CBS Television Stations,18353,0,0,0,0,0,0,0
"Sweepstakes.com Interactive Media, LLC",18653,0,0,0,0,0,0,0
ActivTrades PLC,17512,0,0,0,0,0,0,0
University of Westminster,17530,0,0,0,0,0,0,0
Syfy,18362,0,0,2,2,0,0,1
William Lyon Homes Inc,18655,1,0,1,2,0.5,0,0.5
"ADTRAN, Inc.",17531,2,0,0,2,1,0,0
CHRISTUS Health,18662,0,0,0,0,0,0,0
PishPoshBaby,17524,0,0,0,0,0,0,0
"uNu Electronics, Inc.",18913,0,0,0,0,0,0,0
"Colts, Inc.",18907,0,0,0,0,0,0,0
Ariste Holding Limited,17517,0,0,0,0,0,0,0
"Noodle Education, Inc",18660,0,0,0,0,0,0,0
Simon & Schuster,18352,13,0,0,13,1,0,0
Bannatyne Fitness Ltd,18919,0,0,0,0,0,0,0
"Soloflex, Inc.",18908,0,0,0,0,0,0,0
Gnuf Limited,17545,0,0,0,0,0,0,0
Baltimore Washington Medical Center,17526,0,0,0,0,0,0,0
Bargain Room Inc.,17509,0,0,0,0,0,0,0
Rusmur Floors,18976,0,0,0,0,0,0,0
Yes You Can Diet Plan,18930,0,0,0,0,0,0,0
"Cinda b USA, LLC",18657,0,0,0,0,0,0,0
LumpSum Pension Advance,18652,6,0,0,6,1,0,0
Med Foods Inc.,17522,0,0,0,0,0,0,0
Hartz's Homes,18926,0,0,0,0,0,0,0
FLOR,18337,0,0,0,0,0,0,0
Utah Educational Savings Plan,17516,0,0,0,0,0,0,0
Mother Parker’s Tea & Coffee Inc.,18920,0,0,0,0,0,0,0
"Santa Clarita Valley Signal (Morris Multimedia, Inc.)",18981,0,0,0,0,0,0,0
Orbital Travel Ltd.,18927,0,0,0,0,0,0,0
Withings,17510,0,0,0,0,0,0,0
USA Network,18359,0,0,0,0,0,0,0
MUN (UK) LTD,18914,0,0,0,0,0,0,0
TJX UK,17534,0,0,0,0,0,0,0
Oldcastle,18931,0,0,0,0,0,0,0
Abu Dhabi Tourism and Culture Authority,17533,0,0,0,0,0,0,0
NetZero,17535,0,0,1,1,0,0,1
"NASDAQ OMX Corporate Solutions, Inc.",17541,0,0,0,0,0,0,0
EdgeWave Inc.,17540,0,0,0,0,0,0,0
"Marc Jacobs International, LLC",17542,0,0,0,0,0,0,0
Gavrieli,17546,0,0,0,0,0,0,0
Priority Automotive Group,17543,0,0,0,0,0,0,0
BURGERS' SMOKEHOUSE,17379,1,0,1,2,0.5,0,0.5
"Runic Games, Inc.",17345,0,0,0,0,0,0,0
UsedRV Pros,16092,0,0,0,0,0,0,0
New Orleans Botanical Garden,13635,0,0,0,0,0,0,0
Scott Abel & Balboa Media,17296,1,0,0,1,1,0,0
SilverScript Insurance Company,17362,0,0,0,0,0,0,0
Invest in France Agency,17445,0,0,0,0,0,0,0
Endicott College,17447,0,0,0,0,0,0,0
stv.tv limited,17177,0,0,0,0,0,0,0
DSstyles,17179,0,0,0,0,0,0,0
Bad Teacher Movie,1586,0,0,0,0,0,0,0
Prestone Products Corporation,18921,0,0,1,1,0,0,1
Edward Health Services Corporation,18887,1,0,0,1,1,0,0
CNBC,18360,2,0,1,3,0.666666667,0,0.333333333
Extreme Flash Player,18894,0,0,0,0,0,0,0
HM Revenue & Customs,18928,0,0,0,0,0,0,0
Charles Tyrwhitt LLP,18889,0,0,0,0,0,0,0
WebMediaBrands Inc.,17549,0,0,0,0,0,0,0
Cobblestone Auto Spa,18989,0,0,0,0,0,0,0
Santa Clarita Tourism Office,18902,0,0,0,0,0,0,0
ONEO,18719,14,0,1,15,0.933333333,0,0.066666667
Bay Area Air Quality Management District,18334,0,0,0,0,0,0,0
Pyramid Companies,17502,0,0,0,0,0,0,0
Free Speech Systems LLC,18970,2,0,0,2,1,0,0
Cable Public Affairs Channel Inc. (CPAC),17527,0,0,0,0,0,0,0
EasyTurf,18663,0,0,0,0,0,0,0
Cadence Health,18895,0,0,0,0,0,0,0
ABC Family,18377,0,0,0,0,0,0,0
South Jersey Healthcare,19081,0,0,0,0,0,0,0
"DNC Parks & Resorts at Yosemite, Inc.",18613,0,0,0,0,0,0,0
Sales Gossip Ltd.,18335,0,0,0,0,0,0,0
BrightRoll Inc.,17508,35,17,2,54,0.648148148,0.314814815,0.037037037
Maps of World Store,18730,0,0,0,0,0,0,0
PsychicSource.com,18912,0,0,0,0,0,0,0
Quick Lane,18346,0,0,0,0,0,0,0
One True Media,18396,0,0,0,0,0,0,0
"Movieline, LLC",18978,0,0,0,0,0,0,0
Situation Publishing,18988,0,0,0,0,0,0,0
"Widgix, LLC",18601,0,0,1,1,0,0,1
MSNBC,18371,0,0,0,0,0,0,0
Schlitterbahn,18602,0,0,0,0,0,0,0
SuperOffice AS,18603,0,0,0,0,0,0,0
IG Group,17552,0,0,0,0,0,0,0
Proexport,18737,0,0,0,0,0,0,0
Des Moines Performing Arts,18896,0,0,0,0,0,0,0
The Joinery,18727,0,0,0,0,0,0,0
The New Hope Center for Hearing,18987,0,0,0,0,0,0,0
"Upsher-Smith Laboratories, Inc.",18888,1,0,1,2,0.5,0,0.5
Chattanooga Visitor Bureau,19153,0,0,0,0,0,0,0
SVG Tourism Authority,19006,0,0,0,0,0,0,0
Siemens STEM Academy,19198,0,0,0,0,0,0,0
InteleTravel.com,18720,0,0,0,0,0,0,0
SilverDownloads,18885,3,0,0,3,1,0,0
Digital Signage Connection,18891,0,0,0,0,0,0,0
Cotton Traders Ltd,17551,0,0,0,0,0,0,0
New York Life Investment Management LLC,18992,0,0,1,1,0,0,1
"Valtra, Inc.",18755,0,0,0,0,0,0,0
ExperienceBG,18991,0,0,0,0,0,0,0
Bownty ApS,18996,0,0,0,0,0,0,0
Bangor University,18995,0,0,0,0,0,0,0
"LiveWorld, Inc.",19013,0,0,0,0,0,0,0
Japan National Tourism Organization,18985,1,0,0,1,1,0,0
Bridesmaids Movie,18384,0,0,0,0,0,0,0
ABC News,18378,0,0,1,1,0,0,1
Houston Ballet Foundation,18532,0,0,0,0,0,0,0
Bulla Miami,18717,0,0,0,0,0,0,0
"Questcor Pharmaceuticals, Inc.",19162,0,0,0,0,0,0,0
Ziering UK,18606,0,0,0,0,0,0,0
Windham Mountain,19145,0,0,0,0,0,0,0
"Association of Independents in Radio, Inc.",17553,0,0,0,0,0,0,0
Porsche Dealerships,18614,9,0,0,9,1,0,0
"Race On Baltimore, LLC",19005,0,0,0,0,0,0,0
iNet Cubed Ltd.,18607,3,0,0,3,1,0,0
REFUND MANAGEMENT SERVICES (RMS),19009,0,0,0,0,0,0,0
Yeepgame,18732,0,0,0,0,0,0,0
Virginia Economic Development Partnership,18725,0,0,0,0,0,0,0
Central Florida Sports Commission,19010,0,0,0,0,0,0,0
A Glimpse Inside the Mind of Charles Swan III Movie,18762,0,0,0,0,0,0,0
BrandTech Scientific Inc.,18998,0,0,0,0,0,0,0
"RSD Web Properties, LLC",18401,0,0,0,0,0,0,0
Fitness Technologies Limited,19023,0,0,0,0,0,0,0
Disney Studios Home Entertainment,18397,12,0,1,13,0.923076923,0,0.076923077
Masa Israel Journey,18738,0,0,0,0,0,0,0
Freedom Boat Club,18728,0,0,0,0,0,0,0
One Billion Rising,19000,0,0,0,0,0,0,0
"AppliancePartsPros.com, Inc.",19148,0,0,0,0,0,0,0
Taylor Wimpey plc,19152,0,0,0,0,0,0,0
INTERNATIONAL Brands Gallery (IBG),19017,0,0,0,0,0,0,0
"Vendini, Inc.",18723,0,0,0,0,0,0,0
Contraband Movie,18387,0,0,0,0,0,0,0
Turnberry Isle,18403,0,0,0,0,0,0,0
"Newgrounds, Inc.",19015,0,0,1,1,0,0,1
American Reunion Movie,18388,0,0,0,0,0,0,0
Utah Department of Alcoholic Beverage Control and Utah Prevention,18748,0,0,0,0,0,0,0
HomeAway Sàrl,17554,0,0,0,0,0,0,0
Castle Trust,19007,0,0,0,0,0,0,0
"Lee's Famous Recipes, Inc.",18402,0,0,0,0,0,0,0
Singapore Management University,18743,0,0,0,0,0,0,0
InVite Health,19107,0,0,0,0,0,0,0
"Optify, Inc.",19108,0,0,0,0,0,0,0
"Gnu Foods, LLC.",19256,0,0,0,0,0,0,0
Adventures by Disney,18392,8,0,0,8,1,0,0
Carnegie Mellon University,19106,0,0,0,0,0,0,0
GulfStream Communications,19091,0,0,0,0,0,0,0
GSM Association,19205,0,0,0,0,0,0,0
Trance Movie,19206,0,0,0,0,0,0,0
Plymouth Rock Group of Companies,19112,0,0,0,0,0,0,0
QuicklaneDeals.com,18734,0,0,0,0,0,0,0
Wanderful Media,19092,1,1,0,2,0.5,0.5,0
FindLaw,18400,0,0,0,0,0,0,0
Measat Broadcast Network Systems Sdn Bhd,18741,0,0,0,0,0,0,0
SB7 Mobile,19109,1,0,0,1,1,0,0
Abel & Cole Limited,18742,0,0,0,0,0,0,0
Chaparral Motorsports,19110,0,0,0,0,0,0,0
A J Bell Management Limited,19113,0,0,0,0,0,0,0
"JMA Ventures, LLC",19209,0,0,0,0,0,0,0
Fiesta Restaurant Group,19149,0,0,0,0,0,0,0
The Carle Foundation,19259,0,0,0,0,0,0,0
"Abry Brothers, Inc.",19156,0,0,0,0,0,0,0
Norco Products Ltd.,19114,0,0,0,0,0,0,0
FaceConferencing,19263,0,0,0,0,0,0,0
Baker Brothers Plumbing,19261,0,0,0,0,0,0,0
First South Financial,19151,1,0,0,1,1,0,0
"Americans to Protect Family Security, Inc.",18751,0,0,0,0,0,0,0
Balle & Associates,19094,0,0,0,0,0,0,0
Luvcow,18758,3,1,1,5,0.6,0.2,0.2
Dancing & Co Limited,19163,0,0,0,0,0,0,0
Guestcode.com,19208,0,0,0,0,0,0,0
United Nations,19214,0,0,0,0,0,0,0
HotChatDirect.com,19102,0,0,2,2,0,0,1
Harris Law Firm,19202,1,0,0,1,1,0,0
FastMed Urgent Care,19213,0,0,0,0,0,0,0
Tesco Ireland Limited,18753,0,0,0,0,0,0,0
AGA Rangemaster Limited,19260,0,0,0,0,0,0,0
"Sovran Self Storage, Inc.",19264,1,0,0,1,1,0,0
"LOYAL3 Securities, Inc.",18749,1,1,0,2,0.5,0.5,0
"Bloomfire, Inc.",19159,0,0,0,0,0,0,0
Malaysian Airline System Berhad,19200,0,0,0,0,0,0,0
toprewardzone.com,19160,0,0,0,0,0,0,0
Integrys Energy,18764,0,0,0,0,0,0,0
"Coventry Health Care, Inc.",19210,0,0,0,0,0,0,0
Yepp-Yepp (Hectiq),19217,0,0,0,0,0,0,0
Trainline.com Limited,18340,0,0,0,0,0,0,0
Emanuel Medical Center,18357,0,0,0,0,0,0,0
Texas Department of Transportation,18358,0,0,0,0,0,0,0
The Wise Miser,18925,0,0,0,0,0,0,0
NetPlayTV Group Ltd,17539,0,0,0,0,0,0,0
Food Storage Guys,19008,0,0,0,0,0,0,0
The Man With The Iron Fists Movie,18389,0,0,0,0,0,0,0
Kleinfeld Paper,19144,0,0,0,0,0,0,0
Sullivan Sullivan and McGuire,19090,0,0,0,0,0,0,0
Kennedy Restoration,18739,0,0,0,0,0,0,0
ArkPages,19257,0,0,0,0,0,0,0
Tampa General Medical Group,19258,0,0,0,0,0,0,0
Jigsaw Data Corporation,18757,0,0,0,0,0,0,0
"Charlotte Russe, Inc.",17500,5,0,5,10,0.5,0,0.5
ClickOnDetroit,18904,0,0,1,1,0,0,1
London Clubs International,18972,0,0,0,0,0,0,0
LighterLife UK Limited,18336,0,0,0,0,0,0,0
"Instagram, LLC",18979,7,0,1,8,0.875,0,0.125
TheAmericanSignal.com,17525,0,0,0,0,0,0,0
Seven Psychopaths Movie,18354,0,0,0,0,0,0,0
LifeStyle Advantage Limited,18929,0,0,0,0,0,0,0
"Security First Insurance Company, Inc.",17518,0,0,0,0,0,0,0
"Schwartz Investment Counsel, Inc.",17550,0,0,0,0,0,0,0
Ontario Tourism Marketing Partnership Corporation,18922,0,0,0,0,0,0,0
"Port Aventura Entertainment, S.A.",18897,0,0,0,0,0,0,0
FastestWayToPrepare.com,18661,0,0,0,0,0,0,0
DeSales University,19147,0,0,0,0,0,0,0
Salford City College,17532,0,0,0,0,0,0,0
Mike Chang Fitness LLC,18404,6,0,0,6,1,0,0
AIPioneer.com,18886,0,0,0,0,0,0,0
Sharps Bedrooms Limited,19161,0,0,0,0,0,0,0
Oxygen Media,18368,0,0,0,0,0,0,0
Georgia Department of Economic Development,19215,2,0,0,2,1,0,0
Sinclair Oil Corporation,18718,11,0,0,11,1,0,0
Multi Screen Media Pvt. Ltd.,18722,0,0,0,0,0,0,0
Elmhurst College,18997,0,0,0,0,0,0,0
World of Horsecraft AB,18611,8,0,1,9,0.888888889,0,0.111111111
Consumer Health Discoveries,19086,0,0,0,0,0,0,0
Interflora British Unit,19097,0,0,0,0,0,0,0
CollectorsProof.com,18747,0,0,0,0,0,0,0
"EduSearch Network, Inc.",19111,0,0,0,0,0,0,0
Kubota Tractor Corporation,19265,2,0,0,2,1,0,0
Raleigh America Inc.,19165,0,0,0,0,0,0,0
WE R HERE Coalition,19211,0,0,0,0,0,0,0
Aurigny Air Services,17503,0,0,0,0,0,0,0
Spuul Pte Ltd,17504,0,0,0,0,0,0,0
FilesCrunch.com,18339,0,0,0,0,0,0,0
Wave Accounting Inc.,18658,0,0,0,0,0,0,0
Overlake Hospital Medical Center,17521,0,0,0,0,0,0,0
Elite Body Sculpture,17536,0,0,0,0,0,0,0
ALCS Ltd.,18890,0,0,0,0,0,0,0
Intergi LLC,18990,0,0,0,0,0,0,0
"NBC Universal Media, LLC",18375,0,0,2,2,0,0,1
Join In Limited,18993,0,0,0,0,0,0,0
Piedmont Healthcare,18608,0,0,0,0,0,0,0
"Zetta, Inc.",18726,0,0,0,0,0,0,0
Pitch Perfect Movie,18390,0,0,0,0,0,0,0
Needle,19143,0,0,0,0,0,0,0
FriendFinder Networks Inc.,19093,0,0,0,0,0,0,0
"Bizo, Inc.",18740,1,0,0,1,1,0,0
Recommended Locksmith,19157,0,0,0,0,0,0,0
BuildingsGuide.com Online Inc.,19158,0,0,0,0,0,0,0
DiGi Telecommunications Sdn Bhd,19207,0,0,0,0,0,0,0
Barbican Centre,17499,0,0,0,0,0,0,0
Rubicon Project,17501,0,0,0,0,0,0,0
"Unitrends, Inc.",18969,0,0,0,0,0,0,0
NMD Interactive Inc.,18971,0,0,0,0,0,0,0
Veeder-Root Company,18980,0,0,0,0,0,0,0
Comcast SportsNet,18369,1,0,0,1,1,0,0
ABC Owned Television Stations Group,18376,0,0,0,0,0,0,0
Anna Maria College,18605,0,0,0,0,0,0,0
French-American Chamber of Commerce,18610,0,0,0,0,0,0,0
"Deseret Media Company, Inc.",18612,1,0,1,2,0.5,0,0.5
Windsor Court Hotel,19012,0,0,0,0,0,0,0
Mobile Nations,19014,0,0,0,0,0,0,0
Stream Live Limited,18735,0,0,0,0,0,0,0
Mary Lou Fulton Teachers College,19146,0,0,0,0,0,0,0
"Socialwise, Inc.",19103,0,0,0,0,0,0,0
Silver Airways Corp,19105,0,0,0,0,0,0,0
Hammonds Furniture Limited,19203,0,0,0,0,0,0,0
"GKIDS, INC.",19212,0,0,0,0,0,0,0
"Broadreach, Inc.",17495,0,0,0,0,0,0,0
Louisiana State University,18333,2,0,0,2,1,0,0
Saint Mary’s University,18916,0,0,0,0,0,0,0
Digital Experience Studios Inc.,18982,0,0,0,0,0,0,0
Style Media,18363,0,0,0,0,0,0,0
"FastOnlineCreditScores, LLC",17529,0,0,0,0,0,0,0
Visit Seattle,18933,0,0,0,0,0,0,0
Andy Mohr Splash Collision Center,17544,0,0,0,0,0,0,0
Steinberg Media Technologies GmbH,18984,0,0,0,0,0,0,0
Disney Theme Parks & Resorts,18380,181,22,22,225,0.804444444,0.097777778,0.097777778
Rainforest Alliance,19001,0,0,0,0,0,0,0
Iowa Economic Development,18531,1,0,0,1,1,0,0
University of Toronto,18533,0,0,1,1,0,0,1
Upper Deck,18733,0,0,0,0,0,0,0
"Jackalope Labs, Inc.",19018,0,0,0,0,0,0,0
"Silvercar, Inc.",18399,0,0,0,0,0,0,0
"Futuredontics, Inc.",19150,0,0,0,0,0,0,0
Keller Williams Realty,19101,0,0,0,0,0,0,0
Yowza Fitness,18750,0,0,0,0,0,0,0
"Destination Resorts Hawaii, Inc.",19201,0,0,0,0,0,0,0
Baton Rouge General Medical Center,18765,0,0,0,0,0,0,0
Zoopla Property Group Limited,19218,0,0,0,0,0,0,0
SeatMe Inc.,18884,0,0,0,0,0,0,0
Admission Movie,18365,0,0,0,0,0,0,0
Future plc,17548,0,0,0,0,0,0,0
Dream House Movie,18367,0,0,0,0,0,0,0
The Berkeley Group Holdings plc,18599,0,0,0,0,0,0,0
"Nuclear Games, LLC.",18716,0,0,0,0,0,0,0
Alluring Window NYC,19082,0,0,0,0,0,0,0
Abercrombie & Fitch,19084,9,0,0,9,1,0,0
"Gecko Software, Inc.",18731,0,0,0,0,0,0,0
Admiral Markets,19016,0,0,0,0,0,0,0
Mipony.net,19099,4,0,0,4,1,0,0
Humber River Hospital,19199,0,0,0,0,0,0,0
Sheridan College,19216,0,0,0,0,0,0,0
Sunday River Skiway Corp.,18986,0,0,0,0,0,0,0
"Schneider Downs & Co., Inc.",18604,0,0,0,0,0,0,0
Disney Phineas Animal Agents Movie,18379,0,0,0,0,0,0,0
"SESAC, Inc.",19004,0,0,0,0,0,0,0
ArtsandTV.company Inc.,18729,0,0,0,0,0,0,0
Coleman University,19011,0,0,0,0,0,0,0
Disney Theatrical Group,18393,1,0,2,3,0.333333333,0,0.666666667
Shurgard Self Storage,18736,0,0,0,0,0,0,0
AmericanMuscle,19022,0,0,0,0,0,0,0
California Medical Malpractice Attorneys,19104,0,0,0,0,0,0,0
Quintiq Holding B.V.,19154,0,0,0,0,0,0,0
Charlie Palmer Group,19197,0,0,0,0,0,0,0
THINKB4YOUSPEAK.COM,18754,0,0,0,0,0,0,0
Little Creek Casino Resort,19204,0,0,0,0,0,0,0
Smart Vitamin Club,18761,0,0,0,0,0,0,0
Walden Media,18994,0,0,0,0,0,0,0
Footage Firm,18721,0,0,0,0,0,0,0
Fast Five Movie,18385,0,0,0,0,0,0,0
Visit Napa Valley,19087,0,0,0,0,0,0,0
Chicago Athletic Clubs,19089,0,0,0,0,0,0,0
Turiya Media Inc.,19019,0,0,0,0,0,0,0
FindingADegree,19021,0,0,0,0,0,0,0
Classic Journeys LLC,19098,0,0,0,0,0,0,0
The D Las Vegas Casino Hotel,19196,0,0,1,1,0,0,1
First TransPennine Express,19255,0,0,0,0,0,0,0
update93.com,19155,0,0,0,0,0,0,0
"Fine Folks, Inc.",19164,0,0,0,0,0,0,0
"Raw Story Media, Inc.",18760,0,0,0,0,0,0,0
"William Ryan Homes, Inc",19088,0,0,0,0,0,0,0
OKA b. Brands,19095,0,0,0,0,0,0,0
PJ's College of Cosmetology,18745,0,0,0,0,0,0,0
Aryzta LLC,18752,0,0,0,0,0,0,0
"Virbac AH, Inc.",18763,0,0,0,0,0,0,0
The Royal Horticultural Society,18746,0,0,0,0,0,0,0
Amlin Underwriting Services Limited,18906,0,0,0,0,0,0,0
Marston's PLC.,18910,0,0,0,0,0,0,0
Zenovia Exchange,18974,0,0,0,0,0,0,0
Ortho Mattress Inc.,18356,0,0,0,0,0,0,0
Wachusett Mountain Ski Area,18656,0,0,0,0,0,0,0
Partners for Clean Air,17520,0,0,0,0,0,0,0
Darex.com,17523,4,0,0,4,1,0,0
Warner Bros. Theatre,17537,0,0,0,0,0,0,0
Latest-Hairstyles.com,17538,0,0,0,0,0,0,0
Black Eagle Movie,18892,0,0,0,0,0,0,0
Conscious Contraceptives,18724,1,0,0,1,1,0,0
GGM Publishing,18609,0,1,0,1,0,1,0
BACtrack,18391,0,0,0,0,0,0,0
EnergyWorks,19024,0,0,0,0,0,0,0
SimilarWeb Ltd.,18759,0,0,0,0,0,0,0
Darwin's Natural Pet Food,17413,0,0,0,0,0,0,0
AllSaints Retail Ltd,17464,1,4,0,5,0.2,0.8,0
BaubleBar Inc.,17813,0,0,0,0,0,0,0
"Jesta Digital, LLC",19035,0,0,0,0,0,0,0
VF London Limited,17562,0,0,0,0,0,0,0
"Artisan Mobile, Inc",19221,0,0,0,0,0,0,0
Antibodypedia AB,19121,0,0,0,0,0,0,0
Belfast Visitor & Convention Bureau,17962,0,0,0,0,0,0,0
Key Food,19040,0,0,0,0,0,0,0
Kink Bike Co.,19223,0,0,0,0,0,0,0
AMERICAN FRIENDS OF MAGEN DAVID ADOM (AFMDA),19226,0,0,2,2,0,0,1
Canada's Economic Action Plan,19228,0,0,0,0,0,0,0
RateZip,18113,0,0,0,0,0,0,0
Vada Spa,19123,0,0,0,0,0,0,0
Equip4work Ltd,19128,0,0,0,0,0,0,0
Blink Fitness,19130,3,0,0,3,1,0,0
"Beam Global Spirits and Wine, Inc.",19117,1,0,7,8,0.125,0,0.875
"DJZ, Inc",18669,1,0,0,1,1,0,0
"Frank Gay Services, Inc.",19119,0,0,1,1,0,0,1
The Twilight Saga Breaking Dawn - Part 2 Movie,17698,0,0,0,0,0,0,0
Regal Cigs,19232,0,0,0,0,0,0,0
USPack Logistics,19046,0,0,0,0,0,0,0
Raymond Gubbay Limited,17428,0,0,0,0,0,0,0
Peel Holdings,19132,0,0,0,0,0,0,0
Evalyn Dunn Gallery,19139,0,0,0,0,0,0,0
Aimia Coalition Loyalty UK Ltd,17662,0,0,0,0,0,0,0
Mac Haik Hutto,17913,0,0,0,0,0,0,0
"External IT, Inc.",18675,0,0,0,0,0,0,0
ClickBank,17479,3,1,1,5,0.6,0.2,0.2
Canadian Red Cross Society,19057,0,0,0,0,0,0,0
SolarWinds Inc.,18030,0,0,0,0,0,0,0
Adonis Golden Ratio,19058,32,2,2,36,0.888888889,0.055555556,0.055555556
Customized Fat Loss,18132,45,0,1,46,0.97826087,0,0.02173913
Cerritos Auto Square,18032,0,0,0,0,0,0,0
"Mindbody, Inc.",17930,0,0,0,0,0,0,0
Walker Texas Lawyer,17579,0,0,0,0,0,0,0
Jack and Jill Movie,17679,0,0,0,0,0,0,0
The Iron Lady Movie,17681,0,0,0,0,0,0,0
Mammoth Mountain Ski Area,18047,0,0,1,1,0,0,1
"Blackfling.com, LLC",18415,0,0,0,0,0,0,0
Gangster Squad Movie,17830,0,0,0,0,0,0,0
Selfridges Retail Limited,17598,0,0,0,0,0,0,0
"The Lampo Group, Inc.",18064,0,0,0,0,0,0,0
"Blu Homes, Inc.",17845,6,1,0,7,0.857142857,0.142857143,0
Horseshoe Cleveland Casino,18213,0,0,0,0,0,0,0
The Best Exotic Marigold Hotel Movie,18298,0,0,0,0,0,0,0
Neeley School of Business at TCU,19038,0,0,0,0,0,0,0
East-West University,18805,0,0,0,0,0,0,0
Telnames Ltd.,19053,0,0,0,0,0,0,0
"Arbonne International, LLC",18683,0,0,1,1,0,0,1
Zerto,19120,1,0,0,1,1,0,0
Kabbee Exchange Limited,19055,0,0,0,0,0,0,0
Bernstein Liebhard LLP,18667,0,0,0,0,0,0,0
DayMen Canada Acquisition ULC,18666,0,0,0,0,0,0,0
La Mirada Theatre for the Performing Arts,19133,0,0,0,0,0,0,0
Glenwood Management,19231,1,0,0,1,1,0,0
"Enbridge Energy Partners, L.P.",19135,0,0,0,0,0,0,0
professorpickup.com,19045,0,0,0,0,0,0,0
Emotiva Audio Corporation,18551,1,0,0,1,1,0,0
Bellagenix's Lifestyle's Program,19229,0,0,0,0,0,0,0
"MediaNaviCo, LLC",19050,0,0,0,0,0,0,0
VOS Media Ltd,19227,0,0,0,0,0,0,0
"Ultra Enterprises, Inc.",19319,0,0,0,0,0,0,0
First Things First,18535,0,0,0,0,0,0,0
"Acadia Shutters, Inc.",18673,1,0,0,1,1,0,0
Gladstone Brookes Limited,18802,0,0,0,0,0,0,0
MSCI Inc.,18668,0,0,0,0,0,0,0
Mr Green Limited,19234,0,0,0,0,0,0,0
The Paramount Theatre,19241,0,0,0,0,0,0,0
"Killington/Pico Ski Resort Partners, LLC",19244,0,0,0,0,0,0,0
"Parker Arts, Culture and Events (PACE) Center",19042,0,0,0,0,0,0,0
Sony Online Entertainment LLC,18670,1,0,0,1,1,0,0
"Famous Dave's of America, Inc.",18240,0,0,0,0,0,0,0
University of Miami,18801,0,0,0,0,0,0,0
Dr. Joseph Mercola,18677,17,1,9,27,0.62962963,0.037037037,0.333333333
Ode a la Rose Inc.,19062,0,0,0,0,0,0,0
Boost Basketball,19237,0,0,0,0,0,0,0
Federal-Mogul Corporation,19065,0,0,0,0,0,0,0
Fascinations,19063,0,0,0,0,0,0,0
Breckenridge Resort Chamber,18685,5,1,1,7,0.714285714,0.142857143,0.142857143
Game Dreamer Inc.,19134,0,0,0,0,0,0,0
Spring Breakers Movie,19323,0,0,0,0,0,0,0
I Love Skill Games ApS,18547,0,0,0,0,0,0,0
Interactive Ticketing Solutions,18238,0,0,0,0,0,0,0
Jeff Merkley for Oregon,18549,0,0,0,0,0,0,0
Gaijin Entertainment Corporation,18544,3,0,0,3,1,0,0
Astro Malaysia Holdings Berhad,19049,0,0,0,0,0,0,0
Berkeley Symphony Orchestra,19056,0,0,0,0,0,0,0
Bellhaven University,18546,0,0,0,0,0,0,0
Actinic Software Ltd,18823,0,0,0,0,0,0,0
NYU Skirball Center for the Performing Arts,19176,0,0,0,0,0,0,0
DHC USA Inc.,18679,0,0,0,0,0,0,0
Naked Juice Co.,18538,0,0,0,0,0,0,0
ToolbarStudio Inc.,19169,0,0,0,0,0,0,0
Lincoln Center for the Performing Arts,19170,0,0,0,0,0,0,0
Century Communities,18696,0,0,0,0,0,0,0
"Fire Mountain Gems and Beads, Inc.",19051,0,0,0,0,0,0,0
Central Florida Institute,18553,0,0,0,0,0,0,0
PictureCabinet Limited,19248,0,0,0,0,0,0,0
"Luby's Fuddruckers Restaurants, LLC",18942,0,0,0,0,0,0,0
The Heart Institute,18234,0,0,0,0,0,0,0
Distinctive Life,19073,0,0,0,0,0,0,0
The Incredible Burt Wonderstone Movie,18817,0,0,0,0,0,0,0
"Pacific Hospitality Group, LLC",19075,0,0,0,0,0,0,0
"Xplore, Inc.",18939,0,0,0,0,0,0,0
"NHL Interactive CyberEnterprises, LLC",19077,0,0,0,0,0,0,0
Kissimmee Convention and Visitors Bureau,19124,0,0,0,0,0,0,0
Falling Star Auctions,18681,1,0,0,1,1,0,0
Pat Riha Productions,18536,0,0,0,0,0,0,0
The Amen Clinics,18674,0,0,0,0,0,0,0
Full Circle Farm,18545,0,0,0,0,0,0,0
"Bedroom Plus, Inc.",18824,0,0,0,0,0,0,0
We Are Made In New York,18548,0,0,0,0,0,0,0
"Easton-Bell Sports, Inc.",18694,0,0,0,0,0,0,0
Marketwire Inc.,19317,0,0,0,0,0,0,0
Etihad Airways,18541,0,0,0,0,0,0,0
"South Cone, Inc.",18944,0,0,0,0,0,0,0
"Permanent General Companies, Inc",19070,0,0,0,0,0,0,0
183 Degrees Strategic Solutions,19328,0,0,0,0,0,0,0
"NJOY/Sottera, Inc.",19242,0,0,0,0,0,0,0
"Premier Internet Marketing, LLC",18706,0,0,0,0,0,0,0
"OmahaSteaks.com, Inc.",18830,1,0,0,1,1,0,0
EB Games,18825,0,0,0,0,0,0,0
"Larson Boat Group, LLC.",18709,0,0,0,0,0,0,0
The Elms Hotel & Spa,18703,0,0,0,0,0,0,0
"XGaming, Inc.",18691,0,0,0,0,0,0,0
Travelbag Ltd.,18708,0,0,0,0,0,0,0
"Swiss Watch International, Inc.",18815,0,0,0,0,0,0,0
The Arbor,18935,0,0,0,0,0,0,0
Resorts World at Sentosa Pte. Ltd.,19245,0,0,0,0,0,0,0
Minnesota Society of CPAs,19240,0,0,0,0,0,0,0
Dart Container Corporation,18820,0,0,0,0,0,0,0
Emlyon Business School,18255,0,0,0,0,0,0,0
CanadianForex Limited,18698,0,0,0,0,0,0,0
National Association of Professional Women (NAPW),19315,0,0,0,0,0,0,0
"Manduka, LLC",18569,0,0,0,0,0,0,0
Impression Bridal,18253,1,0,0,1,1,0,0
Covers Media Group Ltd.,18688,0,0,0,0,0,0,0
Acadia Homes,19324,0,0,0,0,0,0,0
Easy Finance Club,18262,0,0,0,0,0,0,0
Pathfinder Bank,19332,0,0,0,0,0,0,0
Action Fraud,19378,0,0,0,0,0,0,0
Gold Medal Fitness,19320,0,0,0,0,0,0,0
Setanta Sports Hibernia S.à r.l.,18686,0,0,0,0,0,0,0
Choices.com,18702,0,0,0,0,0,0,0
Taylor's University,18959,0,0,0,0,0,0,0
freevideosdownloadforpc.com,19362,0,0,0,0,0,0,0
"Lean In, Inc.",18945,0,0,0,0,0,0,0
"Network World, Inc.",18818,0,0,0,0,0,0,0
CZ Productions LLC,19492,0,0,0,0,0,0,0
ServiceNow,18543,0,0,1,1,0,0,1
Galliford Try Plc,19174,0,0,0,0,0,0,0
"Reboot Marketing, LLC",18570,6,6,0,12,0.5,0.5,0
Vita-Mix Corporation,19252,0,0,1,1,0,0,1
Insurance Hotline,18562,0,0,0,0,0,0,0
The Lighthouse Entertainment and Media Group,18556,0,0,0,0,0,0,0
The Mentholatum Company,19345,0,0,0,0,0,0,0
hungryhouse.com Ltd.,18236,0,0,0,0,0,0,0
Kelly Services Inc.,19387,0,0,0,0,0,0,0
"Personal Liberty Media Group, LLC",19187,0,0,0,0,0,0,0
Puyallup Cars,19441,1,0,0,1,1,0,0
HELP Group,19364,0,0,0,0,0,0,0
Dominion Enterprises and McMahon RV,18564,0,0,0,0,0,0,0
Pret A Manger (Europe) Ltd.,19189,0,0,0,0,0,0,0
Monash University,19375,0,0,0,0,0,0,0
Great Harvest Bread Company,19442,0,0,0,0,0,0,0
The Host Movie,19487,0,0,0,0,0,0,0
Palm Desert Visitor Center,18246,0,0,0,0,0,0,0
College for Financial Planning,18247,0,0,0,0,0,0,0
Restitution Movie,19677,0,0,0,0,0,0,0
"Big Idea Entertainment, LLC.",18566,0,0,0,0,0,0,0
Monnier Frères,18248,0,0,0,0,0,0,0
IronFX Financial Services Limited,19177,0,0,0,0,0,0,0
New Zealand Post,18565,0,0,0,0,0,0,0
edX.org,18705,12,1,0,13,0.923076923,0.076923077,0
Mindfire Solutions,18588,0,0,0,0,0,0,0
Vacation Express,18249,0,0,0,0,0,0,0
Children's Hospital of Wisconsin,19183,0,0,0,0,0,0,0
The Natural History Museum (NHM),19410,0,0,0,0,0,0,0
RBC Heritage,19247,0,0,0,0,0,0,0
Walpole Woodworkers,19336,0,0,0,0,0,0,0
"Red Bull New York, Inc.",19627,0,0,0,0,0,0,0
The Drinkaware Trust,19195,0,0,0,0,0,0,0
Evil Dead Movie,18949,0,0,0,0,0,0,0
Preston Automotive Group,18953,0,0,0,0,0,0,0
"Aplos Software, LLC.",18955,0,0,0,0,0,0,0
Hannah the Pet Society,19355,0,0,0,0,0,0,0
The Beer Institute,19341,0,0,1,1,0,0,1
"Ellie Fashion Group, Inc.",19389,0,0,0,0,0,0,0
channel4-news.s-com.tv,19172,0,0,0,0,0,0,0
Earth Hour Global Limited,19357,0,0,0,0,0,0,0
HE TRAVEL,18581,0,0,0,0,0,0,0
"Sprouts Farmers Markets, LLC",18951,0,0,0,0,0,0,0
The Underground Movement,19509,0,0,0,0,0,0,0
Dallas Convention and Visitors Bureau,19396,0,0,0,0,0,0,0
Domino Foods Inc.,18260,0,0,0,0,0,0,0
Update85.com,19349,0,0,0,0,0,0,0
Highland Titles Limited,18832,0,0,0,0,0,0,0
East Orange General Hospital,19431,0,0,0,0,0,0,0
Blue Diamond Growers,19184,0,0,0,0,0,0,0
Isle of Man Steam Packet Company,19331,0,0,0,0,0,0,0
Marie Curie Cancer Care,19351,0,0,0,0,0,0,0
To The Wonder Movie,19488,0,0,0,0,0,0,0
"The Dress Barn, Inc.",19342,0,0,0,0,0,0,0
Incyte Corporation,18563,0,0,0,0,0,0,0
The City Of Chandler Economic Developement Division,19194,0,0,0,0,0,0,0
Scribendi Inc.,19181,0,0,0,0,0,0,0
Quality One Wireless,19395,0,0,0,0,0,0,0
Brandman University,18578,0,0,0,0,0,0,0
Reach the Beach Relay,19191,0,0,0,0,0,0,0
PC Mary's Inc.,19510,1,0,0,1,1,0,0
Raise Your Hand Texas,18827,0,0,0,0,0,0,0
"Ecology Auto Parts, Inc.",18948,0,0,0,0,0,0,0
WakeMed Health & Hospitals,19562,0,0,0,0,0,0,0
State University of New York College at Plattsburgh,18583,0,0,0,0,0,0,0
"Ironwood Pharmaceuticals, Inc.",18624,3,0,0,3,1,0,0
Knouse Foods Inc.,19188,0,0,0,0,0,0,0
Matalan,19413,0,0,0,0,0,0,0
SmartFares.com,19353,0,0,0,0,0,0,0
SkyNet Media Group LLC.,18693,0,0,0,0,0,0,0
Northwestern Lake Forest Hospital,19383,0,0,0,0,0,0,0
Lidl Stiftung & Co. KG,19759,0,0,0,0,0,0,0
Species is M Movie,19688,0,0,0,0,0,0,0
"Grind Media, LLC",18831,0,0,0,0,0,0,0
RHB Banking Group,19760,0,0,0,0,0,0,0
Village Roadshow Theme Parks Holdings USA Inc.,19631,0,0,0,0,0,0,0
Shelter Trading Limited,19432,0,0,0,0,0,0,0
"Dashers Insurance Services, Inc.",19072,0,0,0,0,0,0,0
Greater Los Angeles Zoo Association (GLAZA),18958,0,0,0,0,0,0,0
National Hot Rod Association (NHRA),19574,0,0,0,0,0,0,0
"CREDO Mobile, Inc.",18952,0,0,0,0,0,0,0
"Mack Weldon, Inc.",19612,5,0,0,5,1,0,0
G.I. Joe Retaliation Movie,18950,0,0,0,0,0,0,0
Holland & Barrett Retail Limited,19384,0,0,0,0,0,0,0
Pura Cleanse,18263,0,0,0,0,0,0,0
National Maritime Museum (UK),19435,0,0,0,0,0,0,0
The Red Movie,19618,0,0,0,0,0,0,0
Essential Nail Products Limited,19192,0,0,0,0,0,0,0
Sandos Internacional,19356,0,0,0,0,0,0,0
Oblivion Movie,19489,0,0,0,0,0,0,0
Ithaca College,19377,0,0,0,0,0,0,0
"Fazoli’s System Management, LLC",19828,0,0,0,0,0,0,0
ITT Exelis,19557,0,0,0,0,0,0,0
"CIE Tours International, Inc.",18822,0,0,0,0,0,0,0
Smarter Travel Media LLC,18256,4,0,0,4,1,0,0
"RMV Community Development, LLC",19348,0,0,0,0,0,0,0
Underpriced Furniture,19385,0,0,1,1,0,0,1
sofa.com Ltd,19359,0,0,0,0,0,0,0
Patterson J. Kincaid,19079,0,0,0,0,0,0,0
Houston Aeros,19394,0,0,0,0,0,0,0
Canyon Healthcare,19620,0,0,0,0,0,0,0
Condor Limited,18712,0,0,0,0,0,0,0
Airport Home Appliance,19254,0,0,0,0,0,0,0
"State of Colorado, Department of Higher Education",19368,1,0,1,2,0.5,0,0.5
Aevoe Corp.,19527,0,0,0,0,0,0,0
consumerlifestyleinsider.com,19360,0,0,0,0,0,0,0
Zoological Society of London,19400,0,0,0,0,0,0,0
"KBZ Communications, Inc.",19186,0,0,0,0,0,0,0
"Truly Nolen, Inc.",19382,1,0,0,1,1,0,0
"EarthLink, Inc.",19391,0,0,4,4,0,0,1
Jobe Roofing Company,19366,0,0,0,0,0,0,0
Kitchen Kaboodle,18254,0,0,0,0,0,0,0
Rightmove Group Limited,19623,0,0,0,0,0,0,0
David Weekley Homes,19621,0,0,0,0,0,0,0
The Place Beyond The Pines Movie,19634,0,0,0,0,0,0,0
Smarter Fuel Future,19501,0,0,0,0,0,0,0
5 Star Day Movie,19686,0,0,0,0,0,0,0
Missourians Against Costly Mandates,19566,0,0,0,0,0,0,0
ChallengePost Inc.,19437,0,0,0,0,0,0,0
Tom Udall,19564,0,0,0,0,0,0,0
The Odd Life Of Timothy Green Movie,19491,0,0,0,0,0,0,0
New Mexico State University,19619,0,0,0,0,0,0,0
Special Olympics,18259,0,0,0,0,0,0,0
ParcelQuest,19616,0,0,0,0,0,0,0
Open Download Manager,19749,3,0,9,12,0.25,0,0.75
Treehouse Comedy Productions,18713,0,0,0,0,0,0,0
"Steak 'n Shake Enterprises, Inc.",19630,5,0,0,5,1,0,0
MyFerryLink UK,19559,0,0,0,0,0,0,0
MetroWest Medical Center,19513,0,0,0,0,0,0,0
Hennesey Road Media LLC,19502,0,0,0,0,0,0,0
Seasons 52,19635,0,0,0,0,0,0,0
NRA - ILA,19560,0,0,0,0,0,0,0
The Cash1234 System,19637,0,0,0,0,0,0,0
Heart Photobooth,19388,0,0,0,0,0,0,0
Nifty Thrifty,19190,0,0,0,0,0,0,0
"Huawei Technologies Co., Ltd.",19443,0,0,0,0,0,0,0
Australia's Northern Territory,19516,0,0,0,0,0,0,0
Patriot Majority PAC,19568,0,0,0,0,0,0,0
Highschool Movie,19673,0,0,0,0,0,0,0
StopWaste.Org,19626,0,0,0,0,0,0,0
A Little Help Movie,19689,0,0,0,0,0,0,0
Public Notice,19570,0,0,0,0,0,0,0
Grinding Gear Games Limited,19370,0,0,0,0,0,0,0
InnovAge,19518,0,0,0,0,0,0,0
Werner Co.,19495,0,0,0,0,0,0,0
Hastings Insurance Services Limited,19347,0,0,0,0,0,0,0
Darrell Klassen Golf Lessons,19636,0,0,0,0,0,0,0
BackyardLiberty.com,19354,0,3,0,3,0,1,0
Branson/Lakes Area Chamber of Commerce/CVB,19650,0,0,0,0,0,0,0
After Earth Movie,19902,0,0,0,0,0,0,0
Cottageline,18586,0,0,0,0,0,0,0
New Jersey Education Association,19556,0,0,0,0,0,0,0
The Eye of the Storm Movie,19685,0,0,0,0,0,0,0
DealMates Sdn Bhd,19757,0,0,0,0,0,0,0
Spine Treatment Centers of America,19429,0,0,0,0,0,0,0
Moneyball Movie,19851,0,0,0,0,0,0,0
Yonkers Raceway,19412,4,0,0,4,1,0,0
Mud Movie,19674,0,0,0,0,0,0,0
WPXI-TV,19802,0,0,0,0,0,0,0
Mobotop,18619,0,0,0,0,0,0,0
Melancholia Movie,19678,0,0,0,0,0,0,0
Cross Cultural Journeys Foundation,18627,0,0,0,0,0,0,0
Movement Mortgage,19409,1,0,0,1,1,0,0
Lexington Center Corporation,19507,0,0,1,1,0,0,1
Core Capital Media LLC,19824,5,0,0,5,1,0,0
K-11 Movie,19687,0,0,0,0,0,0,0
SXSW Inc.,19514,0,0,0,0,0,0,0
London Paris New York Movie,19699,0,0,0,0,0,0,0
"Kos Media, LLC",19445,0,0,0,0,0,0,0
OptionsClick,19628,0,0,0,0,0,0,0
University of Liverpool,19648,0,0,0,0,0,0,0
Safe Movie,19692,0,0,0,0,0,0,0
CBC Restaurant Corp,18617,0,0,0,0,0,0,0
"Harris Media, LLC",19577,0,0,0,0,0,0,0
For the Love of Money Movie,19691,0,0,0,0,0,0,0
AutoSquad,18625,0,0,0,0,0,0,0
"Braille Institute of America, Inc.",19823,0,0,0,0,0,0,0
"AirMed International, LLC",19763,0,0,0,0,0,0,0
50/50 Movie,19694,0,0,0,0,0,0,0
2016 Movie,19696,0,0,0,0,0,0,0
NSI Holdings Ltd,19751,0,0,0,0,0,0,0
The HoneyBaked Ham Co.,18261,0,0,0,0,0,0,0
The Great Gatsby Movie,19835,0,0,0,0,0,0,0
Reto-Moto,18623,0,0,0,0,0,0,0
Friends of Jeanne Shaheen,19825,0,0,0,0,0,0,0
Transworld Network Corp,19753,0,0,0,0,0,0,0
INTI,18630,0,0,1,1,0,0,1
A Place At The Table Movie,19782,0,0,0,0,0,0,0
Sanpellegrino Group,19899,0,0,0,0,0,0,0
Crosby Lake Spirits Co.,19406,0,0,0,0,0,0,0
Exelon Corporation,19519,0,0,0,0,0,0,0
"Chicago Steak Company, Inc.",19831,0,0,0,0,0,0,0
Florida Citrus Commission,19583,1,0,0,1,1,0,0
Priorities USA Action,19578,0,0,0,0,0,0,0
Fordson Movie,19700,0,0,0,0,0,0,0
Chakravyuh Movie,19695,0,0,0,0,0,0,0
Christianpost.com,19523,0,0,0,0,0,0,0
"Castle Brands, Inc.",18626,0,0,0,0,0,0,0
freevideomediaconverter.com,19532,0,0,0,0,0,0,0
Lamkin Corporation,19826,0,0,0,0,0,0,0
Cosmopolis Movie,19849,0,0,0,0,0,0,0
pdfreaderapps.com,19499,0,0,0,0,0,0,0
National Restaurant Association,19800,0,0,0,0,0,0,0
Lubbock Christian University,19642,0,0,0,0,0,0,0
"Brown Financial Advisors, LLC",19652,0,0,0,0,0,0,0
"Vanko Trading, Incorporated",19761,0,0,0,0,0,0,0
Arthur Christmas Movie,19852,0,0,0,0,0,0,0
Armadil Ltd.,19645,0,0,0,0,0,0,0
Our Lady of the Lake University,19762,0,0,0,0,0,0,0
Bernie Movie,19526,0,0,0,0,0,0,0
Skirball Cultural Center,19615,0,0,0,0,0,0,0
Stratasys Ltd.,19447,0,0,0,0,0,0,0
Quill Corporation,19624,5,0,3,8,0.625,0,0.375
Albert Nobbs Movie,19683,0,0,0,0,0,0,0
North Carolina Blumenthal Performing Arts Center,19504,0,0,0,0,0,0,0
Corcoran Gallery of Art and College of Art & Design,19755,0,0,0,0,0,0,0
Miele Co Ltd.,19651,0,0,0,0,0,0,0
Muenchens Furniture,19528,0,0,0,0,0,0,0
TransCanada Corporation,19768,0,0,0,0,0,0,0
Solstice Marketing Concepts LLC,19640,0,0,0,0,0,0,0
Heritage Bank,19524,0,0,0,0,0,0,0
Concentra Operating Corporation,19649,1,0,0,1,1,0,0
Cobalt (ADP Dealer Services Inc.),19838,0,0,0,0,0,0,0
The Leinbach Company,19531,0,0,0,0,0,0,0
McConnell Senate Committee,19830,0,0,0,0,0,0,0
Donate Life Virginia,19799,0,0,0,0,0,0,0
WonderNetwork,19758,20,1,5,26,0.769230769,0.038461538,0.192307692
Schools-Edu.com,19832,0,0,0,0,0,0,0
Academy of Country Music,19530,0,0,0,0,0,0,0
Force Movie,19697,0,0,0,0,0,0,0
Vibrant Pittsburgh,18629,0,0,0,0,0,0,0
Rockland Trust,19647,0,0,0,0,0,0,0
"Daedong Industrial Company, Ltd.",19833,0,0,0,0,0,0,0
The Drive4Growth Company Limited,19765,0,0,0,0,0,0,0
"Apex Tool Group, LLC",19116,0,0,0,0,0,0,0
"Payday Cash Loans, LLC",19118,0,0,0,0,0,0,0
"DMS Network, Inc.",19235,0,0,0,0,0,0,0
"Ampush Media, Inc.",18682,0,0,0,0,0,0,0
RewardzoneUSA LLC,18233,7,1,1,9,0.777777778,0.111111111,0.111111111
Suddenlink Communication,19316,4,0,2,6,0.666666667,0,0.333333333
"Universal Furniture International, Inc.",19318,0,0,0,0,0,0,0
The Becket Fund for Religious Liberty,19067,0,0,0,0,0,0,0
Arizona Ready,18816,0,0,0,0,0,0,0
GSMC Limited,18699,0,0,0,0,0,0,0
The Melting Pot Restaurants Inc.,19333,0,0,0,0,0,0,0
"Amici's East Coast Pizzeria, Inc.",19182,0,0,0,0,0,0,0
Elizabeth Bradley,19386,0,0,0,0,0,0,0
Media Wales Ltd.,19433,0,0,0,0,0,0,0
Squaw Valley Ski Corporation,18265,0,0,0,0,0,0,0
AirMalta plc,19403,0,0,0,0,0,0,0
"Alure Home Improvements, Inc.",19503,0,0,0,0,0,0,0
"Greenpeace, Inc.",19569,0,0,0,0,0,0,0
Emperor Movie,19684,0,0,0,0,0,0,0
Talk Mobile Limited,18616,0,0,0,0,0,0,0
For Eyes Optical Company,19750,0,0,0,0,0,0,0
Usay Business Limited,19754,0,0,0,0,0,0,0
A Chorus Line London,19520,0,0,0,0,0,0,0
CREATETHE GROUP,18631,0,0,0,0,0,0,0
pureproductsdirect.com,19533,0,0,0,0,0,0,0
Guccio Gucci S.p.A,19801,0,0,0,0,0,0,0
Giosis Limited,19803,0,0,0,0,0,0,0
Protector Window and Door Inc.,19230,1,1,0,2,0.5,0.5,0
P&P Associates Ltd,19064,0,0,0,0,0,0,0
Findlay Roofing,18687,1,0,0,1,1,0,0
Standard Chartered Bank,19321,0,0,0,0,0,0,0
JVC Kenwood Corporation,18555,0,0,0,0,0,0,0
BNY Mellon,18819,0,0,0,0,0,0,0
BestQuotes.com,18821,0,0,0,0,0,0,0
Season of Savings,19330,0,0,0,0,0,0,0
Corporate Turnaround,19253,2,0,0,2,1,0,0
III Forks (3 Forks),18560,2,1,0,3,0.666666667,0.333333333,0
Seneca College of Applied Arts and Technology,18828,0,0,0,0,0,0,0
Rogers Broadcasting Limited,18251,0,0,0,0,0,0,0
ParticipACTION,18585,2,0,0,2,1,0,0
Philippine Department of Tourism,18587,0,0,0,0,0,0,0
PointMMO Pte Ltd.,19430,0,0,0,0,0,0,0
Cruise.com,19555,0,0,0,0,0,0,0
One Source Talent,19398,0,0,0,0,0,0,0
"MiLEND, Inc.",19496,0,0,0,0,0,0,0
Fit Private Investment Counsel Inc.,19498,0,0,0,0,0,0,0
"National Grid USA Service Company, Inc.",18621,1,0,1,2,0.5,0,0.5
iPage Hosting,18628,0,0,0,0,0,0,0
Pokemon The Movie,19698,0,0,0,0,0,0,0
The TDL Group Corp.,19521,0,0,0,0,0,0,0
HealtheLifeDaily.com,19764,0,0,0,0,0,0,0
StoresCompared.com,19766,0,0,0,0,0,0,0
Jordans & Ryvita Company Limited,19796,0,0,0,0,0,0,0
Air France KLM Group,19798,0,0,0,0,0,0,0
5Dimes Casino & Sportsbook,19220,0,0,0,0,0,0,0
D'Angelo Sandwich Shops,19131,0,0,0,0,0,0,0
Calvary Episcopal Church,19138,0,0,0,0,0,0,0
WaveCloud Corporation,19238,0,0,0,0,0,0,0
LHR Airports Limited,18813,0,0,0,0,0,0,0
"PennyMac Loan Services, LLC",18552,0,0,0,0,0,0,0
GrowthAccelerator,18938,0,0,0,0,0,0,0
"SugarCRM, Inc.",18695,0,0,0,0,0,0,0
Exploring Ireland,18245,1,0,0,1,1,0,0
Upper Street Events Ltd,19338,0,0,0,0,0,0,0
Vein Atlanta,18252,0,0,0,0,0,0,0
Vanquis Bank Limited,18577,0,0,0,0,0,0,0
Glimcher,18956,0,0,0,0,0,0,0
A Place For Mom Inc.,19381,0,0,0,0,0,0,0
Interim HealthCare Inc.,19363,0,0,0,0,0,0,0
Sport Ngin,19613,0,0,0,0,0,0,0
Otterbein University,19438,0,0,0,0,0,0,0
Al Franken,19563,0,0,0,0,0,0,0
Parker Adventist Hospital,19449,0,0,0,0,0,0,0
Touchback Movie,19681,0,0,0,0,0,0,0
Systemax Inc.,19506,0,0,0,0,0,0,0
Sellar Group,18620,0,0,0,0,0,0,0
Jefferson Regional Medical Center,19638,0,0,0,0,0,0,0
Campaign for Tobacco-Free Kids,19581,0,0,0,0,0,0,0
Leon Medical Centers,19044,0,0,0,0,0,0,0
"EEFC., Inc.",19048,0,0,0,0,0,0,0
"The Ultimate Zip, LLC",18671,0,0,0,0,0,0,0
Nationwide Building Society,19137,0,0,0,0,0,0,0
Greg Smith for City Attorney,18537,0,0,0,0,0,0,0
British Red Cross,19314,0,0,0,0,0,0,0
"Consolidated Restaurant Operations, Inc.",18810,2,0,0,2,1,0,0
Bechiro S.L.,18237,4,0,5,9,0.444444444,0,0.555555556
DealPly Technologies Ltd,19069,0,0,0,0,0,0,0
"Orlando Pro Hockey Operations, L.P.",19173,0,0,0,0,0,0,0
Bentley Motors Limited,19071,0,0,0,0,0,0,0
Vizant Technologies,18937,0,0,0,0,0,0,0
Indeed Inc.,19078,0,0,0,0,0,0,0
"FinancialForce.com, inc.",18946,0,0,0,0,0,0,0
Essense Designs,19339,0,0,0,0,0,0,0
The Color Run,18571,0,0,0,0,0,0,0
University of Exeter,19346,0,0,0,0,0,0,0
"MetisMD, LLC",19373,0,0,0,0,0,0,0
Brookside II Bar and Grill,18710,0,0,0,0,0,0,0
Home Builders Association of Metro Harrisburg,19380,0,0,0,0,0,0,0
Kentucky Department of Travel,19614,0,0,0,0,0,0,0
"Mitsui & Co., Ltd",19371,0,0,0,0,0,0,0
Eurosport Player,19405,0,0,0,0,0,0,0
Children’s Bereavement Center of South Texas,19448,0,0,0,0,0,0,0
Doctored Movie,19682,0,0,0,0,0,0,0
Fort Worth Zoo,19414,0,0,0,0,0,0,0
National Association of Broadcasters,19571,0,0,0,0,0,0,0
"Applied Nutritional Research, LLC.",19512,0,0,0,0,0,0,0
National Cable & Telecommunications Association,19580,0,0,0,0,0,0,0
Hyde Park,19641,0,0,0,0,0,0,0
Silentnight Group Ltd.,19043,0,0,0,0,0,0,0
Southland Credit Union,18676,0,0,0,0,0,0,0
Enfinium Pty Ltd,18807,0,0,0,0,0,0,0
Centra,18239,0,0,0,0,0,0,0
Collinson Group,19325,0,0,0,0,0,0,0
Getrevising.co.uk,18557,0,0,0,0,0,0,0
"Silverton Casino, LLC",19076,0,0,1,1,0,0,1
Omlet Ltd.,18943,0,0,0,0,0,0,0
Wiltshire Farm Foods,18826,0,0,0,0,0,0,0
"UVNV, Inc.",18572,0,0,0,0,0,0,0
Southall Travel Limited,19344,0,0,0,0,0,0,0
ATOL Department (Air Travel Organizers),18575,0,0,0,0,0,0,0
Zuora Inc.,19193,0,0,0,0,0,0,0
Direct Line for Business,18257,0,0,0,0,0,0,0
Champion AC,18957,0,0,0,0,0,0,0
creditcardandloanoffers.com,19361,0,0,0,0,0,0,0
Vine Path,18589,0,0,0,0,0,0,0
360Cut,19558,0,0,0,0,0,0,0
Florida's Natural Growers,19561,0,0,0,0,0,0,0
111111 Movie,19675,0,0,0,0,0,0,0
MindArk PE AB,19625,2,0,0,2,1,0,0
Founders Entertainment,19411,0,0,0,0,0,0,0
"VIVUS, Inc.",19508,1,0,2,3,0.333333333,0,0.666666667
Airlines for America,19575,0,0,0,0,0,0,0
BrainBuys,19511,0,0,0,0,0,0,0
Arizona Nutrition Network,18622,0,0,0,0,0,0,0
Stand Strong Movie,19693,0,0,0,0,0,0,0
"Educational Media Group, LLC",19829,0,0,0,0,0,0,0
Catholic Healthcare Partners,19525,0,0,0,0,0,0,0
MModal IP LLC,19122,0,0,0,0,0,0,0
Baldwin & Sons,19129,0,0,0,0,0,0,0
Northern Ireland Water Ltd.,19047,0,0,0,0,0,0,0
Western General Insurance Company,19136,0,0,0,0,0,0,0
EmploymentCrossing,19054,0,0,0,0,0,0,0
"Intrepid Museum Foundation, Inc.",18804,0,0,0,0,0,0,0
BSaving.com,19061,0,0,0,0,0,0,0
"Builder Homesite, Inc.",19322,0,0,0,0,0,0,0
dailyconsumer-tips.com,18936,0,0,0,0,0,0,0
American Hospital Association,18243,0,0,0,0,0,0,0
Snow Summit Inc.,19329,0,0,0,0,0,0,0
"En Masse Entertainment, Inc.",18704,1,0,0,1,1,0,0
Teekanne GmbH,19340,0,0,0,0,0,0,0
surveillancenationreport.com,18829,0,0,0,0,0,0,0
The Music Center,19372,0,0,0,0,0,0,0
Builders Association of Greater Indianapolis,18711,1,0,0,1,1,0,0
"Audicus, Inc.",18954,0,0,0,0,0,0,0
Maurices Incorporated,19390,0,0,0,0,0,0,0
"SnapLogic, Inc.",19440,0,0,0,0,0,0,0
New York City Center,19622,0,0,0,0,0,0,0
"Centro Media, Inc.",19565,0,0,0,0,0,0,0
Proximo Spirits,19629,0,0,0,0,0,0,0
"The Video Converter, LLC",18618,2,0,0,2,1,0,0
Next Retail Ltd.,19529,0,0,0,0,0,0,0
Glazer's Camera,19224,0,0,1,1,0,0,1
Energy Realities,19041,0,0,2,2,0,0,1
"Bassett Furniture Industries, Inc",19127,0,0,1,1,0,0,1
TAG2 Telecom LLC,19141,0,0,0,0,0,0,0
OilDrillingPartners.info,19142,0,0,0,0,0,0,0
Bok Tower Gardens,19059,0,0,0,0,0,0,0
Conservative Political Action Conference (CPAC),18806,0,0,0,0,0,0,0
The Mob Museum,19060,1,0,0,1,1,0,0
Code 42 Software,18809,0,0,0,0,0,0,0
Towergate Underwriting Group Ltd,18692,0,0,0,0,0,0,0
Plan UK,18241,0,0,0,0,0,0,0
Lincoln Academy & GED Online Diploma,19327,0,0,0,0,0,0,0
Cellectis bioresearch Inc.,19074,0,0,0,0,0,0,0
"Hughes Watters Askanase, LLP",18559,0,0,0,0,0,0,0
Boba Inc.,18941,2,0,1,3,0.666666667,0,0.333333333
Gamepot Inc.,18573,0,0,0,0,0,0,0
Bellroy Pty Ltd.,18574,7,0,0,7,1,0,0
University of Buckingham,19374,0,0,0,0,0,0,0
Woodland Heights Medical Center,19392,0,0,0,0,0,0,0
"SnapOne, Inc.",19827,0,0,0,0,0,0,0
The Age UK Group,18665,0,0,0,0,0,0,0
Gibbs Landscape Company,18799,0,0,0,0,0,0,0
Willpower Entertainment,19052,0,0,0,0,0,0,0
Feld Motor Sports,18684,0,0,0,0,0,0,0
"PowerPlay Destination Properties (Hawaii), Inc.",19167,0,0,0,0,0,0,0
St. Ann's Warehouse,18550,0,0,0,0,0,0,0
James Villa Holidays,19250,0,0,0,0,0,0,0
The Health Lottery Ltd.,18701,0,0,0,0,0,0,0
BEYOND YOGA,19335,0,0,0,0,0,0,0
Solar America Corp,18567,0,0,0,0,0,0,0
"CPO Commerce, Inc.",18250,0,0,0,0,0,0,0
Bard Valley Medjool Date Growers Association,19350,0,0,0,0,0,0,0
InteleTravel,18582,0,0,0,0,0,0,0
Hugh James Solicitors,18584,0,0,0,0,0,0,0
"P.C. Marys, Inc.",19552,0,0,0,0,0,0,0
Motor City Door Company,19367,0,0,0,0,0,0,0
The Open Championship,19369,0,0,0,0,0,0,0
"Telecom Lease Advisors, LLC.",19399,0,0,0,0,0,0,0
National Cash Advance,19401,0,0,0,0,0,0,0
Global Placements International,19567,0,0,0,0,0,0,0
Family Owned Markets,19450,0,0,0,0,0,0,0
Pennsylvania Ballet,19416,0,0,0,0,0,0,0
Ferran Services & Contracting,19633,0,0,1,1,0,0,1
HealthExperts.com,19752,0,0,0,0,0,0,0
New York City Health Department,19584,0,0,0,0,0,0,0
Coffin Movie,19701,0,0,0,0,0,0,0
"The Above Network, LLC.",19901,0,0,0,0,0,0,0
ZipDownloader.com,19903,0,1,0,1,0,1,0
online-fog.com,19767,0,0,0,0,0,0,0
"SnagAJob.com, Inc.",19769,3,0,0,3,1,0,0
mmoseek.com,19036,0,0,0,0,0,0,0
"Matrixx Initiatives, Inc.",18672,0,0,0,0,0,0,0
Northeast Credit Union,18811,0,0,0,0,0,0,0
Pegasus Airlines Inc.,18554,0,0,0,0,0,0,0
Harrison County Tourism Commission,18561,0,0,0,0,0,0,0
Greater New York Automobile Dealers Association,19179,0,0,0,0,0,0,0
The Patriot Health Institute,18568,1,1,0,2,0.5,0.5,0
Hockey Hall of Fame and Museum,18947,0,0,0,0,0,0,0
Baltimore Symphony Orchestra,18579,0,0,0,0,0,0,0
Arizona Department of Agriculture,19379,0,0,0,0,0,0,0
"Cree, Inc.",19365,0,0,0,0,0,0,0
Safecracker Movie,19490,0,0,0,0,0,0,0
Christian Aid,19397,0,0,0,0,0,0,0
"Centerline Homes, Inc.",19497,0,0,0,0,0,0,0
Regional Tourism Organization 12 (RTO12),19404,0,0,0,0,0,0,0
Unconditional Movie,19679,0,0,0,0,0,0,0
Shopcaster Inc.,19415,0,0,0,0,0,0,0
Employee Choice Coalition,19572,0,0,0,0,0,0,0
Butter Movie,19690,0,0,0,0,0,0,0
National Republican Congressional Committee,19579,0,0,0,0,0,0,0
balagana.net,19515,11,1,0,12,0.916666667,0.083333333,0
Northern Arizona University,19522,0,0,0,0,0,0,0
Gerber Gear,19847,0,0,0,0,0,0,0
FirstStepSolar.com,19790,3,0,0,3,1,0,0
EssentialVitality.org,19797,0,0,0,0,0,0,0
Peninsula Research Associates,19225,0,0,0,0,0,0,0
Station Casinos,19125,0,0,1,1,0,0,1
RV Care Network Canada,19126,0,0,0,0,0,0,0
brightsolid online publishing (UK) Inc,19140,0,0,0,0,0,0,0
"Event Farm, Inc.",18808,0,0,0,0,0,0,0
Lab Series,18539,1,0,0,1,1,0,0
"Galveston.com & Company, Inc",18540,0,0,0,0,0,0,0
Compass Contract Services Limited,19243,0,0,0,0,0,0,0
American Pawn and Gallery,18689,0,0,0,0,0,0,0
"Zuffa, LLC (UFC)",18690,2,0,0,2,1,0,0
Royal National Institute of Blind People,19326,0,0,0,0,0,0,0
smart-lifestyles.net,19175,1,0,0,1,1,0,0
Federal Student Aid,18558,3,0,0,3,1,0,0
ATAX,18940,0,0,0,0,0,0,0
GLOBAL BEAUTY INTERNATIONAL MANAGEMENT LTD,19343,0,0,0,0,0,0,0
Wilderness At The Smokies,18707,0,0,0,0,0,0,0
"New York Organ Donor Network, Inc.",19376,0,0,0,0,0,0,0
Completely You Blog,18258,0,0,0,0,0,0,0
Westfield Limited,19358,0,0,0,0,0,0,0
Coastal Luxury Management,19393,0,0,0,0,0,0,0
"Driscoll Strawberry Associates, Inc.",19493,0,0,0,0,0,0,0
"J.G. Wentworth, LLC",19494,0,0,0,0,0,0,0
Sons of Liberty Tees,19444,0,0,0,0,0,0,0
The Way Movie,19676,0,0,0,0,0,0,0
Froedtert Health,19408,0,0,0,0,0,0,0
Blue State Digital,19576,0,0,0,0,0,0,0
"Justin Alexander Bridal, Inc., LLC.",19643,2,0,0,2,1,0,0
Connecticut Department of Economic and Community Development,19644,0,0,0,0,0,0,0
Irving Oil Limited,19037,0,0,0,0,0,0,0
"The Drainman, Inc.",19039,0,0,0,0,0,0,0
Mondelez International,18803,0,0,3,3,0,0,1
Gold & Silver Buyers,18678,0,0,0,0,0,0,0
"SWH Mimi's Cafe, LLC",18680,0,0,1,1,0,0,1
"The Neat Company, Inc.",19239,0,0,0,0,0,0,0
"FilmDistrict Distribution, LLC",18812,0,0,0,0,0,0,0
iFOREX Brokerage Ltd.,19246,0,0,0,0,0,0,0
"Kerzner International Resorts, Inc.",18814,0,0,0,0,0,0,0
"Consumer Credit Counseling Service of Greater Atlanta, Inc.",19171,0,0,0,0,0,0,0
Indigo Books & Music Inc.,18242,0,0,0,0,0,0,0
The Foundation for Credit Counselling,18244,0,0,0,0,0,0,0
Nutmeg Saving and Investment Limited,19178,0,0,0,0,0,0,0
Kinky Boots LLC,19180,2,0,1,3,0.666666667,0,0.333333333
Paragon Hotels Limited,19080,0,0,0,0,0,0,0
The Medium Princess,18576,0,0,0,0,0,0,0
Breitling Royalties,19439,4,0,0,4,1,0,0
Beaumont Health System,19446,0,0,0,0,0,0,0
Trimble Navigation Limited,19407,0,0,0,0,0,0,0
Hellbound Movie,19680,0,0,0,0,0,0,0
Georgia Home Theater,19505,0,0,0,0,0,0,0
"American Federaton of State, County & Municipal Employees (AFSCME)",19573,0,0,0,0,0,0,0
Quick Cash Auto Inc.,19639,0,0,0,0,0,0,0
American Energy Alliance,19582,0,0,0,0,0,0,0
AboutAirportParking.com,19646,0,0,0,0,0,0,0
VOSS Water,19839,0,0,0,0,0,0,0
Anonymous Movie,19848,0,0,0,0,0,0,0
"Squidoo, LLC",17847,0,0,0,0,0,0,0
FireKeepers Casino Hotel,18447,1,0,0,1,1,0,0
PaymentSense,17779,0,0,0,0,0,0,0
Ordoro,17864,0,0,0,0,0,0,0
Life of Pi Movie,17715,0,0,0,0,0,0,0
ACE Home Services,19418,0,0,0,0,0,0,0
"SoKno Media, Inc.",18464,0,0,0,0,0,0,0
Rat Race (Events) Limited,17494,0,0,0,0,0,0,0
Iron Man 3 Movie,19656,0,0,0,0,0,0,0
Cbay Financial Services Limited,19457,2,0,0,2,1,0,0
KooKoo Bear Kids,18900,0,0,0,0,0,0,0
Financial Link Sdn. Bhd.,19463,0,0,0,0,0,0,0
Man Of Steel Movie,19917,0,0,0,0,0,0,0
American Museum of Natural History,19819,0,0,0,0,0,0,0
Graceland University,19663,0,0,0,0,0,0,0
Disconnect Movie,19668,0,0,0,0,0,0,0
Plarium,19908,10,0,0,10,1,0,0
Star Trek Into Darkness Movie,19670,0,0,0,0,0,0,0
At Properties,19913,0,0,0,0,0,0,0
"Slacker, Inc.",18332,0,0,0,0,0,0,0
Carena Medical Providers,19818,0,0,0,0,0,0,0
Illen Products Ltd.,18968,0,0,0,0,0,0,0
The Purge Movie,19918,0,0,0,0,0,0,0
The Big Wedding Movie,19659,0,0,0,0,0,0,0
"A Writers Cult, LLC",19664,0,0,0,0,0,0,0
Whiptail,19460,0,0,0,0,0,0,0
Trade of Innocents Movie,19671,0,0,0,0,0,0,0
Vax Ltd,18651,0,0,0,0,0,0,0
University of Hertfordshire,18767,0,0,0,0,0,0,0
Wreck-It Ralph Movie,19536,0,0,0,0,0,0,0
Abduction Movie,20036,0,0,0,0,0,0,0
First 4 Lawyers Limited,18768,0,0,0,0,0,0,0
"SunFoods, LLC",19587,0,0,0,0,0,0,0
Healthier Scotland - The Scottish Government,18917,0,0,0,0,0,0,0
Google Ad Services,20046,2,0,1,3,0.666666667,0,0.333333333
"Clique Media, Inc.",19602,1,0,0,1,1,0,0
Kevin Hart Let Me Explain Movie,20040,0,0,0,0,0,0,0
"Golfsmith International, Inc.",19551,16,0,2,18,0.888888889,0,0.111111111
GMC Dealerships,18770,6,0,0,6,1,0,0
First Trade Union Bank,19589,0,0,0,0,0,0,0
Connad.org,19542,0,0,0,0,0,0,0
appliedhealthstudies.com,18774,0,0,0,0,0,0,0
Attack The Block Movie,20101,0,0,0,0,0,0,0
Miracle Garcinia Cambogia,19458,0,0,0,0,0,0,0
Rural Economic Action Alliance,19595,0,0,0,0,0,0,0
Wastecorp,19468,0,0,0,0,0,0,0
Colombiana Movie,20102,0,0,0,0,0,0,0
GE Capital,19545,0,0,0,0,0,0,0
Lamb Handbags Ltd,18769,0,0,0,0,0,0,0
America's Health Insurance Plans,19538,0,0,0,0,0,0,0
Alvin and the Chipmunks Movie,19596,0,0,0,0,0,0,0
"Fiduciary Real Estate Development, Inc.",20170,0,0,0,0,0,0,0
LaFontaine Used Car King,20049,0,0,0,0,0,0,0
Become Pain Free,19591,0,0,0,0,0,0,0
Clean Energy Works,19539,0,0,0,0,0,0,0
Crescendo Movie,20099,0,0,0,0,0,0,0
Brave Movie,19598,0,0,0,0,0,0,0
MetroHartford Alliance,20171,0,0,0,0,0,0,0
NoThinkDiet.com,18771,0,0,0,0,0,0,0
Silver Legacy Resort & Casino,19606,0,0,0,0,0,0,0
Red Funnel,19609,0,0,0,0,0,0,0
A3D2 Ltd.,20368,0,0,0,0,0,0,0
"33 Broad Street Associates II, LLC",20177,0,0,0,0,0,0,0
VisitGuatemala,19604,2,0,0,2,1,0,0
Chaddsford Winery,20174,0,0,0,0,0,0,0
The Baillie Gifford Group,20178,0,0,0,0,0,0,0
Frances Ha Movie,20050,0,0,0,0,0,0,0
Apartments24-7.com,20172,0,0,0,0,0,0,0
Urbilis,20310,0,0,0,0,0,0,0
American Beverage Corporation,19543,0,0,0,0,0,0,0
Belly Buds LLC,20317,0,0,0,0,0,0,0
Call Connection Limited,20367,0,0,0,0,0,0,0
The SBM Group,19599,0,0,0,0,0,0,0
PropTiger,20369,0,0,0,0,0,0,0
Organization of Teratology Information Specialists,20315,0,0,0,0,0,0,0
Tiger Tool International Incorporated,20366,0,0,0,0,0,0,0
Ava Financial Ltd.,19607,0,0,0,0,0,0,0
Spiritual Knowledge LLC,19611,0,0,0,0,0,0,0
Nancys Notions,20318,0,0,0,0,0,0,0
"Cracker Barrel Old Country Store, Inc.",20311,0,0,0,0,0,0,0
"Bloomingdale's, Inc.",20312,30,7,3,40,0.75,0.175,0.075
Landmark Wine,19655,0,0,0,0,0,0,0
"MidTen Media, Inc.",19657,1,0,0,1,1,0,0
Blue Buffalo Company,19455,1,0,0,1,1,0,0
Port Aransas Chamber of Commerce and Tourist Bureau,19462,0,0,0,0,0,0,0
Tripcentral.ca,19464,0,0,0,0,0,0,0
CompareNow,19821,0,0,0,0,0,0,0
Sound City Movie,20098,0,0,0,0,0,0,0
Janie Jones Movie,20100,0,0,0,0,0,0,0
Graceland Fairlawn Funeral Home,19662,0,0,0,0,0,0,0
Hatchet3 Movie,20180,0,0,0,0,0,0,0
femMED Formulas,19454,0,0,0,0,0,0,0
"CARite, Inc.",19822,0,0,0,0,0,0,0
Epic Movie,19672,0,0,0,0,0,0,0
"MyGofer, LLC",19540,0,0,0,0,0,0,0
Branded Movie,20097,0,0,0,0,0,0,0
Laurence Anyways Movie,20183,0,0,0,0,0,0,0
"Circuit Of The Americas, LLC",19906,0,0,0,0,0,0,0
State of California,19456,0,0,0,0,0,0,0
Royal FrieslandCampina N.V.,19588,0,0,0,0,0,0,0
Vehicle 19 Movie,20181,0,0,0,0,0,0,0
"Tealium, Inc.",19816,7,0,0,7,1,0,0
Cochlear Americas,19907,0,0,0,0,0,0,0
SafeMonitor,19914,2,0,0,2,1,0,0
The Hunger Games Catching Fire Movie,19916,0,0,6,6,0,0,1
Nature's Way,19537,0,0,0,0,0,0,0
Source Code Movie,20039,0,0,0,0,0,0,0
"Granite City Food & Brewery, Ltd.",20048,0,0,0,0,0,0,0
The Lakes at Waterford,20173,0,0,0,0,0,0,0
TLC Dental of Medford,20175,0,0,0,0,0,0,0
The Conjuring Movie,20307,0,0,0,0,0,0,0
42 Movie,19660,0,0,0,0,0,0,0
Master’s Transportation,19459,0,0,0,0,0,0,0
University of Kansas Cancer Center,19909,0,0,0,0,0,0,0
No One Lives Movie,19910,0,0,0,0,0,0,0
"PAPYLESS Co., Ltd.",18773,1,0,0,1,1,0,0
1099Careers LLC,19592,0,0,0,0,0,0,0
Adventure Center (First Choice) Inc.,19610,0,0,0,0,0,0,0
The Echo and Echoplex,20313,0,0,0,0,0,0,0
EMI Limited,19820,0,0,0,0,0,0,0
Owners Direct Holiday Rentals Ltd,19535,0,0,0,0,0,0,0
BP Lubricants USA Inc.,19586,0,0,1,1,0,0,1
"Chicago.com, Inc.",19469,5,0,2,7,0.714285714,0,0.285714286
DigiMogul LLC,19601,0,0,0,0,0,0,0
"Prudential Financial, Inc.",19603,0,0,14,14,0,0,1
Cuties Clementine Cooperative,19654,0,0,0,0,0,0,0
Pain And Gain Movie,19658,0,0,0,0,0,0,0
Paragon Micro,19815,0,0,0,0,0,0,0
Better Ride Mountain Bike Skills Coaching,19465,1,0,0,1,1,0,0
"BUDK Worldwide, Inc.",18772,0,0,0,0,0,0,0
Avengers Movie,19597,0,0,0,0,0,0,0
The Cosmetic Medic,20176,0,0,0,0,0,0,0
R.I.P.D. Movie,20308,0,0,0,0,0,0,0
Helmsley Hotels,18883,0,0,0,0,0,0,0
Mind Candy Ltd.,18983,0,0,0,0,0,0,0
Hyde Park On Hudson Movie,18364,0,0,0,0,0,0,0
"Aztec Bolting Services, Inc.",19273,0,0,0,0,0,0,0
Texas Oncology,18598,0,0,0,0,0,0,0
Mental Movie,19716,0,0,0,0,0,0,0
"Scrubs AC, Inc.",19278,0,0,0,0,0,0,0
"Home Run Inn, Inc.",19709,0,0,0,0,0,0,0
Larry Flynt's World Famous Hustler Club,17547,0,0,0,0,0,0,0
RedBubble Pty. Ltd.,19279,0,0,0,0,0,0,0
Partners Trust Real Estate,19274,0,0,0,0,0,0,0
"K. Hovnanian Companies, LLC.",19710,0,0,0,0,0,0,0
KPMG Law LLP,19282,0,0,0,0,0,0,0
"SpaFinder Wellness, Inc.",19277,0,0,0,0,0,0,0
"Corinthian Colleges, Inc.",19281,0,0,0,0,0,0,0
"NetBase Solutions, Inc.",18715,0,0,1,1,0,0,1
First State Bank,19420,0,0,0,0,0,0,0
Robert D. Clements and Associates,18600,0,0,0,0,0,0,0
Boston Interiors,19422,0,0,0,0,0,0,0
"Greenland Travel, A/S",18530,0,0,0,0,0,0,0
Disney Interactive,18381,11,0,9,20,0.55,0,0.45
Society for the Performing Arts,19002,0,0,0,0,0,0,0
"Goddard Systems, Inc.",19085,2,0,3,5,0.4,0,0.6
"Elements Therapeutic Massage, Inc.",19034,0,0,1,1,0,0,1
"Rescue Mission Alliance, Inc.",19219,0,0,0,0,0,0,0
Kacper Postawski Companies,19283,0,1,0,1,0,1,0
Nominet UK,19115,0,0,0,0,0,0,0
Inappropriate Comedy Movie,19485,0,0,0,0,0,0,0
Slater's 50/50,18664,0,0,0,0,0,0,0
Neptune Society,18798,0,0,0,0,0,0,0
Mercy Fitzgerald Hospital in Darby,18800,0,0,1,1,0,0,1
"Tidebuy.com, Limited",18534,0,0,0,0,0,0,0
Colorado Mountain College,18232,0,0,0,0,0,0,0
"Credit Karma, Inc.",19236,0,0,0,0,0,0,0
Sacramento State - College of Business Administration,19295,0,0,0,0,0,0,0
Pennsylvania Liquor Control Board,19931,0,0,0,0,0,0,0
Temptation Movie,19481,0,0,0,0,0,0,0
BELLYFATDIETEASY,20324,0,0,0,0,0,0,0
Hick Movie,19703,0,0,0,0,0,0,0
"Mami Nutraceuticals, LLC",19951,0,0,0,0,0,0,0
Fruitvale Station Movie,20436,0,0,0,0,0,0,0
Radyoos Media Ltd.,19427,0,0,0,0,0,0,0
"BeyondTrust Software, Inc.",19291,0,0,0,0,0,0,0
Respect for Marriage Coalition,19423,0,0,0,0,0,0,0
Dean & DeLuca,19428,0,0,0,0,0,0,0
"Guaranteed Rate, Inc.",19309,0,0,0,0,0,0,0
UN Refugee Agency,19289,0,0,0,0,0,0,0
Viacom,19721,0,0,0,0,0,0,0
Great American Country,20495,0,0,0,0,0,0,0
Scorpion King Movie,19712,0,0,0,0,0,0,0
Cub Cadet,19303,0,0,0,0,0,0,0
TV Land,19723,0,0,0,0,0,0,0
Catholic Charities USA,19275,0,0,0,0,0,0,0
Don't Be Afraid Of The Dark Movie,19718,0,0,0,0,0,0,0
Megaplex Theatres,20326,0,0,0,0,0,0,0
Margin Call Movie,19717,0,0,0,0,0,0,0
A Resurrection Movie,19292,0,0,0,0,0,0,0
Harvey Water Softeners Ltd.,19285,0,0,0,0,0,0,0
Racing-Games.Com,20210,1,0,0,1,1,0,0
Barisan Nasional,19925,0,0,0,0,0,0,0
Western Pest Services,19948,0,0,0,0,0,0,0
Memphis Convention & Visitors Bureau,19924,0,0,0,0,0,0,0
Jacobs Music,20345,0,0,0,0,0,0,0
Bosch Rexroth AG,20438,0,0,0,0,0,0,0
Pittsburgh Home & Garden Show,19305,0,0,0,0,0,0,0
Green Smoke Inc.,19298,6,1,0,7,0.857142857,0.142857143,0
TheCleverOwl.com,20202,4,0,2,6,0.666666667,0,0.333333333
itsyoursexlife.com,19724,1,0,0,1,1,0,0
Suntory Holdings Limited,20189,1,0,2,3,0.333333333,0,0.666666667
"Yammer, Inc.",20213,0,0,0,0,0,0,0
Upside Down Movie,19483,0,0,0,0,0,0,0
Terri Movie,20109,0,0,0,0,0,0,0
Ezell's Famous Chicken,20127,0,0,0,0,0,0,0
Newland Communities,19476,0,0,0,0,0,0,0
Naterra International Inc.,19956,0,0,0,0,0,0,0
CBS Films,19938,0,0,0,0,0,0,0
Bridge & Wickers World of Travel Ltd,19732,0,0,0,0,0,0,0
uk.findyourdegree.org,19312,0,0,0,0,0,0,0
"Daniel DeCaro Real Estate Auctions, Inc.",19927,0,0,0,0,0,0,0
New York Digital Media,19738,0,0,0,0,0,0,0
patriotsurvivalplan.com,19977,0,0,3,3,0,0,1
Insidious Movie,20106,0,0,0,0,0,0,0
COALITION FOR RESPONSIBLE GAMING EXPANSION,19968,0,0,0,0,0,0,0
George Brazil Home Services,20117,0,0,0,0,0,0,0
Liz Earle Beauty Co. Ltd,19748,0,0,0,0,0,0,0
Veeam Software,20432,0,0,0,0,0,0,0
"World Kitchen, LLC",20207,0,0,0,0,0,0,0
"Sigma Mechanical Services, LLC",20121,0,0,0,0,0,0,0
athinline.org,19725,0,0,0,0,0,0,0
International Dairy Queen,20463,0,0,0,0,0,0,0
Patriot Privacy,20509,1,0,0,1,1,0,0
Consorzio Vino Chianti Classico,20321,0,0,0,0,0,0,0
Vein Center of Lake Norman,20329,0,0,0,0,0,0,0
Best Buddies International,20228,0,0,0,0,0,0,0
The Gamer Stop,19940,0,0,0,0,0,0,0
Malaysia Kitchen NYC,19284,0,0,0,0,0,0,0
"CPC Marketing, LLC",20449,0,0,0,0,0,0,0
Iron Mountain Incorporated,20198,0,0,0,0,0,0,0
Nancys Gone Green,20320,0,0,0,0,0,0,0
The Sanctuary of Lake Villa,20331,0,0,0,0,0,0,0
AceTiger,20363,0,0,0,0,0,0,0
Buffalo International,20194,0,0,0,0,0,0,0
Democrats.com,20516,0,0,0,0,0,0,0
All Market inc.,19935,0,0,0,0,0,0,0
convertvideosfree.com,20217,10,0,0,10,1,0,0
"Town Residential, LLC",19928,0,0,0,0,0,0,0
"Best Buy Co., Inc.",20188,161,34,24,219,0.735159817,0.155251142,0.109589041
Before Midnight Movie,19947,0,0,0,0,0,0,0
National Peanut Board,19936,0,0,0,0,0,0,0
Nozee Limited,20506,0,0,0,0,0,0,0
University of Colorado Hospital,19740,0,0,0,0,0,0,0
Vueling Airlines SA,19955,0,0,0,0,0,0,0
Société des Produits MARNIER-LAPOSTOLLE,20477,10,11,0,21,0.476190476,0.523809524,0
Ultra Sabers LLC,19311,0,0,0,0,0,0,0
San Jacinto College,19300,0,0,0,0,0,0,0
Mikado Sushi Bar,20337,0,0,0,0,0,0,0
Monster Energy Company,20451,0,0,0,0,0,0,0
Kemper Development Company,20328,0,0,0,0,0,0,0
TFS Stores Limited,20517,0,0,0,0,0,0,0
Balenciaga Fragrance,20455,0,0,0,0,0,0,0
Straw Dogs Movie,20113,0,0,0,0,0,0,0
The Wolverine Movie,20122,0,0,0,0,0,0,0
"Lumaris, F.Z.E.",20521,0,0,0,0,0,0,0
20jeans.com,19960,0,0,0,0,0,0,0
CFA Institute,19957,0,0,0,0,0,0,0
Grace Unplugged Movie,20687,0,0,0,0,0,0,0
The Student World,20346,0,0,0,0,0,0,0
"Smart Destinations, Inc.",19966,0,0,0,0,0,0,0
Sees Candies,20460,0,0,0,0,0,0,0
"Promeritum, LLC",19962,15,0,1,16,0.9375,0,0.0625
Costa Crociere S.p.A.,20564,0,0,0,0,0,0,0
Wasabi Frog Limited,20568,0,0,0,0,0,0,0
St. Jacobs Furnishings,20347,0,0,0,0,0,0,0
"Apptix, Inc.",19992,0,0,0,0,0,0,0
Lamborghini Dealerships,20684,0,0,0,0,0,0,0
RC Willey Home Furnishings,20470,0,0,0,0,0,0,0
Thompson Place Productions Limited,19983,0,0,0,0,0,0,0
Simpson Property Group,19302,0,0,0,0,0,0,0
"Pure Storage, Inc.",19306,0,0,0,0,0,0,0
"FIN Branding Group, LLC.",20546,0,0,0,0,0,0,0
"Stila Styles, LLC",19971,0,0,0,0,0,0,0
Thunderstruck Movie,19953,0,0,0,0,0,0,0
Enumclaw Insurance Group,20442,0,0,0,0,0,0,0
The Macallan Distillers Limited,20481,0,0,0,0,0,0,0
Winnie The Pooh Movie,20150,0,0,0,0,0,0,0
UndergroundAssaultRifle,20204,0,2,0,2,0,1,0
"Pop Hang, LLC",20513,47,1,6,54,0.87037037,0.018518519,0.111111111
A Nelson and Co Ltd.,20704,0,0,0,0,0,0,0
Tiger Woods Foundation,20352,0,0,0,0,0,0,0
Aurora Health Care,20223,0,0,0,0,0,0,0
The Muppets Movie,20155,0,0,0,0,0,0,0
CONCACAF,19967,0,0,0,0,0,0,0
Ignite Restaurant Group,20222,1,0,0,1,1,0,0
National Gaucher Foundation,19313,0,0,0,0,0,0,0
Alamo District,20514,0,0,0,0,0,0,0
The Grommet,20520,9,0,0,9,1,0,0
Pippin The Musical,20227,0,0,0,0,0,0,0
"California Voices, LLC",20119,0,0,0,0,0,0,0
Campaign for Innovation,20510,1,0,0,1,1,0,0
American Committee for the Weizmann Institute of Science,20500,0,0,0,0,0,0,0
Vauxhall Motors (GM UK Limited),20550,0,0,0,0,0,0,0
The Spectacular Now Movie,20553,0,0,0,0,0,0,0
Despicable Me 2 Movie,20142,0,0,0,0,0,0,0
World War Z Movie,20137,0,0,0,0,0,0,0
Marshall Services Inc.,20349,0,0,0,0,0,0,0
O'Malley's Liquor Kitchen,20796,0,0,0,0,0,0,0
Bridgeport Sound Tigers,20358,0,0,0,0,0,0,0
The Woman Movie,20132,0,0,0,0,0,0,0
Community Merchants USA,20504,0,0,1,1,0,0,1
Keeny & Basford P.A. Funeral Home,20168,0,0,0,0,0,0,0
"Surya, Inc.",20692,0,0,0,0,0,0,0
William Hill,20699,0,0,0,0,0,0,0
"Thor Entertainment Group, LLC",20502,3,0,0,3,1,0,0
Kick Ass 2 Movie,20489,0,0,0,0,0,0,0
"Burt's Bees, Inc.",20453,0,0,0,0,0,0,0
August Storck KG,20482,8,0,3,11,0.727272727,0,0.272727273
"Energizer Holdings, Inc.",20125,2,0,7,9,0.222222222,0,0.777777778
"Uniqlo Co., LTD",20225,0,0,1,1,0,0,1
Sirona Dental GmbH,20131,0,0,0,0,0,0,0
100 Layer Cake,20694,0,0,0,0,0,0,0
Oriental Trading Company,20459,0,0,0,0,0,0,0
"Asure Software, Inc.",19988,0,0,0,0,0,0,0
A1 Travel Deals LTD,19981,0,0,0,0,0,0,0
Travel Channel,20485,0,0,0,0,0,0,0
"Primal Health, LP",20219,13,0,2,15,0.866666667,0,0.133333333
NEST Fragrances,20685,1,0,0,1,1,0,0
The Trouble With Bliss Movie,20134,0,0,0,0,0,0,0
"Body Central Direct, Inc.",20904,0,0,0,0,0,0,0
The Grandmaster Movie,20492,0,0,0,0,0,0,0
Business Wire,20468,0,0,0,0,0,0,0
America's Tire,20903,0,0,0,0,0,0,0
Towson University Athletics,20360,0,0,0,0,0,0,0
Detroit Tigers,20357,0,0,0,0,0,0,0
"Texas Power, LP",20528,0,0,0,0,0,0,0
"Iconology, Inc.",20525,0,0,0,0,0,0,0
Totem Entertainment,20540,0,0,0,0,0,0,0
Frozen Ropes Tigers Baseball,20359,0,0,0,0,0,0,0
Outside the Box Boston,20512,0,0,0,0,0,0,0
Zip Opener,19989,7,0,0,7,1,0,0
Strutta.com Media Inc.,20519,0,0,0,0,0,0,0
eCommerce Outdoors,20356,0,0,0,0,0,0,0
Jenn-Air,20534,2,0,0,2,1,0,0
"Impact Confections, Inc.",20558,0,0,0,0,0,0,0
Live Well Brands,19976,0,0,0,0,0,0,0
Facebook,19998,5,1,0,6,0.833333333,0.166666667,0
Tiger Airways,20355,0,0,0,0,0,0,0
NOLA Media Group,20524,0,0,0,0,0,0,0
Shaw Industries,20462,0,0,0,0,0,0,0
Clayton Homes,20467,0,0,0,0,0,0,0
Wisconsin National Guard,20794,0,0,0,0,0,0,0
"Natural Balance Pet Foods, Inc.",20531,0,0,0,0,0,0,0
Leman Manhattan Preparatory School,20364,0,0,0,0,0,0,0
Break The Floor Productions,20235,0,0,0,0,0,0,0
Paranoia Movie,20490,0,0,0,0,0,0,0
BoatUS,20471,0,0,0,0,0,0,0
Stremor,20232,0,0,0,0,0,0,0
Judd & Black,20702,18,0,0,18,1,0,0
"Pacific and Southern Company, Inc.",20159,0,0,0,0,0,0,0
Sterling Autobody Inc.,19987,0,0,0,0,0,0,0
Garden Protein International Inc,20234,0,0,0,0,0,0,0
The Bling Ring Movie,20138,0,0,0,0,0,0,0
The Bahamas Ministry of Tourism,20231,0,0,0,0,0,0,0
"CA Acquisition LLC, Inc.",20693,0,0,0,0,0,0,0
Miniclip SA,20229,0,0,0,0,0,0,0
University of Lincoln,20164,0,0,0,0,0,0,0
Funky Baja's Cantina,20793,0,0,0,0,0,0,0
Service King Collision Repair Centers,20535,5,1,1,7,0.714285714,0.142857143,0.142857143
Liquor.com,20801,0,0,0,0,0,0,0
The Majestic Star Casino LLC,20696,0,0,0,0,0,0,0
The Best Man Holiday Movie,21119,0,0,0,0,0,0,0
Wolford Group,20166,0,0,0,0,0,0,0
Scion Dealerships,20160,6,0,1,7,0.857142857,0,0.142857143
PurePlay.com,20237,0,0,0,0,0,0,0
The Heat Movie,20236,0,0,0,0,0,0,0
Optimal Fusion,20700,0,0,0,0,0,0,0
H.H. Brown Shoe Group,20472,0,0,0,0,0,0,0
"Wanderlust Festival, LLC",20554,0,0,0,0,0,0,0
La Crema Winery,20230,0,0,0,0,0,0,0
Food Network,20486,2,0,1,3,0.666666667,0,0.333333333
Pocketwatch Games,20805,0,0,0,0,0,0,0
Tilted Kilt Pub,20795,0,0,0,0,0,0,0
Riddick Movie,20493,0,0,0,0,0,0,0
POLMOS ZYRARDOW LLC,19999,0,0,0,0,0,0,0
Star Wars Movie,20557,0,0,0,0,0,0,0
SpinMedia,20362,0,0,0,0,0,0,0
The Lone Ranger Movie,20143,0,0,0,0,0,0,0
"Monsters, Inc. 3D Movie",20153,0,0,0,0,0,0,0
I Give It A Year Movie,20491,0,0,0,0,0,0,0
Home Run Movie,20555,0,0,0,0,0,0,0
Cadillac,20547,120,3,32,155,0.774193548,0.019354839,0.206451613
Indiana Lottery,20804,0,0,0,0,0,0,0
Breckenridge Brewery,20479,0,0,0,0,0,0,0
stream-directmovies.com,21121,0,0,0,0,0,0,0
Margaritaville Brewing Co.,20480,0,0,0,0,0,0,0
Disney Channel,20149,2,0,6,8,0.25,0,0.75
Romantix,20797,0,0,0,0,0,0,0
Instructions Not Included Movie,21116,0,0,0,0,0,0,0
GMC,20549,50,2,25,77,0.649350649,0.025974026,0.324675325
"Dering Hall, LLC",20560,0,0,1,1,0,0,1
El Chupacabra,20799,0,0,0,0,0,0,0
NetoTrade global investment LTD,19477,0,0,0,0,0,0,0
Acaté Amazon Conservation,19478,0,0,0,0,0,0,0
Beringer Vineyard,20327,0,0,0,0,0,0,0
The Company You Keep Movie,19946,0,0,0,0,0,0,0
ooopsvideo.com,20195,29,2,4,35,0.828571429,0.057142857,0.114285714
Bellco Credit Union,19742,1,0,0,1,1,0,0
Rio Movie,20110,0,0,0,0,0,0,0
DressFirst.com,19745,0,0,0,0,0,0,0
Lotus Dealerships,19310,0,0,1,1,0,0,1
Top TV Stuff,19959,0,0,0,0,0,0,0
RainForest Action Network,20496,0,0,0,0,0,0,0
YOTEL Limited,19963,0,0,0,0,0,0,0
We're The Millers Movie,20445,0,0,0,0,0,0,0
Percy Jackson Sea of Monsters Movie,20446,0,0,0,0,0,0,0
Jack Pirtle’s Chicken,20128,0,0,0,0,0,0,0
"PL Studios, Inc.",19978,0,0,0,0,0,0,0
NetJets,20464,2,0,1,3,0.666666667,0,0.333333333
The Internship Movie,19995,0,0,0,0,0,0,0
Getit Infoservices Pvt. Ltd.,19996,0,0,0,0,0,0,0
BearShare,20545,3,0,0,3,1,0,0
Busters Liquors,20478,0,0,0,0,0,0,0
Lincoln Property Company,20163,0,0,0,0,0,0,0
The Grid Chicago,19421,0,0,0,0,0,0,0
Carl's Air Conditioning & Sheet Metal Inc,19287,0,0,0,0,0,0,0
"RateMyProfessors.com, LLC",19930,0,0,0,0,0,0,0
Skyline Developers,19296,3,0,0,3,1,0,0
New England College of Business and Finance,19730,13,1,0,14,0.928571429,0.071428571,0
Monticello Wayne County Chamber of Commerce,20332,0,0,0,0,0,0,0
Golden Flake Snack Foods Inc.,20334,0,0,0,0,0,0,0
unipdfconverter.com,20200,3,0,1,4,0.75,0,0.25
"Society6, LLC",20498,2,0,0,2,1,0,0
Specialty Food Association,19964,0,0,0,0,0,0,0
WinTech LLC,20123,0,0,0,0,0,0,0
Fill The Void Movie,20523,0,0,0,0,0,0,0
Michigan State University,20527,3,0,0,3,1,0,0
CORT Business Services,20466,15,2,1,18,0.833333333,0.111111111,0.055555556
TLC Laser Eye Centers Inc.,19991,0,0,0,0,0,0,0
Martha White Foods Incorporated,20691,6,0,10,16,0.375,0,0.625
Planes Movie (Disney),20559,42,0,5,47,0.893617021,0,0.106382979
PFC Fitness.,20900,7,0,0,7,1,0,0
"Brookfield Residential Southland, Inc.",20902,0,0,1,1,0,0,1
Beach Girls Club,20802,0,0,0,0,0,0,0
Second Chance Trust Fund,19272,0,0,0,0,0,0,0
Garnier,19472,0,0,2,2,0,0,1
The Paperboy Movie,19715,0,0,0,0,0,0,0
Medical Weight Loss Clinic,19479,0,0,0,0,0,0,0
"Premier Lighting, LLC",19922,0,0,0,0,0,0,0
Logo TV,19722,0,0,1,1,0,0,1
Zico,19733,1,0,0,1,1,0,0
StorageMart,20433,0,0,0,0,0,0,0
America's Voice,20333,0,0,0,0,0,0,0
Girl Most Likely Movie,20440,0,0,0,0,0,0,0
"Dealer Tire, LLC.",19958,0,0,0,0,0,0,0
Arizona Commerce Authority,20201,0,0,0,0,0,0,0
Pretty Maids,20115,0,0,0,0,0,0,0
"Adchemy, Inc.",20501,0,0,0,0,0,0,0
Zalora,19972,0,0,0,0,0,0,0
"PLAOR, LLC",20351,0,0,0,0,0,0,0
Democratic Legislative Campaign Committee,20515,0,0,0,0,0,0,0
Borsheims Fine Jewelry,20458,0,0,0,0,0,0,0
Boblr,20133,0,0,0,0,0,0,0
Brooks Sports,20465,2,0,0,2,1,0,0
White House Down Movie,20140,0,0,0,0,0,0,0
BIN Insurance Holdings LLC,20533,0,0,0,0,0,0,0
"Smithfield Foods, Inc.",20147,0,0,0,0,0,0,0
Gilardi & Co. LLC,20158,0,0,0,0,0,0,0
Welcome to the Punch Movie,20483,0,0,0,0,0,0,0
Our Jeweler Bedford,20165,0,0,0,0,0,0,0
Scary Movie 5 Movie,19661,0,0,0,0,0,0,0
Mary's Media Foundation,19461,0,0,1,1,0,0,1
Trespass Movie,19911,0,0,0,0,0,0,0
"Triad Digital Media, LLC",19912,0,0,0,0,0,0,0
Lutsen Mountains,19593,0,0,0,0,0,0,0
Corning Incorporated,19594,0,0,0,0,0,0,0
"Charming Direct, Inc.",18775,6,0,0,6,1,0,0
Jenkins Clinic,19544,0,0,0,0,0,0,0
RenatoTurano.com,18776,0,0,0,0,0,0,0
Sugartown Worldwide LLC,19608,0,0,0,0,0,0,0
"Rearden Commerce, Inc.",19711,0,0,0,0,0,0,0
Salem State University,19276,0,0,0,0,0,0,0
Pike Place Market PDA,19929,0,0,0,0,0,0,0
Tourism Toronto,20193,0,0,0,0,0,0,0
Banff Lake Louise Tourism,20330,0,0,0,0,0,0,0
King Naresuan Movie,20111,0,0,0,0,0,0,0
Duodecad IT Services Luxembourg S.à.r.l.,20497,1,0,1,2,0.5,0,0.5
The World's End Movie,20447,0,0,0,0,0,0,0
Jacobs Engineering Group Inc.,20344,0,0,0,0,0,0,0
"The Senators (Ret.) Firm, LLP",20212,0,0,0,0,0,0,0
"Aspen Chamber Resort Association, Inc.",20561,0,0,0,0,0,0,0
CheckPeople.com,20511,1,0,0,1,1,0,0
Browns Chicken,20130,0,0,0,0,0,0,0
Bulmers Ltd.,19979,0,0,0,0,0,0,0
Consumers Guides,20530,8,0,0,8,1,0,0
National Brain Tumor Society,19994,0,0,0,0,0,0,0
X Men First Class Movie,20698,0,0,0,0,0,0,0
Medical Teams International,20162,0,0,0,0,0,0,0
Don's Appliances,19805,0,0,0,0,0,0,0
DSYR Sdn Bhd,19905,0,0,0,0,0,0,0
National Security Agency,19541,0,0,0,0,0,0,0
Solar America,19605,0,0,0,0,0,0,0
I'm So Excited Movie,20182,0,0,0,0,0,0,0
"The Way, Way Back Movie",20184,0,0,0,0,0,0,0
"Bloomington Brands, LLC.",20309,0,0,0,0,0,0,0
"Morris Enterprises, Inc.",20316,0,0,0,0,0,0,0
At Any Price Movie,19707,0,0,0,0,0,0,0
Las Vegas Metro Chamber of Commerce,19471,0,0,0,0,0,0,0
Cheap Ticket,19280,0,0,0,0,0,0,0
Salmon Fishing in the Yemen Movie,19939,0,0,0,0,0,0,0
"Delhaize America, Inc.",19941,0,0,0,0,0,0,0
Unpakt LLC,19739,0,0,0,0,0,0,0
"Two Men And A Truck International, Inc.",19741,0,0,0,0,0,0,0
JUCY Group Limited,19307,0,0,0,0,0,0,0
Playtech Software,20443,0,0,1,1,0,0,1
Jacobs Upholstery and Patio,20341,0,0,0,0,0,0,0
"Hisamitsu Pharmaceutical Co., Inc.",20209,6,0,0,6,1,0,0
International Medical University (IMU),19973,0,0,0,0,0,0,0
The Committee to Elect Nancy Jacobs,20348,0,0,0,0,0,0,0
Arla Foods Inc,19975,0,0,0,0,0,0,0
Goody Goody Liquors,20682,0,0,0,0,0,0,0
"CrowdGather, Inc.",20518,0,0,0,0,0,0,0
"ECCO USA, Inc.",19980,2,0,2,4,0.5,0,0.5
Momentum Entertainment Group,19982,0,0,0,0,0,0,0
Monsters University Movie,20139,0,0,0,0,0,0,0
Aftershock Movie,20141,14,2,0,16,0.875,0.125,0
Nebraska Furniture Mart,20473,0,0,0,0,0,0,0
TTI Inc,20475,0,0,0,0,0,0,0
Dean House plc,20543,0,0,0,0,0,0,0
The Unique You Store,19452,0,0,0,0,0,0,0
Not Today Movie,19669,0,0,0,0,0,0,0
Monster Mass,19267,0,0,0,0,0,0,0
The Last Stand Movie,20037,0,0,0,0,0,0,0
Zookeeper Movie,20103,0,0,0,0,0,0,0
Desert Inn Women's Care Center,19269,0,0,0,0,0,0,0
North America Travel Service,19286,0,0,0,0,0,0,0
Jessica Dorfman Jones,19484,0,0,0,0,0,0,0
Olympus Has Fallen Movie,19486,0,0,0,0,0,0,0
Grown Ups 2 Movie,20186,0,0,0,0,0,0,0
Groupe Danone,19937,0,0,0,0,0,0,0
moneyExpert Limited,19301,0,0,0,0,0,0,0
What's Your Number Movie,20105,0,0,0,0,0,0,0
Stautzenberger Institute,20439,0,0,0,0,0,0,0
The Government of Canada,20203,0,0,0,0,0,0,0
Jeffrey Freedman Attorneys PLLC,20205,1,0,0,1,1,0,0
TAW Global LLC,20118,0,0,0,0,0,0,0
Cover Oregon,20503,3,1,1,5,0.6,0.2,0.2
Ultimate Gaming,20505,0,0,0,0,0,0,0
"Taylor Nation, LLC",20454,0,0,0,0,0,0,0
Kai Fragrance,20456,0,0,0,0,0,0,0
Freedom Furniture and Electronics,20571,0,0,0,0,0,0,0
ETW Corp.,20354,0,0,0,0,0,0,0
Enough Said Movie,20686,0,0,0,0,0,0,0
Alabama Media Group,19984,0,0,0,0,0,0,0
Tesoro Corporation,20135,0,0,0,0,0,0,0
Eutelsat S.A.,19986,0,0,0,0,0,0,0
Runner Runner Movie,20688,0,0,0,0,0,0,0
McLane Company,20469,0,0,0,0,0,0,0
The Absolut Company AB,20001,9,2,3,14,0.642857143,0.142857143,0.214285714
"Pur Minerals, Inc.",20371,0,0,0,0,0,0,0
Finding Nemo 3D Movie,20152,0,0,0,0,0,0,0
The Secret World of Arrietty Movie,20154,0,0,0,0,0,0,0
Sparkford Sawmills,20169,0,0,0,0,0,0,0
videocollection.com,21122,0,0,0,0,0,0,0
"Cove Financial Group, Inc.",19270,0,0,0,0,0,0,0
Perfect Sense Movie,19706,0,0,0,0,0,0,0
Digital Store LLC,19713,0,0,0,0,0,0,0
"Forward Management, LLC",19474,1,0,0,1,1,0,0
Standard Life Assurance Limited,19424,0,0,0,0,0,0,0
Long Island Auto Find Inc.,19288,0,0,0,0,0,0,0
teenageadhdstudy.com,19942,0,0,0,0,0,0,0
2 Guns Movie,20431,2,0,7,9,0.222222222,0,0.777777778
American Egg Board,20192,0,0,0,0,0,0,0
"Long Mile Solutions, LLC",20199,1,0,0,1,1,0,0
"Cozi, Inc.",20499,0,0,1,1,0,0,1
"Jacobsen Oriental Rugs, Inc.",20342,0,0,0,0,0,0,0
The One Fund Boston,19974,0,0,0,0,0,0,0
Venus Factor,20567,23,1,0,24,0.958333333,0.041666667,0
mediaconverterforwindows.com,20224,1,0,0,1,1,0,0
Medical Protective,20474,0,0,0,0,0,0,0
Funding Circle Limited,20542,0,0,0,0,0,0,0
Cars 2 Movie,20156,0,0,0,0,0,0,0
GREATAPPSDOWNLOAD.COM,20899,12,1,6,19,0.631578947,0.052631579,0.315789474
CN Creative,19271,0,0,0,0,0,0,0
The Darkest Hour Movie,19705,0,0,0,0,0,0,0
"Liberty Safe and Security Products, Inc.",19473,0,0,0,0,0,0,0
In Time Movie,19714,0,0,0,0,0,0,0
Belron UK Limited,19480,0,0,0,0,0,0,0
Jurassic Park 3D Movie,19482,0,0,0,0,0,0,0
Insidious Chapter 2 Movie,20107,0,0,0,0,0,0,0
Charter Communications,19950,1,0,0,1,1,0,0
SalemOffers.com,19746,0,0,2,2,0,0,1
The To Do List Movie,20441,0,0,0,0,0,0,0
180 Movie,20114,0,0,0,0,0,0,0
Pontiac Dealerships,20116,0,0,0,0,0,0,0
St. Jacobs Country,20343,0,0,0,0,0,0,0
"Honest Tea, Inc.",20450,0,0,0,0,0,0,0
Markel Corporation,20214,0,0,1,1,0,0,1
BerryBenka.com,20216,0,0,0,0,0,0,0
Young Hollywood Network,20350,0,0,0,0,0,0,0
"Oliver Manufacturing CO, Inc.",20541,0,0,0,0,0,0,0
Buick,20548,18,0,16,34,0.529411765,0,0.470588235
DIY Network,20484,0,0,0,0,0,0,0
Ripley Entertainment Inc.,21118,0,0,0,0,0,0,0
"ChikiP, LLC",21120,1,0,0,1,1,0,0
Girl Rising Movie,19704,0,0,0,0,0,0,0
"InsiderGuide.com, LC",19290,0,0,0,0,0,0,0
Popularproductrewards,19297,0,0,0,0,0,0,0
Zardetto Spumanti,20190,0,0,0,0,0,0,0
CPS Energy,19304,0,0,0,0,0,0,0
Ra One Movie,20108,0,0,0,0,0,0,0
North Carolina Association of Realtors,19747,0,0,0,0,0,0,0
"Lactalis American Group, Inc.",20340,0,0,0,0,0,0,0
Better Nation,19965,0,0,0,0,0,0,0
"Crisis Education, LLC",20508,33,2,1,36,0.916666667,0.055555556,0.027777778
"MyPoints.com, Inc.",20215,0,0,1,1,0,0,1
McLaren Automotive,20683,0,0,0,0,0,0,0
Arts Holland,20226,0,0,0,0,0,0,0
Altisource Solutions,20526,0,0,0,0,0,0,0
Silence Media Ltd.,19990,0,0,0,0,0,0,0
"Friendly's Ice Cream, LLC",20233,0,0,0,0,0,0,0
John Carter Movie,20151,0,0,0,0,0,0,0
BIC Group,20476,0,0,0,0,0,0,0
"Jewelry Warehouse, Inc",20365,0,0,0,0,0,0,0
"FranchiseHelp Holdings, LLC",19475,0,0,0,0,0,0,0
Huntsville/Madison County Convention & Visitors Bureau,19425,0,0,0,0,0,0,0
Starbuck Movie,19426,0,0,0,0,0,0,0
Coalition to Protect America's Health Care,19926,5,0,0,5,1,0,0
NutraTech Ltd,19293,0,0,0,0,0,0,0
WealthVelocityInstitute.com,19294,0,0,0,0,0,0,0
Tr3s TV,19726,0,0,0,0,0,0,0
Comedy Central,19729,2,0,0,2,1,0,0
ECart Services Indonesia,19943,0,0,0,0,0,0,0
Autonomous Non-Profit Organisation,19944,0,0,2,2,0,0,1
avimediaconverter.com,20197,9,0,1,10,0.9,0,0.1
OregonMetro.gov,19743,0,0,0,0,0,0,0
Region of Attica,19744,0,0,0,0,0,0,0
Confucius Movie,19720,0,0,0,0,0,0,0
Texas Department of Motor Vehicles,19308,0,0,0,0,0,0,0
Willy Wonka And The Chocolate Factory Movie,20112,0,0,0,0,0,0,0
Lifestyles Unlimited,19961,0,0,0,0,0,0,0
Yiasou,19920,0,0,0,0,0,0,0
State Fair of Texas,20444,0,0,0,0,0,0,0
Senator John Heinz History Center,20322,0,0,0,0,0,0,0
Michigan Credit Union League,20211,0,0,1,1,0,0,1
"L & L Reporting Service, Inc.",19299,0,0,0,0,0,0,0
"eCoverage, LLC",20562,1,0,0,1,1,0,0
American Legacy Foundation,19952,0,0,0,0,0,0,0
Dino's Chicken and Burgers,20129,0,0,0,0,0,0,0
"Collective Media, Inc.",20437,3,0,0,3,1,0,0
Jordans Furniture,20461,0,0,0,0,0,0,0
American Century Proprietary Holdings Inc.,19166,0,0,0,0,0,0,0
Ordnance Survey Ltd,20529,0,0,0,0,0,0,0
Tigerbox Group,20361,0,0,0,0,0,0,0
BBI Healthcare LTD,19993,0,0,0,0,0,0,0
Wish You Were Here Movie,20144,0,0,0,0,0,0,0
Bushwacker Inc.,20697,0,0,0,0,0,0,0
Birst Inc.,20544,10,0,0,10,1,0,0
bestimageeditorfunapp.com,20898,6,0,0,6,1,0,0
Don Miguel Gascón,20798,0,0,0,0,0,0,0
Rush Movie,20494,0,0,0,0,0,0,0
The Lords of Salem Movie,21115,0,0,0,0,0,0,0
myPhoneRoom LLC,19954,0,0,0,0,0,0,0
Ken Corporation Ltd,20335,0,0,0,0,0,0,0
"Gaia Herbs, LLC",20339,0,0,0,0,0,0,0
Dimensional Optics,20120,0,0,0,0,0,0,0
bestcodecpackapp.com,19969,4,0,1,5,0.8,0,0.2
Simply Orange Juice Company,20452,0,0,0,0,0,0,0
Blue Jasmine Movie,20522,0,0,0,0,0,0,0
UK Channel Management Limited,20537,0,0,0,0,0,0,0
Elysium Movie,20488,0,0,0,0,0,0,0
7go,20905,0,0,0,0,0,0,0
Mo's Fort Greene,20803,0,0,0,0,0,0,0
Bicycle World of Houston,19168,0,0,0,0,0,0,0
Looper Movie,19856,0,0,0,0,0,0,0
"About, Inc.",19066,0,0,0,0,0,0,0
IMDB,19857,0,0,0,0,0,0,0
Apple Inc.,19860,0,0,0,0,0,0,0
California Health Benefits Exchange,20810,1,0,0,1,1,0,0
Salt River Project,18934,0,0,0,0,0,0,0
"PJ Media,  LLC",19863,0,0,0,0,0,0,0
Runaway Slave Movie,19866,0,0,0,0,0,0,0
Colorado Department of Public Health,20817,1,0,0,1,1,0,0
Unleaded Communications,18175,0,0,0,0,0,0,0
Abraham Lincoln Vampire Hunter Movie,20715,0,0,0,0,0,0,0
The Boston Beer Company,20713,0,0,0,0,0,0,0
Citi Performing Arts Center,19865,0,0,0,0,0,0,0
Tempe Tourism Office,18154,0,0,0,0,0,0,0
DailyWorth,18177,1,0,0,1,1,0,0
HealthWellnessLifestyle,20820,15,5,5,25,0.6,0.2,0.2
"Atari, Inc.",19861,0,0,0,0,0,0,0
Energy Brands Inc. (glaceau),19859,0,0,1,1,0,0,1
Farm Family Casualty Insurance Company,18151,0,0,0,0,0,0,0
"Thismoment, Inc.",18149,0,0,0,0,0,0,0
Schuh Limited,18164,0,0,0,0,0,0,0
SkinCareSearch.com Inc.,20813,2,1,1,4,0.5,0.25,0.25
MyOnlineArcade.com,18170,0,0,0,0,0,0,0
Sony Entertainment Network,19858,4,0,8,12,0.333333333,0,0.666666667
PerfumesbyRihanna.com,20814,1,1,0,2,0.5,0.5,0
Daimler AG,18179,0,0,0,0,0,0,0
"E! Entertainment Television, LLC.",18190,1,0,3,4,0.25,0,0.75
Wallside Windows,18160,0,0,0,0,0,0,0
PuraCleanse,18166,0,0,0,0,0,0,0
Total Recall Movie,19855,0,0,0,0,0,0,0
"Natural Form (WCW, Inc.)",19862,0,0,0,0,0,0,0
AudienceTV,20808,0,0,0,0,0,0,0
Audio Express Inc,20807,0,0,0,0,0,0,0
Dan's Camera City,18155,0,0,0,0,0,0,0
Hightail Inc.,20812,4,0,0,4,1,0,0
"e-MDs, Inc.",18197,0,0,0,0,0,0,0
Womensforum.com,18159,0,0,0,0,0,0,0
Yonge Street Mission,18165,0,0,0,0,0,0,0
Alison for Kentucky,20809,0,0,0,0,0,0,0
Tammy Busche,20709,0,0,0,0,0,0,0
MediaMath Inc.,18157,0,0,0,0,0,0,0
FamilyTime LLC.,19864,4,0,5,9,0.444444444,0,0.555555556
"Linden Research, Inc.",18156,0,0,0,0,0,0,0
"Coffee Shop Millionaire Education, Inc",18161,0,0,0,0,0,0,0
"Winebow, Inc.",20714,0,0,0,0,0,0,0
Los Angeles Tourism and Convention Board,18153,0,0,0,0,0,0,0
Sequel Naturals,18193,0,0,0,0,0,0,0
Profit Masters Academy,18186,9,0,0,9,1,0,0
The Human Rights Campaign,18158,0,0,0,0,0,0,0
Inquirer Interactive Inc.,18173,0,0,1,1,0,0,1
Key Brand Entertainment Inc.,18188,0,0,0,0,0,0,0
Boulder Distillery & Clear Spirit Company Inc.,20711,0,0,0,0,0,0,0
"The LASIK Vision Institute, LLC",18181,2,0,0,2,1,0,0
Digital Extremes Ltd.,20811,0,0,0,0,0,0,0
playmediaplayer.com,18174,0,0,0,0,0,0,0
Hawes & Curtis,18183,0,0,0,0,0,0,0
New England Law,18172,0,0,0,0,0,0,0
Premium Rush Movie,19854,0,0,0,0,0,0,0
BuySpares,18191,0,0,0,0,0,0,0
"Grand Homes, Inc.",18184,0,0,0,0,0,0,0
Dragonfly Products,18178,0,0,0,0,0,0,0
Northgate González Markets,18196,0,0,0,0,0,0,0
Meritus International Hotels Pte Ltd,18162,0,0,0,0,0,0,0
Mahindra Lifespace Developers Ltd,18194,0,0,0,0,0,0,0
UniBev Ltd.,20718,0,0,0,0,0,0,0
Detroit Symphony Orchestra,18180,0,0,0,0,0,0,0
Learn To Trade Ltd.,18187,0,0,0,0,0,0,0
"Stages of Beauty, LLC",20816,1,0,0,1,1,0,0
Comic Relief,18167,0,0,0,0,0,0,0
noyapps,20818,1,0,3,4,0.25,0,0.75
Tractor Supply Co.,18192,2,0,0,2,1,0,0
"Themis Solutions, Inc.",18176,0,0,0,0,0,0,0
"Imperial Brands, Inc.",20712,0,0,0,0,0,0,0
ClickMeIn Limited,20815,2,0,0,2,1,0,0
Miracle Hydrate LLC,18171,3,0,0,3,1,0,0
Nival,20819,0,0,0,0,0,0,0
"Stackify, LLC",18150,0,0,0,0,0,0,0
Now You See Me Movie,19867,0,0,0,0,0,0,0
Kona Brewing,20720,0,0,0,0,0,0,0
Jesta Digital GmbH,18148,0,0,0,0,0,0,0
Health-on-Line Company (UK) Ltd.,18163,0,0,0,0,0,0,0
The University of Scranton,18182,0,0,0,0,0,0,0
Mixwall Limited,18189,0,0,0,0,0,0,0
Oil-Dri Corporation of America,18169,0,0,0,0,0,0,0
BestBuys Brands,19068,0,0,0,0,0,0,0
"Idelle Labs, Ltd.",20006,0,0,0,0,0,0,0
Grupo Modelo,20010,1,0,0,1,1,0,0
EFFEN Import Company,20003,0,0,0,0,0,0,0
Nevada State Treasurer's Office,19249,0,0,0,0,0,0,0
Weetabix Limited,20011,0,0,0,0,0,0,0
SPI Group,20018,0,0,0,0,0,0,0
North American Breweries,20012,2,0,0,2,1,0,0
Walkers Snacks Ltd,20022,0,0,0,0,0,0,0
Army National Guard,20024,0,0,0,0,0,0,0
Virginia Commonwealth University,20026,0,0,0,0,0,0,0
Peeples Movie,20031,0,0,0,0,0,0,0
Yoga Transformation Movie,20032,0,0,0,0,0,0,0
Bachelorette Movie,19870,0,0,0,0,0,0,0
Integral Corp.,19251,0,0,0,0,0,0,0
Pernod Ricard USA,20009,4,0,4,8,0.5,0,0.5
Escape From Planet Earth Movie,19871,0,0,0,0,0,0,0
The Invisible War Movie,19873,0,0,0,0,0,0,0
Conan The Barbarian 3D Movie,20035,0,0,0,0,0,0,0
About Time Movie,21222,0,0,0,0,0,0,0
Keyhole Movie,19874,0,0,0,0,0,0,0
Red Lights Movie,19877,0,0,0,0,0,0,0
The Day Movie,19881,0,0,0,0,0,0,0
Shadow Dancer Movie,19880,0,0,0,0,0,0,0
Salon Marjan,18700,0,0,0,0,0,0,0
"BN Media, LLC",20239,0,0,2,2,0,0,1
"Leslie's Poolmart, Inc.",20241,0,0,0,0,0,0,0
Rampart Movie,19885,0,0,0,0,0,0,0
Blitz-Weinhard Brewing,20013,0,0,0,0,0,0,0
Bending The Rules Movie,19887,0,0,0,0,0,0,0
ReadyDownload,20028,0,0,0,0,0,0,0
La Source Movie,19878,0,0,0,0,0,0,0
Mirror Mirror Movie,19888,0,0,0,0,0,0,0
The Girl From The Naked Eye Movie,19886,0,0,0,0,0,0,0
VANYA and SONIA and MASHA and SPIKE,19334,0,0,0,0,0,0,0
Mr. Electric Corporation,20242,0,0,0,0,0,0,0
Globe Education Network,20822,1,1,0,2,0.5,0.5,0
Adriana's Insurance,20252,1,0,0,1,1,0,0
The Hangover Part III Movie,19892,0,0,0,0,0,0,0
coolzipextractorapp.com,20244,14,0,1,15,0.933333333,0,0.066666667
Florette SAS,20240,0,0,0,0,0,0,0
"MHL, LLC",20249,0,0,0,0,0,0,0
Zmovie.tv,21124,0,0,0,0,0,0,0
"Keas, Inc.",19185,0,0,0,0,0,0,0
Liberte Inc,20020,0,0,0,0,0,0,0
"Nancy Fishman Film Releasing, LLC",21321,0,0,0,0,0,0,0
"National Amusements, Inc.",21128,0,0,0,0,0,0,0
Glasgow Film Theatre,21335,0,0,0,0,0,0,0
Marion Films,21328,0,0,0,0,0,0,0
Oil Can Breweries,20015,0,0,2,2,0,0,1
NRG Energy Inc.,20255,0,0,0,0,0,0,0
Pacific Rim Movie,20273,0,0,0,0,0,0,0
SnapComms Ltd,20269,0,0,0,0,0,0,0
SENTAI FILMWORKS LLC,21353,0,0,0,0,0,0,0
HAVC,21343,0,0,0,0,0,0,0
City and County of San Francisco,21332,0,0,0,0,0,0,0
Threshold Filmworks,21331,0,0,0,0,0,0,0
MIZEL ARTS & CULTURE CENTER,21357,0,0,0,0,0,0,0
Fast & Furious 6 Movie,19891,0,0,0,0,0,0,0
"Cervecería Cuauhtémoc Moctezuma, S.A. de C.V. ",20023,0,0,0,0,0,0,0
"Cooper Spirits International, Inc.",20284,0,0,0,0,0,0,0
University of Sussex,21375,0,0,0,0,0,0,0
NewFilmmakers Los Angeles (NFMLA),21326,0,0,0,0,0,0,0
Torchmark Corporation,20264,0,0,0,0,0,0,0
Copperhead Movie,20275,0,0,0,0,0,0,0
Louisiana Department of Public Safety,20256,0,0,1,1,0,0,1
CPMGO Inc.,21350,0,0,0,0,0,0,0
NWFilmCenter,21367,0,0,0,0,0,0,0
Nutronics Labs,20270,0,0,0,0,0,0,0
Australian International Movie Convention,21135,0,0,0,0,0,0,0
Shedd Aquarium,20025,0,0,0,0,0,0,0
Filmclub,21377,0,0,0,0,0,0,0
Alberta Film,21337,0,0,0,0,0,0,0
San Francisco Silent Film Festival,21330,0,0,0,0,0,0,0
"Loeks Theatres, Inc.",21349,0,0,0,0,0,0,0
filmanator.com,21379,0,0,0,0,0,0,0
Shape Up and Shed Pounds Movie,20033,0,0,0,0,0,0,0
Campus Crusade for Christ International,21372,0,0,0,0,0,0,0
Asian Project Market,21342,0,0,0,0,0,0,0
Michigan Film Office,21323,0,0,0,0,0,0,0
"Chobani, Inc.",20288,2,0,2,4,0.5,0,0.5
PrinterPix,20258,0,0,0,0,0,0,0
Dredd Movie,20029,0,0,0,0,0,0,0
Musicians Institute,21381,0,0,0,0,0,0,0
Red 2 Movie,20277,0,0,0,0,0,0,0
The Wicker Tree Movie,19869,0,0,0,0,0,0,0
Sedona Film Festival,21374,0,0,0,0,0,0,0
Patron Spirits International AG,20281,0,0,0,0,0,0,0
GI Film Festival,21386,0,0,0,0,0,0,0
All Stars Movie,21131,0,0,0,0,0,0,0
The Iceman Movie,19884,0,0,0,0,0,0,0
Fire with Fire Movie,20034,0,0,0,0,0,0,0
2nd PLAYGROUND FILM FESTIVAL,21351,0,0,0,0,0,0,0
Mr. Popper's Penguins,19893,0,0,0,0,0,0,0
Monterey Media Inc.,21333,0,0,0,0,0,0,0
Sleepwalk With Me Movie,19876,0,0,0,0,0,0,0
movieguide.org,21125,0,0,0,0,0,0,0
Canadian Film Fest,21360,0,0,0,0,0,0,0
Artivist,21420,0,0,0,0,0,0,0
Russian Standard Vodka LLC,20285,0,0,0,0,0,0,0
The Spirit of '45 Movie,21384,0,0,0,0,0,0,0
Detroit Metro Convention & Visitors Bureau,21325,0,0,0,0,0,0,0
Republic of Montenegro,20265,0,0,0,0,0,0,0
"Western Athletic Clubs, Inc.",20262,1,0,1,2,0.5,0,0.5
Ventura Visitors & Convention Bureau,21347,0,0,0,0,0,0,0
Crazy Eyes Movie,21338,0,0,0,0,0,0,0
"Paragon Films, Inc.",21424,0,0,0,0,0,0,0
American Spaz,21418,0,0,0,0,0,0,0
Oxford University Press,21389,0,0,0,0,0,0,0
The Attack Movie,20274,0,0,0,0,0,0,0
FilmOn,21378,0,0,0,0,0,0,0
Alliance Films,21448,0,0,0,0,0,0,0
Videojug Corporation Limited,21439,0,0,0,0,0,0,0
"Buy Buy Baby, Inc.",20306,0,0,0,0,0,0,0
TelecityGroup,21421,0,0,0,0,0,0,0
Gig Harbor Film Festival,21432,0,0,0,0,0,0,0
The Morton Arboretum,20292,0,0,0,0,0,0,0
vodonet.net,21423,2,1,0,3,0.666666667,0.333333333,0
Anthill Films,21429,0,0,0,0,0,0,0
San Giorgio Aste,20299,0,0,0,0,0,0,0
Monsieur Lazhar Movie,19889,0,0,0,0,0,0,0
Reeling LGBT International Film Festival,21453,0,0,0,0,0,0,0
Philadelphia Film Society,21434,0,0,0,0,0,0,0
Albuguerque Film Experience,21340,0,0,0,0,0,0,0
Met Film School,21382,0,0,0,0,0,0,0
Films TV Productions,21425,0,0,0,0,0,0,0
Colorado Film School,21355,0,0,0,0,0,0,0
marketingmovies.net,21127,0,0,0,0,0,0,0
"Boot Barn, Inc.",20296,0,0,0,0,0,0,0
Gene Siskel Film Center,21329,0,0,0,0,0,0,0
Shebang Technologies Group Ltd.,20272,0,0,0,0,0,0,0
Funk Factory Films,21440,0,0,0,0,0,0,0
Florida State University,21336,0,0,0,0,0,0,0
Anthony's Pizza and Pasta,20302,0,0,0,0,0,0,0
Miami Film Life Center,21438,0,0,0,0,0,0,0
United Film Festival,21442,0,0,0,0,0,0,0
f BRUGAL & Co. C. POR A.,20283,0,0,0,0,0,0,0
Teaneck Film Festival,21444,0,0,0,0,0,0,0
GOAL ZERO Corporation,20257,1,0,0,1,1,0,0
myfilmplayer.com,21451,1,1,0,2,0.5,0.5,0
"Scribd, Inc.",20268,0,0,0,0,0,0,0
Curzon Film World,21359,0,0,0,0,0,0,0
Enzian Theatre,21361,0,0,0,0,0,0,0
"Tropicana Products, Inc.",20289,0,0,0,0,0,0,0
"Morton Salt, Inc.",20291,0,0,0,0,0,0,0
tvnoop.com,20293,2,0,1,3,0.666666667,0,0.333333333
Honolulu Film Office,21371,0,0,0,0,0,0,0
Virgil Film and Entertainment,21385,0,0,0,0,0,0,0
Pinewood Shepperton plc,21428,0,0,0,0,0,0,0
RVA Environmental Film Festival,21435,0,0,0,0,0,0,0
thermogenicreviews.com,21446,0,0,0,0,0,0,0
Sunderland AFC,20016,0,0,0,0,0,0,0
Sinister Soles,19875,0,0,0,0,0,0,0
High Ground Movie,19882,0,0,0,0,0,0,0
Stony Brook Film Festival,21320,0,0,0,0,0,0,0
Telefilms,21345,0,0,0,0,0,0,0
Moovweb,21352,0,0,0,0,0,0,0
Monsters and Critics,21443,0,0,0,0,0,0,0
Inffinito,21454,0,0,0,0,0,0,0
Louisiana Film Prize,21445,0,0,0,0,0,0,0
NUESTRA.TV,21452,0,0,0,0,0,0,0
Liberal Arts Movie,19883,0,0,0,0,0,0,0
Remy Cointreau USA,20251,0,0,4,4,0,0,1
Smashed Movie,21133,0,0,0,0,0,0,0
TRISA JEWELS LIMITED,21137,0,0,0,0,0,0,0
Farewell My Queen Movie,21369,0,0,0,0,0,0,0
"Borges USA, Inc.",20301,0,0,0,0,0,0,0
University of Minnesota,21419,0,0,0,0,0,0,0
Freya Films,21426,0,0,0,0,0,0,0
jipaban,21129,0,0,0,0,0,0,0
Seasons of Gray Movie,21130,0,0,0,0,0,0,0
Keep Food Affordable,20261,0,0,0,0,0,0,0
Mash Up Media Limited,21366,0,0,0,0,0,0,0
Mike's Hard Lemonade Co.,20280,0,0,0,0,0,0,0
digital.film-schools.us.com,21380,0,0,0,0,0,0,0
Busan International Film Festival,21383,0,0,0,0,0,0,0
Tulsa World,20297,0,0,0,0,0,0,0
Central Film School London,21430,0,0,0,0,0,0,0
British Academy of Film and Television Arts (BAFTA),21433,0,0,0,0,0,0,0
MoviePass Inc.,18264,0,0,0,0,0,0,0
Blake Lapthorn,19436,0,0,0,0,0,0,0
"Del Real, LLC",20573,0,0,0,0,0,0,0
Compass Rose Academy,20574,0,0,0,0,0,0,0
San Luis Obispo International Film Festival,21392,0,0,0,0,0,0,0
"Less Everything, Inc.",21396,0,0,0,0,0,0,0
Singh Resorts,19553,0,0,0,0,0,0,0
Auberge Resorts,20577,0,0,0,0,0,0,0
USA Football Inc.,21394,0,0,0,0,0,0,0
Racca Enterprises,20582,0,0,0,0,0,0,0
FragranceShop.com,20578,1,0,0,1,1,0,0
Mosaiq Fragrance,20584,0,0,0,0,0,0,0
"Pinkberry, Inc.",19617,0,0,0,0,0,0,0
Oakjo Wedding Films,21400,0,0,0,0,0,0,0
UK Film Studio Productions PLC,21403,0,0,0,0,0,0,0
Lisa Hoffman Beauty LLC,20580,0,0,0,0,0,0,0
"Citadel Cinemas, Inc.",21404,0,0,0,0,0,0,0
DaVita HealthCare Partners Inc.,20831,0,0,0,0,0,0,0
Utah Governor's Office of Economic Development,18637,0,0,0,0,0,0,0
SlimWare Utilities Inc.,20824,43,0,5,48,0.895833333,0,0.104166667
"Pre-Paid Legal Services, Inc.",20830,0,0,0,0,0,0,0
US Social Security,20827,0,0,0,0,0,0,0
BancorpSouth,18639,0,0,0,0,0,0,0
"Blandford Homes, LLC.",18638,0,0,0,0,0,0,0
Monroe College,18644,0,0,0,0,0,0,0
Yves Rocher Amérique du Nord Inc.,20586,0,0,1,1,0,0,1
Sabes Jewish Community Center,21406,0,0,0,0,0,0,0
"Praxis Communications, LLC",18647,0,0,1,1,0,0,1
Heartscope Learning,18634,0,0,0,0,0,0,0
Futures Without Violence,20836,0,0,0,0,0,0,0
California Electronic Asset Recovery (CEAR),18640,0,0,0,0,0,0,0
ultimatemediaconverter.com,18642,0,0,0,0,0,0,0
Esquire Network,20832,0,0,1,1,0,0,1
The Croods Movie,18645,0,0,0,0,0,0,0
Hudson Valley Film Commission,21402,0,0,0,0,0,0,0
Mattamy Homes,18641,0,0,0,0,0,0,0
Friends of Tom Suozzi,20825,0,0,0,0,0,0,0
Reveal Labs,20838,3,1,0,4,0.75,0.25,0
Ebookr,20834,0,0,0,0,0,0,0
Mount Carmel Health System,19402,0,0,0,0,0,0,0
Albany County Tourism,19500,0,0,0,0,0,0,0
Amarin Pharmaceuticals Ireland Ltd,18615,0,0,0,0,0,0,0
Under the Milky Way,21411,0,0,0,0,0,0,0
California Dried Plums Board,19451,0,0,0,0,0,0,0
Meneret Productions,21414,0,0,0,0,0,0,0
International Academy of Film and Television,21417,0,0,0,0,0,0,0
Truth in 24 II Movie,21415,0,0,0,0,0,0,0
Energy & Enterprise Initiative,20846,0,0,0,0,0,0,0
freefilmshd.com,21464,0,0,0,0,0,0,0
Blacks Outdoor Retail Limited,19417,0,0,0,0,0,0,0
"Vermont International Film Foundation, Inc",21466,0,0,0,0,0,0,0
Independent Filmmaker Project,21461,0,0,0,0,0,0,0
Mr. Thrifty,21521,0,0,0,0,0,0,0
TheFilmDesk.com,21470,0,0,0,0,0,0,0
Jacksonville Film Festival,21471,0,0,0,0,0,0,0
filmnose.com,21472,0,0,0,0,0,0,0
"Hoodmart, Inc.",19653,1,0,0,1,1,0,0
zeewetv.com,21474,0,0,0,0,0,0,0
"Evolve Media, LLC",19904,0,0,0,0,0,0,0
Metropolitan Filmexport,21475,0,0,0,0,0,0,0
Build Huge Muscle,21482,24,0,0,24,1,0,0
hibu (UK) Limited,21484,16,7,2,25,0.64,0.28,0.08
Laemmle Theaters,21231,0,0,0,0,0,0,0
NY Auto Giant Group,21486,4,0,0,4,1,0,0
The Little Brown Book Group,21227,0,0,0,0,0,0,0
Student Loan Advisors Group,21489,3,0,0,3,1,0,0
Zacks Media,21234,1,0,0,1,1,0,0
moviefanrewards.com,21236,0,0,0,0,0,0,0
YourInsuranceFinder.co.uk,19804,0,0,0,0,0,0,0
Iona College,21488,0,0,0,0,0,0,0
American Veterinary Medical Foundation,21492,3,0,3,6,0.5,0,0.5
The Smurfs 2 Movie,20384,0,0,0,0,0,0,0
Answers Corporation,21239,0,0,0,0,0,0,0
Time Out Group Ltd,21235,0,0,0,0,0,0,0
Make-A-Wish Foundation of America,19453,0,0,0,0,0,0,0
American Mary Movie,21241,0,0,0,0,0,0,0
SBS SUBSCRIPTION TV,21238,0,0,0,0,0,0,0
"Equinox Holdings, Inc.",21505,2,2,1,5,0.4,0.4,0.2
Talking Movies,21240,0,0,0,0,0,0,0
"Ultimate Golf Fantasy, Inc.",19817,0,0,0,0,0,0,0
Canada Goose Inc.,21493,0,0,0,0,0,0,0
American Physical Therapy Association,21499,0,0,0,0,0,0,0
M&T Bank,21502,1,2,1,4,0.25,0.5,0.25
"Vocus, Inc.",19266,0,0,0,0,0,0,0
"Diamond Resorts Holdings, LLC",21504,0,0,0,0,0,0,0
SeaWaves Technology,21246,0,0,0,0,0,0,0
FremantleMedia Enterprises,20380,0,0,0,0,0,0,0
PHD Virtual Technologies,18766,0,0,0,0,0,0,0
You're Next Movie,20591,0,0,0,0,0,0,0
"Feedbands, LLC",20610,0,0,0,0,0,0,0
LIFE Foundation,21006,0,0,0,0,0,0,0
Drip Depot,21476,0,0,0,0,0,0,0
Columbus Association for the Performing Arts,21228,0,0,0,0,0,0,0
AXS TV,21503,4,0,0,4,1,0,0
"InstallX, LLC.",21245,2,0,0,2,1,0,0
Spinning Plates Movie,21254,0,0,0,0,0,0,0
language-lesson.com,21481,0,0,0,0,0,0,0
Snowmass Village,20600,0,0,0,0,0,0,0
Tele2,21487,0,0,0,0,0,0,0
Priest Movie,21259,0,0,0,0,0,0,0
FreeStreams,20604,0,0,0,0,0,0,0
Nutrex Hawaii Inc.,20377,0,0,0,0,0,0,0
Washington Healthplanfinder,21011,1,0,0,1,1,0,0
Oahu Publications,20376,0,0,0,0,0,0,0
San Joaquin Valley College,21261,0,0,0,0,0,0,0
"nCrowd, Inc",21255,0,0,0,0,0,0,0
Entertainment Film Distributors,21264,0,0,0,0,0,0,0
The Human Events Group,21494,0,0,0,0,0,0,0
Canisius College,21497,0,0,0,0,0,0,0
heartattackfighter.com,20609,0,0,0,0,0,0,0
Terry McAuliffe for Governor,20378,0,0,0,0,0,0,0
Cloudy with a Chance of Meatballs 2 Movie,20592,0,0,0,0,0,0,0
Missguided,20595,0,0,0,0,0,0,0
Northwest Film Center,21268,0,0,0,0,0,0,0
"Vindale Media, LLC",20606,0,0,0,0,0,0,0
Philomena Movie,21631,0,0,1,1,0,0,1
"Boiron, Inc.",21005,5,0,0,5,1,0,0
TweetCraft Minecraft Server,21642,0,0,1,1,0,0,1
yourmovies.com,21257,0,0,0,0,0,0,0
Mirassou Winery,20722,0,0,2,2,0,0,1
Missouri Credit Union Association,20909,0,0,0,0,0,0,0
Hall Pass Movie,21260,0,0,0,0,0,0,0
UnlockYourLuck.com,20911,0,0,0,0,0,0,0
Visual Software Systems Ltd.,18650,0,0,0,0,0,0,0
ShareYourFreebies.com,20934,4,0,0,4,1,0,0
savemovieplayer.com,21244,0,0,0,0,0,0,0
Invitations by Dawn,20921,4,0,0,4,1,0,0
Dallas Buyers Club Movie,21632,0,0,3,3,0,0,1
Frozen Movie,20620,6,0,6,12,0.5,0,0.5
Platinum Acquisitions INC.,20955,0,0,0,0,0,0,0
Sight & Sound Theatres,21661,0,1,1,2,0,0.5,0.5
NatureRaised Foods,21017,0,0,0,0,0,0,0
Newport Beach Film Festival,21267,0,0,0,0,0,0,0
Dot & Bo Inc.,20954,10,0,0,10,1,0,0
Matomy Media Group,21663,16,1,0,17,0.941176471,0.058823529,0
Sensible Portions,21672,0,0,0,0,0,0,0
"Flint Mobile, Inc",20928,0,0,0,0,0,0,0
Love Bite Movie,20938,0,0,0,0,0,0,0
DUX Design,20602,0,0,0,0,0,0,0
The Restaurant,21673,0,0,0,0,0,0,0
Del Mar Thoroughbred Club,20601,0,0,0,0,0,0,0
GamingBolt,21249,0,0,0,0,0,0,0
"Pro-Football, Inc.",21640,1,0,0,1,1,0,0
Bel Furniture,20935,0,0,0,0,0,0,0
Unicorns Restaurant,21668,0,0,0,0,0,0,0
A.G. Findings & Mfg. Co.,21635,11,1,4,16,0.6875,0.0625,0.25
Trouble With The Curve Movie,21674,0,0,0,0,0,0,0
Simon and the Oaks Movie,21646,0,0,0,0,0,0,0
American Management Association,21013,0,0,0,0,0,0,0
"Knoll, Inc.",21018,0,0,0,0,0,0,0
Mandela Long Walk To Freedom Movie,21653,0,0,1,1,0,0,1
12 Years a Slave Movie,20914,0,0,1,1,0,0,1
Texans for Senator John Cornyn Inc.,21008,1,0,0,1,1,0,0
Eastern Michigan University,21643,0,0,0,0,0,0,0
Arizona Exterminating Company,20942,0,0,0,0,0,0,0
weupdatevideos.com,21664,1,0,0,1,1,0,0
Kate Walsh Perfume,21657,0,0,0,0,0,0,0
Shhots Pub,21670,0,0,0,0,0,0,0
Geek Insider,21248,0,0,0,0,0,0,0
RandomSales.net,21262,0,0,0,0,0,0,0
weekly-contest-winner.net,21659,3,0,0,3,1,0,0
Cory Booker,20619,0,0,0,0,0,0,0
Greene County,20931,0,0,0,0,0,0,0
"Judicial Watch, Inc.",20919,1,0,0,1,1,0,0
Warner Bros. Music,21675,0,0,0,0,0,0,0
Lehigh Valley Dairy Farms,21671,0,0,0,0,0,0,0
Marin Software Incorporated,21012,0,0,0,0,0,0,0
Japan-Women-Dating.com,20912,4,0,1,5,0.8,0,0.2
Cleveland International Film Festival,21266,0,0,0,0,0,0,0
Collider.com,21633,0,0,1,1,0,0,1
tumblr.com,21654,62,6,5,73,0.849315068,0.082191781,0.068493151
UMass Memorial Health Care,20933,0,0,0,0,0,0,0
Trine University,20947,0,0,0,0,0,0,0
The Other Dream Team Movie,21647,0,0,0,0,0,0,0
"Qello, LLC",20932,0,0,0,0,0,0,0
AsterNews,21666,0,0,0,0,0,0,0
Charlie Johns General Store,20946,0,0,0,0,0,0,0
Hong Kong Trade Development Council,21322,0,0,0,0,0,0,0
Matilda LP,20254,2,0,0,2,1,0,0
Tightrope Interactive,20841,2,1,2,5,0.4,0.2,0.4
Patten Sales & Marketing,20850,0,0,0,0,0,0,0
MyHeritage Ltd.‎,21477,3,0,0,3,1,0,0
Visiting Nurse Service of New York,21479,0,0,2,2,0,0,1
Noritz America Corporation,20373,0,0,0,0,0,0,0
Hopewell Valley Community Bank,20375,0,0,0,0,0,0,0
"Go Pro Workouts, LLC",20382,0,0,0,0,0,0,0
"Cordova Bend, LTD",21016,0,0,0,0,0,0,0
American Savings Bank,20618,0,0,1,1,0,0,1
JJ Cole Collections,20918,0,0,0,0,0,0,0
Condé Nast Partners,21020,1,0,0,1,1,0,0
The Independent Film & Television Alliance,20941,0,0,0,0,0,0,0
Clyde’s Restaurant Group,20943,0,0,0,0,0,0,0
Suncor Energy Inc.,21645,4,0,2,6,0.666666667,0,0.333333333
Museum of Life and Science,20952,1,0,0,1,1,0,0
Syracuse Film Festival,21358,0,0,0,0,0,0,0
Heffernan Insurance Brokers,21373,0,0,0,0,0,0,0
Terlato Wine Group,20286,1,0,1,2,0.5,0,0.5
"Dailybreak, Inc.",20303,0,0,0,0,0,0,0
Ravi's Pasta & Pizzeria,20305,0,0,0,0,0,0,0
Kirkland Performance Center,21422,0,0,0,0,0,0,0
Doha Film Institute,21441,0,0,0,0,0,0,0
"Doublepositive Marketing Group, Inc.",20837,0,0,0,0,0,0,0
"CNO Services, LLC",18648,0,0,0,0,0,0,0
Roadshow Entertainnment,21458,0,0,0,0,0,0,0
Alabama Gulf Seafood,21522,0,0,0,0,0,0,0
ultimatemoviefan.com,21256,0,0,0,0,0,0,0
Apollo 18 Movie,21258,0,0,0,0,0,0,0
aspenFILM,21271,0,0,0,0,0,0,0
Hiller's Inc.,21641,0,0,0,0,0,0,0
lovebuddyhookup.com,21658,0,0,0,0,0,0,0
WeMade Entertainment,20243,0,0,0,0,0,0,0
Catalina Film Festival,21348,0,0,0,0,0,0,0
Comisión Mexicana de Filmaciones,21365,0,0,0,0,0,0,0
Fuller Smith & Turner P.L.C,20279,0,0,0,0,0,0,0
Hurricane Films,21447,0,0,0,0,0,0,0
M.J. Rose,20579,0,0,0,0,0,0,0
Boston Film Festival,21398,0,0,0,0,0,0,0
DownloadVerse.com,20847,0,0,0,0,0,0,0
Meliá Hotels International Group,20848,0,0,4,4,0,0,1
Spacebird Media,21465,0,0,0,0,0,0,0
"Aereo, Inc.",21480,8,2,0,10,0.8,0.2,0
Virginia Movie,21230,0,0,0,0,0,0,0
The Sweeney Movie,21233,0,0,0,0,0,0,0
WKMG Orlando,20598,0,0,1,1,0,0,1
Warrior Sports,20611,0,0,1,1,0,0,1
Utah State University,20612,0,0,0,0,0,0,0
The Seed Company,21015,0,0,0,0,0,0,0
Donna Morgan LLC,20915,0,0,1,1,0,0,1
iSparkmedia Inc.,20948,3,0,0,3,1,0,0
Grudge Match Movie,21648,0,0,0,0,0,0,0
RecDirect Factory Outlets,21665,4,0,0,4,1,0,0
Kinja,21327,1,0,0,1,1,0,0
Savannah Film Festival,21334,0,0,0,0,0,0,0
Pulling Strings Movie,21134,0,0,0,0,0,0,0
Soul Surfer Movie,21136,0,0,0,0,0,0,0
RisingSeniors.com,20259,0,0,1,1,0,0,1
Copyright Clearance Center,20266,0,0,0,0,0,0,0
Window Film Depot,21368,0,0,0,0,0,0,0
Out On Screen,21370,0,0,0,0,0,0,0
"George DeLallo Company, Inc.",20300,0,0,0,0,0,0,0
The Cinefamily,21427,0,0,0,0,0,0,0
Teton Gravity Research,21436,0,0,0,0,0,0,0
West Virginia Department of Commerce,21393,0,0,0,0,0,0,0
Saint Louis Art Museum,21395,0,0,0,0,0,0,0
Fashion Institute of Technology,21459,0,0,0,0,0,0,0
"Latino International Film Institute & Festival, LALIFF",21468,0,0,0,0,0,0,0
Cinemagic Stadium Theaters,21225,0,0,0,0,0,0,0
It's a Disaster Movie,21229,0,0,0,0,0,0,0
Hotel Monteleone,21495,0,0,0,0,0,0,0
Australian Unity Limited,20927,0,0,0,0,0,0,0
Dallas International Film Festival,21270,0,0,0,0,0,0,0
"Legacy Labs, LLC",21638,0,0,1,1,0,0,1
Nativity 2 Movie,21341,0,0,0,0,0,0,0
Keesler Federal Credit Union,20271,0,0,0,0,0,0,0
Heartland Truly Moving Pictures,21388,0,0,0,0,0,0,0
EF Cultural Travel LTD,21390,0,0,0,0,0,0,0
Ocala Car Audio,21405,0,0,0,0,0,0,0
Arcos Films LLC,21407,0,0,0,0,0,0,0
MNI Targeted Media Inc.,18633,0,0,0,0,0,0,0
FocusCamera,21456,0,0,0,0,0,0,0
Janus Films,21473,0,0,0,0,0,0,0
imoviesclub.com,21224,0,0,0,0,0,0,0
"HomeSearch.com Realty, Inc.",21490,4,0,0,4,1,0,0
almay,20386,0,0,0,0,0,0,0
Galaxy Perfume,20588,0,0,0,0,0,0,0
Ready For Hillary PAC,21007,4,1,0,5,0.8,0.2,0
4223.com,20603,0,0,0,0,0,0,0
Healthy Consumer Living,20605,0,0,0,0,0,0,0
Woodland Direct Inc.,20907,0,0,0,0,0,0,0
Broadway Bank,20920,0,0,0,0,0,0,0
YesStyle.com Ltd.,20922,1,0,0,1,1,0,0
"Fling.com, LLC",21639,0,0,1,1,0,0,1
Disabled American Veterans,20956,0,0,0,0,0,0,0
getrippedfastnow.com,21656,0,0,0,0,0,0,0
Why Stop Now Movie,19872,0,0,0,0,0,0,0
AbbVie Inc.,19897,0,0,7,7,0,0,1
hdmoviefun.com,21126,0,0,0,0,0,0,0
The Babymakers Movie,21132,0,0,0,0,0,0,0
HowToGeek.com,20260,0,0,0,0,0,0,0
New Yorker Films,21431,0,0,0,0,0,0,0
New Hope Film Festival,21449,0,0,0,0,0,0,0
True Beauty Films,21450,0,0,0,0,0,0,0
Lone Star Film Society,21399,0,0,0,0,0,0,0
The Perfume Shop Limited,20581,0,0,0,0,0,0,0
retailsurveygifts.com,20828,3,0,0,3,1,0,0
Jacob Krupnick Productions LLC.,21413,0,0,0,0,0,0,0
Festival-of-Films.com,21463,0,0,0,0,0,0,0
The First Time Movie,21232,0,0,0,0,0,0,0
NS Groep NV,21500,0,0,0,0,0,0,0
Amway Center,20596,0,0,0,0,0,0,0
"Niagara Bottling, LLC",21014,0,0,0,0,0,0,0
Blue Cross and Blue Shield of Kansas City,20613,2,0,0,2,1,0,0
"Two Jinn, Inc",20614,2,0,0,2,1,0,0
filmomatics.com,21263,0,0,2,2,0,0,1
Baggage Claim Movie,20913,0,0,0,0,0,0,0
Eros International Ltd.,21649,0,0,0,0,0,0,0
"Hollywood Spill, LLC",21650,1,0,0,1,1,0,0
The Pact Movie,21344,0,0,0,0,0,0,0
"SXSW, LLC",21362,0,0,0,0,0,0,0
"Education Action Group Foundation, Inc.",21376,0,0,0,0,0,0,0
razorbackfilms,21387,0,0,0,0,0,0,0
Atheist Film Festival,21437,0,0,0,0,0,0,0
HCL Technologies Limited,20576,0,0,0,0,0,0,0
Fragrance Foundation,20583,0,0,0,0,0,0,0
Montlick & Associates,18643,0,0,0,0,0,0,0
Mount Washington College,20833,0,0,0,0,0,0,0
Living Arts College,21462,0,0,0,0,0,0,0
New Orleans Film Society,21469,0,0,0,0,0,0,0
FullMetal Akchemist 2 Movie,21226,0,0,0,0,0,0,0
Clique Ent. Limited,21237,0,0,0,0,0,0,0
coolestmovie.info,21251,0,0,1,1,0,0,1
getyourplayer.com,20608,8,1,1,10,0.8,0.1,0.1
digital-survey.co.uk,21269,0,0,0,0,0,0,0
Americans for Food & Beverage Choice,21637,3,1,0,4,0.75,0.25,0
"Celestron, LLC",21644,2,0,0,2,1,0,0
The Book Thief Movie,21655,0,0,0,0,0,0,0
Navarro Discount Pharmacies,20585,0,0,0,0,0,0,0
Visual Communications,21410,0,0,0,0,0,0,0
"Home-Grown Industries of Georgia, Inc.’s (HGI)",20842,0,0,0,0,0,0,0
LOVEFiLM Deutschland GmbH,21460,0,0,0,0,0,0,0
NO on 522,21478,0,0,0,0,0,0,0
"ProbioSlim, LLC",21485,0,0,0,0,0,0,0
Tourism Organisation Engadin St. Moritz,20374,0,0,0,0,0,0,0
HeBS Digital,21496,0,0,0,0,0,0,0
"Fuelbelt, Inc.",20381,0,0,0,0,0,0,0
The Smurfs Movie,20385,0,0,0,0,0,0,0
"AnyClip, LLC",21242,0,0,0,0,0,0,0
30 Minutes or Less Movie,21253,0,0,0,0,0,0,0
Nigeria's Renaissance,21010,0,0,0,0,0,0,0
Prisoners Movie,20910,0,0,0,0,0,0,0
Tan Physics,20575,1,0,0,1,1,0,0
Hot Tub Expo,18635,0,0,0,0,0,0,0
ConsumerTrials,18646,0,0,0,0,0,0,0
Solar Films Inc.,21409,0,0,0,0,0,0,0
CandidaCleanser.com,20843,0,1,0,1,0,1,0
Jupi Corporation,20852,1,0,0,1,1,0,0
Robinsons Movieworld,21243,0,0,0,0,0,0,0
Popoholic,21250,0,0,0,0,0,0,0
Real Steel Movie,21252,0,0,0,0,0,0,0
KOG Games Inc.,21009,1,0,0,1,1,0,0
gamerankers.com,20607,14,0,1,15,0.933333333,0,0.066666667
PA Media Group,20616,0,0,1,1,0,0,1
Grady Health System,20916,3,2,0,5,0.6,0.4,0
"Clopay Building Products Company, Inc.",20950,0,0,0,0,0,0,0
Stayfilm,21652,0,0,0,0,0,0,0
Menemsha Films,21401,0,0,0,0,0,0,0
NatureBox Inc.,18636,0,0,0,0,0,0,0
Covenant House,20826,0,0,0,0,0,0,0
JESUS Film Media,21412,0,0,0,0,0,0,0
Experience Kissimmee,20844,0,0,0,0,0,0,0
Navy Mutual Aid Association,20851,1,0,1,2,0.5,0,0.5
Rising From Ashes Movie,20590,0,0,0,0,0,0,0
Biocodex,20908,0,0,0,0,0,0,0
downloadfiles.us.com,20615,0,0,2,2,0,0,1
Searching for Sugar Man Movie,21019,0,0,0,0,0,0,0
ACC Ventures LLC,20926,0,0,0,0,0,0,0
Long Island Power Authority,20944,0,0,0,0,0,0,0
Gunnison - Crested Butte Tourism Association,20951,0,0,0,0,0,0,0
Rise Credit,21662,44,8,0,52,0.846153846,0.153846154,0
La Marca Winery,21669,0,0,1,1,0,0,1
Tupelo Film Festival Society,21397,0,0,0,0,0,0,0
Homebaked Films,21416,0,0,0,0,0,0,0
TomTom International B.V.,21483,0,0,2,2,0,0,1
Ken Cuccinelli for Governor,20379,0,0,0,0,0,0,0
Billionaire Boys Club,21498,0,0,0,0,0,0,0
Imperia Online LTD,21247,0,0,0,0,0,0,0
Pennsylvania Department of Labor & Industry,20594,0,0,0,0,0,0,0
Canadian Youth Business Foundation,20597,0,0,0,0,0,0,0
Miami International Film Festival,21265,0,0,0,0,0,0,0
"United Concordia Companies, Inc.",20929,11,0,4,15,0.733333333,0,0.266666667
JoyDownload.com,21651,0,0,0,0,0,0,0
Incapital Holdings LLC,19534,0,0,0,0,0,0,0
The New Digital Age,19585,0,0,0,0,0,0,0
Pure Power Boot Camp,19466,0,0,0,0,0,0,0
"Participant Channel, Inc.",20854,0,0,0,0,0,0,0
Austin Energy,20864,0,0,0,0,0,0,0
Source Atlantique,20860,0,0,0,0,0,0,0
GSIG REO Real Estate,20856,0,0,1,1,0,0,1
Applegate Farms,20855,0,0,0,0,0,0,0
VisitBritain,20862,0,0,0,0,0,0,0
DigiMogul Media Network,20861,0,0,0,0,0,0,0
"GumGum, Inc.",20857,0,0,0,0,0,0,0
"AMC Entertainment, Inc.",20866,0,0,2,2,0,0,1
Reform CA Lifeline,20863,0,0,0,0,0,0,0
"Save On Energy, LLC",20859,0,0,0,0,0,0,0
Kasturi & Sons Ltd,20868,0,0,1,1,0,0,1
Lake Forest Graduate School of Management,19268,0,0,0,0,0,0,0
The Double Movie,19702,0,0,0,0,0,0,0
The College Illinois! 529 Prepaid Tuition Program,19470,0,0,0,0,0,0,0
Mobile-One Auto Sound,20727,0,0,0,0,0,0,0
Sapporo Breweries Limited,20733,3,0,0,3,1,0,0
Audio Express,20728,0,0,0,0,0,0,0
Jacob Leinenkugel Brewing Company,20729,0,0,0,0,0,0,0
Rock and Roll Fantasy Camp (RRFC),19419,0,0,0,0,0,0,0
"Piedmont Distillers, Inc.",20730,0,0,0,0,0,0,0
Garden City Tattoo,20734,0,0,0,0,0,0,0
Kressmann Wines,20741,0,0,0,0,0,0,0
This Is The End Movie,19919,0,0,0,0,0,0,0
Viña San Pedro Tarapacá S.A.,20736,1,0,0,1,1,0,0
Chateau Ste. Michelle,20740,0,0,0,0,0,0,0
Beer Can Alley,20745,0,0,0,0,0,0,0
Florida Film Festival,21274,0,0,0,0,0,0,0
Nancys Candy Etc.,20319,0,0,0,0,0,0,0
The Dollar Diaper Club Company,21510,3,0,0,3,1,0,0
"American Vintage Beverage, Inc.",20746,0,0,0,0,0,0,0
Stuck In Love Movie,20185,0,0,0,0,0,0,0
"WeiserMazars, LLP",21514,0,0,0,0,0,0,0
Oka Movie,20104,0,0,0,0,0,0,0
McCracken County Public Schools,20336,0,0,0,0,0,0,0
Benjamin Franklin Plumbing,20338,0,0,0,0,0,0,0
Wagner SprayTech Corp.,19970,0,0,0,0,0,0,0
Detroit Institute of Arts,21515,3,0,0,3,1,0,0
Ashland independent Film Festival,21273,0,0,0,0,0,0,0
Maui Film Festival Inc.,21281,0,0,0,0,0,0,0
4A Games,20755,0,0,0,0,0,0,0
Savannah College of Art and Design,21288,0,0,0,0,0,0,0
Domaine Chandon,20724,0,0,0,0,0,0,0
Cepia LLC.,21030,0,0,0,0,0,0,0
Woodstock Film Festival,21291,0,0,0,0,0,0,0
Kowa Group,20873,0,0,0,0,0,0,0
McBride & Son Homes,20872,0,0,1,1,0,0,1
"Sabra Dipping Co., LLC.",21032,0,0,0,0,0,0,0
Atlanta Film Festival,21282,0,0,0,0,0,0,0
Sensible Heating & Cooling,20757,0,0,0,0,0,0,0
Metallica Through The Never Movie,21026,0,0,0,0,0,0,0
"Paradise Bakery & Cafe, Inc.",21025,0,0,0,0,0,0,0
Muscle Shoals Movie,21027,0,0,0,0,0,0,0
Brancott Estate Wines,20735,0,0,0,0,0,0,0
Cinamuse,20763,4,0,0,4,1,0,0
Nature’s Best,21529,0,0,0,0,0,0,0
Fonseca Guimaraens,21519,0,0,0,0,0,0,0
Sports Unlimited Inc.,21035,0,0,0,0,0,0,0
Filmhouse,21296,0,0,0,0,0,0,0
Napa Valley Film Festival,21297,0,0,0,0,0,0,0
Discount Golf World,21034,0,0,0,0,0,0,0
Vapor Hog,20761,0,0,0,0,0,0,0
Roadrunner Records,21038,0,0,0,0,0,0,0
NDTV Ethnic Retail Limited,20880,0,0,1,1,0,0,1
The Grey Movie,20758,0,0,0,0,0,0,0
Buffalo Wings and Rings,20772,0,0,0,0,0,0,0
Linden Square,20750,0,0,0,0,0,0,0
Markham Vineyards,20742,0,0,0,0,0,0,0
A Touch of Sin Movie,21039,0,0,0,0,0,0,0
Kim Crawford Wines,20768,0,0,0,0,0,0,0
Nantucket Film Festival,21308,0,0,0,0,0,0,0
Free Birds Movie,21028,0,0,0,0,0,0,0
Mast-Jägermeister SE,20771,0,0,0,0,0,0,0
"LES Film Festival, LLC.",21292,0,0,0,0,0,0,0
mediaplayerinstaller.com,21538,0,0,0,0,0,0,0
Seno Jewelry LLC,21312,0,0,0,0,0,0,0
P.T. Hastings Seafood,20779,0,0,0,0,0,0,0
Taco Man,20787,0,0,0,0,0,0,0
Ghetto Film School,21285,0,0,0,0,0,0,0
Stio,20874,0,0,0,0,0,0,0
Kino International Corporation,21316,0,0,0,0,0,0,0
Mama's Pizza & Subs,21531,0,0,0,0,0,0,0
Sonoma International Film Festival,21299,0,0,0,0,0,0,0
Easy Living Garden Center,20770,0,0,0,0,0,0,0
Sal and Phil's Restaurant,21528,0,0,1,1,0,0,1
The Imposter Movie,20767,0,0,0,0,0,0,0
Austin Film Festival,21305,0,0,0,0,0,0,0
"eMedia Group, Inc.",21304,0,0,0,0,0,0,0
The Master Movie,20778,0,0,0,0,0,0,0
The RoomPlace,20878,0,0,0,0,0,0,0
SHS Drinks,20781,0,0,0,0,0,0,0
Robinson Film Center,21319,0,0,0,0,0,0,0
HealthCare.gov,20882,0,0,1,1,0,0,1
Imagine Science Films,21303,0,0,0,0,0,0,0
Look Cinemas,21293,0,0,0,0,0,0,0
"Biofire Diagnostics, Inc.",21306,0,0,0,0,0,0,0
Alexandre's Lounge,20789,0,0,0,0,0,0,0
Ann Arbor Film Festival,21275,0,0,0,0,0,0,0
Like Water Movie,21307,0,0,0,0,0,0,0
Entertainment One Ltd.,21295,0,0,0,0,0,0,0
The Sarasota Film Festival,21277,0,0,0,0,0,0,0
filmplugin.com,21302,0,0,0,0,0,0,0
LGBTQutie.com,20791,0,0,0,0,0,0,0
Abus Group,20788,0,0,0,0,0,0,0
Hamptons International Film Festival,21284,0,0,0,0,0,0,0
Purple Cowboy Wines,21520,0,0,0,0,0,0,0
Utah Film Center,21317,0,0,0,0,0,0,0
Alaskan Brewery Company,20792,0,0,0,0,0,0,0
Jesse Brown's Outdoors,20775,0,0,0,0,0,0,0
PledgeMusic.com Limited,21313,0,0,0,0,0,0,0
Downloadius,20570,0,0,0,0,0,0,0
Stichting Nederlands Bureau voor Toerisme & Congressen,20221,0,0,0,0,0,0,0
Zenith Infotech Ltd.,20353,0,0,0,0,0,0,0
Hot Deals Hawaii,19985,0,0,0,0,0,0,0
Captain Phillips Movie,20689,0,0,0,0,0,0,0
Kaleida Health,20536,0,0,0,0,0,0,0
Tiger World,20370,0,0,0,0,0,0,0
PriceDepot.net,20538,0,0,0,0,0,0,0
The Social Network Movie,19853,0,0,0,0,0,0,0
"AudienceFUEL, Inc.",20806,0,0,0,0,0,0,0
Phillips Distilling Company,20706,0,0,0,0,0,0,0
Monex Precious Metals,18147,0,0,0,0,0,0,0
Campari America,20002,0,0,4,4,0,0,1
Honey 2 Movie,19868,0,0,0,0,0,0,0
"Furniture Row, LLC",20238,0,0,0,0,0,0,0
FixYourBloodSugar.com,20821,1,2,0,3,0.333333333,0.666666667,0
Flipkart Internet Private Limited,21123,0,0,0,0,0,0,0
Thorndike Development Corporation,20253,1,0,0,1,1,0,0
University of Law,20572,0,0,0,0,0,0,0
San Francisco Film Society,21391,0,0,0,0,0,0,0
Metropolitan Arts Centre,18632,0,0,0,0,0,0,0
HMDX Audio,20823,0,0,0,0,0,0,0
Breast Fest Film Festival,21455,0,0,0,0,0,0,0
Maryland Film Festival,21408,0,0,0,0,0,0,0
Tudor Watches,20840,0,0,1,1,0,0,1
Humphrey Bogart Film Festival,21457,0,0,0,0,0,0,0
We Make Movies,21223,0,0,0,0,0,0,0
Rocket Lawyer,20372,0,0,0,0,0,0,0
"Gotham Organization, Inc.",21491,5,0,6,11,0.454545455,0,0.545454545
theperfumespot.com,20587,0,0,0,0,0,0,0
"Logos Research Systems, Inc.",21004,0,0,1,1,0,0,1
"National Tobacco Company, LP",20721,0,0,0,0,0,0,0
Dr. Bernstein Diet & Health Clinics,18649,0,0,0,0,0,0,0
Heritage Action for America,20853,0,0,0,0,0,0,0
High Ridge Brands,20387,0,0,0,0,0,0,0
Unify Inc.,21506,1,0,2,3,0.333333333,0,0.666666667
Premium Wine Brands Pty Ltd,20723,0,0,0,0,0,0,0
Addicted To Fame Movie,21138,0,0,0,0,0,0,0
LA Carpet,21508,0,0,0,0,0,0,0
Phoenix Film Festival,21272,0,0,0,0,0,0,0
Ender's Game Movie,21021,0,0,0,0,0,0,0
Carrie Movie,21023,0,0,0,0,0,0,0
Ecco Domani,21523,0,0,0,0,0,0,0
Tetley USA Inc.,20870,0,0,0,0,0,0,0
Pop's Saloon,21525,0,0,0,0,0,0,0
San Diego Film Festival,21289,0,0,0,0,0,0,0
Bergdorf Movie,20051,0,0,0,0,0,0,0
"Exponential Entertainment, Inc.",21140,0,0,0,0,0,0,0
"William W Schwartz Associates, Inc.",20389,1,0,0,1,1,0,0
Solomon Kane Movie,21046,0,0,0,0,0,0,0
"Pacifica, Inc.",21049,0,0,0,0,0,0,0
dlapplication.com,21542,0,0,0,0,0,0,0
Prudential Savings Bank,20398,0,0,0,0,0,0,0
"AZEK Building Products, Inc.",20891,0,0,0,0,0,0,0
How To Train Your Dragon Movie,21155,0,0,0,0,0,0,0
DaftCode Sp. z o.o.,21156,3,0,6,9,0.333333333,0,0.666666667
TradeWins Publishing Corporation,21142,0,0,0,0,0,0,0
Snake and Mongoose Movie,21149,0,0,0,0,0,0,0
Broadway Idiot Movie,21041,0,0,0,0,0,0,0
HeritageWest Credit Union,20889,0,0,0,0,0,0,0
Qualtrics,20959,0,0,0,0,0,0,0
Driven Brands,20402,1,0,0,1,1,0,0
fmpub.net,21157,0,0,0,0,0,0,0
Lidl UK GmbH,20403,0,0,0,0,0,0,0
123mediaplayer.com,21055,0,0,0,0,0,0,0
Santa Rosa Island Authority,20893,0,0,0,0,0,0,0
Double Groove LLC.,21150,2,0,1,3,0.666666667,0,0.333333333
proplayersetup.com,21057,2,0,2,4,0.5,0,0.5
hitmovies.co.in,21161,0,0,0,0,0,0,0
gomegamovies.com,21163,0,0,0,0,0,0,0
Evoke,20966,1,0,0,1,1,0,0
Just Flirt,20405,2,0,0,2,1,0,0
Community America Credit Union,20896,0,0,0,0,0,0,0
First Midwest Bank,20972,0,0,0,0,0,0,0
SNI/SI Networks L.L.C.,20404,0,0,0,0,0,0,0
TV BOSS,20968,2,0,0,2,1,0,0
Escape From Tomorrow Movie,21042,0,0,0,0,0,0,0
The We and The I Movie,21147,0,0,0,0,0,0,0
Full Movies,21152,0,0,0,0,0,0,0
Montana Film Office,21170,0,0,0,0,0,0,0
Ivanka Trump Marks LLC.,20395,0,0,0,0,0,0,0
McConkey Movie,21043,0,0,0,0,0,0,0
"Fuze Beverage, LLC",20974,0,0,0,0,0,0,0
Gigantic Parfums,20392,0,0,0,0,0,0,0
quickconvertmedia.com,21059,5,0,0,5,1,0,0
Usenet.nl,21550,0,0,1,1,0,0,1
Ridgewood Savings Bank,21574,0,0,0,0,0,0,0
KC Star,20892,1,0,0,1,1,0,0
Big Ass Spider! Movie,21045,0,0,0,0,0,0,0
Goldworth Financial,20390,0,0,0,0,0,0,0
"Today’s Active Living, Inc.",21561,0,0,0,0,0,0,0
KIDS Games,20971,1,0,0,1,1,0,0
Boy Movie,21189,0,0,0,0,0,0,0
Lighthouse Beauty LLC,20394,0,0,1,1,0,0,1
Aegean Airlines SA,20406,0,0,0,0,0,0,0
Roger Dean Stadium,21168,0,0,0,0,0,0,0
BestBuyFragrance.com,21607,0,0,4,4,0,0,1
GetSoftFree.com,20963,0,0,0,0,0,0,0
The Marine 3 Movie,21048,0,0,0,0,0,0,0
IkkoTrader,21553,0,0,3,3,0,0,1
Opportunity International,20975,9,0,1,10,0.9,0,0.1
Sepha Cosmetics Trade Ltd,21609,0,0,0,0,0,0,0
Alkaline Diet,20895,1,0,0,1,1,0,0
"CFA Properties, LLC",20410,0,0,0,0,0,0,0
HiOscar.com,21063,23,0,0,23,1,0,0
"CKE Restaurants, Inc.",20401,3,0,0,3,1,0,0
gto15.com,21105,0,0,0,0,0,0,0
Fire Adapted Communities Coalition,21547,1,1,0,2,0.5,0.5,0
The Samaritan Movie,21172,0,0,0,0,0,0,0
Worldstar LLC,21002,0,0,1,1,0,0,1
tubemovieshd.com,21158,7,1,0,8,0.875,0.125,0
Now Is Good Movie,21087,0,0,0,0,0,0,0
CarQuest,20421,0,0,0,0,0,0,0
Steel Battalion,21570,0,0,0,0,0,0,0
ShmeGAG,21051,6,0,0,6,1,0,0
Levon Helm Movie,21175,0,0,0,0,0,0,0
funprizes.us,21548,0,0,0,0,0,0,0
Jasco Products Company,21060,0,0,0,0,0,0,0
coolflvplayer.com,21053,0,0,0,0,0,0,0
AIB Group (UK) p.l.c.,20423,0,0,0,0,0,0,0
DealerDirect LLC,21567,0,0,2,2,0,0,1
Colossus Movie,21193,0,0,0,0,0,0,0
Penske Media Corporation,21093,1,0,0,1,1,0,0
It’s My Business Coalition,21624,0,0,0,0,0,0,0
Computer Chess Movie,21202,0,0,0,0,0,0,0
Play Golf America,20996,0,0,0,0,0,0,0
Phoenix Rises Movie,21579,0,0,0,0,0,0,0
Mofilm Ltd.,21174,0,0,0,0,0,0,0
Midtown Crossing,21167,0,0,0,0,0,0,0
"MN Airlines, LLC",21560,5,8,0,13,0.384615385,0.615384615,0
Warrior Movie,21195,0,0,0,0,0,0,0
Luv Movie,21181,0,0,0,0,0,0,0
Nevada Film Office,21182,0,0,0,0,0,0,0
Patriot Stockpile,20412,0,0,0,0,0,0,0
Marble Falls Chamber Visitor Center,20894,0,0,0,0,0,0,0
Junedairymovies.com,21164,0,0,0,0,0,0,0
Terrible Angels Movie,21205,0,0,0,0,0,0,0
Running Wild Movie,21191,0,0,0,0,0,0,0
Silver Circle Movie,21072,0,0,0,0,0,0,0
Connect2Compete,20978,5,0,0,5,1,0,0
mymovieninja.com,21100,0,0,0,0,0,0,0
TPG REWARDS INC.,21082,0,0,0,0,0,0,0
Sensio Labs,20413,1,0,0,1,1,0,0
"TruRx, LLC",21627,2,0,0,2,1,0,0
Sometrics Inc.,21067,0,0,0,0,0,0,0
movienewsletters.net,21208,0,0,0,0,0,0,0
Mgame USA Inc.,21102,0,0,0,0,0,0,0
Frontiers Media S.A.,20427,1,0,0,1,1,0,0
Lainey Gossip Entertainment Inc.,20632,0,0,0,0,0,0,0
McGill's Perfume Oil,21611,0,0,0,0,0,0,0
Coverdell Canada Corporation,20623,0,0,0,0,0,0,0
DTV Services Ltd,17797,0,0,0,0,0,0,0
ACOD Movie,21085,0,0,0,0,0,0,0
Forth Capital,21617,0,0,0,0,0,0,0
Connect America,21565,0,0,0,0,0,0,0
Quorum-Sensing-The-Movie.com,20068,0,0,0,0,0,0,0
iq5download.com,21111,0,0,0,0,0,0,0
flash-download-manager.com,21603,3,0,0,3,1,0,0
Joblo Media Inc.,21074,0,0,0,0,0,0,0
Archer Norris PLC,21113,0,0,0,0,0,0,0
American Ethanol,21629,0,0,0,0,0,0,0
Norwalk Hospital,20428,0,0,0,0,0,0,0
The Family Movie,20659,0,0,0,0,0,0,0
"PropertyMinder, Inc.",21162,0,0,0,0,0,0,0
In  A World Movie,20637,0,0,0,0,0,0,0
Daisuki Inc.,20424,0,0,0,0,0,0,0
No Holds Barred Movie,20085,0,0,0,0,0,0,0
Movie Tavern,21081,1,0,0,1,1,0,0
The Vitality Group,21566,0,0,0,0,0,0,0
HMV CANADA INC.,17799,0,0,0,0,0,0,0
Life Happens Movie,21192,0,0,0,0,0,0,0
"Layered Technologies, Inc.",21589,0,0,0,0,0,0,0
"Epic Events and Promotion, Inc.",21114,0,0,0,0,0,0,0
Forbidden Woman Movie,20627,0,0,0,0,0,0,0
Brooklyn Bridge Park,21089,0,0,0,0,0,0,0
Sumo Lounge Inc,20976,1,0,0,1,1,0,0
"Allvoices, Inc.",21621,13,0,0,13,1,0,0
Liberty Science Center,21599,2,0,1,3,0.666666667,0,0.333333333
Quizulous,1703,0,0,0,0,0,0,0
The Ultimate Life Movie,20656,0,0,0,0,0,0,0
123-movie.com,20064,0,0,0,0,0,0,0
Quest Diagnostics,21628,0,0,1,1,0,0,1
Securifi Ltd,21569,0,0,0,0,0,0,0
The Revolution Movie,20066,0,0,0,0,0,0,0
The Healthcare Education Project,17809,0,0,0,0,0,0,0
FXhome Limited,21196,0,0,0,0,0,0,0
Diana Movie,21578,0,0,0,0,0,0,0
ReserveBar.com,20671,0,0,0,0,0,0,0
Black Entertainment Television LLC,2511,1,0,1,2,0.5,0,0.5
This Is Us Movie,20624,0,0,0,0,0,0,0
Rickard S.J Jonasson,17810,0,0,0,0,0,0,0
Nikko Hotels International,21065,1,0,0,1,1,0,0
District of Columbia Public Schools,1716,0,0,0,0,0,0,0
"LowerMyBills, Inc.",20649,138,1,23,162,0.851851852,0.00617284,0.141975309
"New Life Solution, Inc.",17806,0,0,0,0,0,0,0
"Hotwire, Inc.",21066,0,0,2,2,0,0,1
Dania,2439,1,0,0,1,1,0,0
Winnie Mandela Movie,20983,0,0,0,0,0,0,0
Brooklyn Brothers Movie,20054,0,0,0,0,0,0,0
Dufry,21608,0,0,0,0,0,0,0
WNMP Ltd.,21069,1,0,0,1,1,0,0
Carlson School of Management,20645,0,0,0,0,0,0,0
movieplayerupdate.com,21104,0,0,0,0,0,0,0
Blue is the Warmest Color Movie,21583,0,0,0,0,0,0,0
Resume Rabbit,20678,0,0,0,0,0,0,0
V.W. Brown Insurance Service,20666,0,0,0,0,0,0,0
TheHappyHousewife.com,21204,0,0,0,0,0,0,0
"Eventful, Inc.",3256,1,0,0,1,1,0,0
APR LLC,20668,0,0,0,0,0,0,0
Metroplay Casino,20426,0,0,0,0,0,0,0
"GenTechnologies Apps, LLC",21096,0,0,0,0,0,0,0
Kon-tiki Movie,21078,0,0,0,0,0,0,0
Great Expectations Movie,21584,0,0,0,0,0,0,0
"Bless Me, Ultima Movie",21199,0,0,0,0,0,0,0
Bringing Up Bobby Movie,21180,0,0,0,0,0,0,0
Elite Squad Movie,20074,0,0,0,0,0,0,0
Turbo Movie,20430,0,0,0,0,0,0,0
The Kings Of Summer Movie,20055,0,0,0,0,0,0,0
MSP Productions,20077,0,0,0,0,0,0,0
The Mortal Instruments Movie,20086,0,0,0,0,0,0,0
"Mercola.com, LLC",17798,0,0,0,0,0,0,0
"University of California, Berkeley",2501,0,0,0,0,0,0,0
If A Tree Falls Movie,21185,0,0,0,0,0,0,0
Lee Daniels' The Butler Movie,20638,0,0,0,0,0,0,0
Rogue Saints Movie,20091,0,0,0,0,0,0,0
Digi-Key Corporation,2519,3,0,4,7,0.428571429,0,0.571428571
The Sitter Movie,20060,0,0,0,0,0,0,0
"Express, LLC",1705,1,0,0,1,1,0,0
fashion4home GmbH,2190,0,0,0,0,0,0,0
Much Ado About Nothing Movie,20078,0,0,0,0,0,0,0
H&R Block,2575,0,0,0,0,0,0,0
"AARC, Inc. (Advance America)",2429,11,5,0,16,0.6875,0.3125,0
NEXT GEN CLIMATE ACTION,20994,0,0,0,0,0,0,0
"Seatzy, LLC",21210,0,0,0,0,0,0,0
H&M,2579,6,2,6,14,0.428571429,0.142857143,0.428571429
Kizi Games,2577,12,2,1,15,0.8,0.133333333,0.066666667
Mid-America Regional Council,20677,0,0,0,0,0,0,0
Dr. Hennessy Cosmetic Clinic,20672,0,0,0,0,0,0,0
The CHAIN Fund,20095,0,0,0,0,0,0,0
University Hospitals,3544,0,0,1,1,0,0,1
Emma,2580,2,0,0,2,1,0,0
Julien Dubuque International Film Festival,21597,0,0,0,0,0,0,0
Bitz & Pixelz B.V.,21217,0,0,0,0,0,0,0
The Revenant Movie,20070,0,0,0,0,0,0,0
Claims Direct,17802,0,0,0,0,0,0,0
Splinters Movie,20096,0,0,0,0,0,0,0
The Gift Of Life Movie,20067,0,0,0,0,0,0,0
EchoStar Corporation,10585,0,0,0,0,0,0,0
One.org,1702,0,0,0,0,0,0,0
The Reunion Movie,20082,0,0,0,0,0,0,0
"IceGames Co., Ltd.",21601,8,0,8,16,0.5,0,0.5
Life In A Day Movie,1704,0,0,0,0,0,0,0
Grassroots Movie,21194,0,0,0,0,0,0,0
Central Michigan University,3547,16,1,0,17,0.941176471,0.058823529,0
moviefanfare.com,21094,0,0,1,1,0,0,1
USC School of Social Work,3243,0,0,0,0,0,0,0
Movies OK,21101,0,0,0,0,0,0,0
Dark Tide Movie,20084,0,0,0,0,0,0,0
Tangient LLC,21108,0,0,0,0,0,0,0
ChoiceStream Inc,21598,6,1,0,7,0.857142857,0.142857143,0
Lost for Words Movie,20633,0,0,0,0,0,0,0
The End Of Love Movie,20087,0,0,0,0,0,0,0
"Hearst Communications, Inc. (Magazines)",2493,21,5,12,38,0.552631579,0.131578947,0.315789474
NorthShore University Health System,2200,4,0,2,6,0.666666667,0,0.333333333
"Petz Enterprises, Inc.",3248,0,0,0,0,0,0,0
We're Not Broke Movie,20092,0,0,0,0,0,0,0
Nimsoft,1715,0,0,0,0,0,0,0
iq4download.com,21097,0,0,0,0,0,0,0
Afternoon Delight Movie,20640,0,0,0,0,0,0,0
North American Precis Syndicate,2505,0,0,0,0,0,0,0
Behavioral Analytics LLC,20651,0,0,0,0,0,0,0
NACS,1718,0,0,0,0,0,0,0
Ausfilm,21198,0,0,0,0,0,0,0
"Harvey Industries, Inc.",10579,0,0,0,0,0,0,0
Ginger Software,10581,0,0,0,0,0,0,0
elove.com,1721,0,0,0,0,0,0,0
In A World Movie,20658,0,0,0,0,0,0,0
Genesco Inc,2515,1,0,5,6,0.166666667,0,0.833333333
American Movie Classics Company LLC.,2436,1,0,1,2,0.5,0,0.5
Regatta Travel Solutions,20669,0,0,0,0,0,0,0
Chivas,1722,0,0,1,1,0,0,1
Transworld Snowboarding,18199,0,0,0,0,0,0,0
"Rocket Fuel, Inc.",10582,0,0,0,0,0,0,0
Fidelity,3244,6,3,11,20,0.3,0.15,0.55
"Gala-Net, Inc.",10583,0,0,0,0,0,0,0
Artsana S.p.a.,3251,0,0,0,0,0,0,0
"UniRush, LLC,",2430,8,0,0,8,1,0,0
"Taylor Morrison, Inc.",3262,1,0,0,1,1,0,0
Koninklijke Philips Electronics,3261,22,3,12,37,0.594594595,0.081081081,0.324324324
Snap Equity Limited,10586,0,0,0,0,0,0,0
PerfectConnectionGolfSwing.com,1720,0,0,0,0,0,0,0
Christian Book Distributors,2574,0,0,2,2,0,0,1
"Time, Inc.",3548,9,0,7,16,0.5625,0,0.4375
Fora.tv,3247,0,0,0,0,0,0,0
Digital Romance Inc,17804,1,0,0,1,1,0,0
Cowboys & Aliens Movie,3546,0,0,0,0,0,0,0
Reynolds Auto Group,10578,0,0,0,0,0,0,0
"J.R. Carlson Laboratories, Inc.",20647,0,0,0,0,0,0,0
Symantec Corporation,3253,208,12,117,337,0.617210682,0.035608309,0.347181009
Verve Wireless,20662,0,0,0,0,0,0,0
"Marvel Entertainment, LLC",3241,1,0,0,1,1,0,0
Deep In The Heart Movie,20061,0,0,0,0,0,0,0
Façonnable,3258,0,0,0,0,0,0,0
Jungle Girl Movie,20080,0,0,0,0,0,0,0
The English Teacher Movie,20093,0,0,0,0,0,0,0
American Public University,2195,12,1,1,14,0.857142857,0.071428571,0.071428571
Lan Airlines,2196,1,0,4,5,0.2,0,0.8
Barrett for Wisconsin,10584,0,0,0,0,0,0,0
Association of American Railroads,3249,2,0,1,3,0.666666667,0,0.333333333
Pabst Brewing Company,20731,0,0,0,0,0,0,0
Gabi H2O UK Ltd.,21031,0,0,0,0,0,0,0
"The Bureau of National Affairs, Inc.",21300,0,0,0,0,0,0,0
"First Stop Health, LLC.",20881,0,0,1,1,0,0,1
Israel Film Festival,21314,0,0,0,0,0,0,0
movienightreviews.com,21146,0,0,0,0,0,0,0
Mcllhenny Company,20396,0,0,0,0,0,0,0
"Empowered Medical Media, LLC",20964,1,0,0,1,1,0,0
House Of Fraser (Stores) Ltd.,20414,0,0,0,0,0,0,0
Connecticut School of Broadcasting,21564,0,0,0,0,0,0,0
Cookie Craze,21064,0,0,0,0,0,0,0
Baird & Warner Real Estate,20981,0,0,0,0,0,0,0
The Christmas Candle Movie,21581,2,0,2,4,0.5,0,0.5
7 Diamonds Clothing Co. Inc.,21582,0,0,0,0,0,0,0
Kill Your Darlings Movie,21600,0,0,0,0,0,0,0
"MTI USA, Inc.",21099,0,0,0,0,0,0,0
Very Perry Films,21213,0,0,0,0,0,0,0
The Independent Order of Foresters,21214,0,0,0,0,0,0,0
Thomas Cook Retail Limited,17805,0,0,0,0,0,0,0
California 90420 Movie,20628,0,0,0,0,0,0,0
The Look of Love Movie,20631,0,0,0,0,0,0,0
Carlson Craft,20646,0,0,0,0,0,0,0
TradeMotion LLC,20663,0,0,0,0,0,0,0
The White Rabbit,20681,0,0,0,0,0,0,0
Leonie Movie,20063,0,0,0,0,0,0,0
SpeedDate.com,2497,6,0,0,6,1,0,0
Montage Hotels,1712,0,0,0,0,0,0,0
Homemade Energy,2194,0,0,0,0,0,0,0
TeamViewer,2197,1,0,1,2,0.5,0,0.5
Levtec LLC,21511,9,7,0,16,0.5625,0.4375,0
Green Dot Bank,21513,0,0,0,0,0,0,0
Rhode Island International Film Festival,21279,0,0,0,0,0,0,0
Wilmington Trust,20875,4,1,0,5,0.8,0.2,0
Montclair Film Festival,21309,0,0,0,0,0,0,0
videotender.com,20886,19,0,0,19,1,0,0
Tree House Farm & Nursery,20784,0,0,0,0,0,0,0
Astro’s World of Movies,21143,0,0,0,0,0,0,0
my-movie-player.com,21145,0,0,0,0,0,0,0
managemydownload.com,21545,0,0,0,0,0,0,0
Hulk Share,20407,0,0,1,1,0,0,1
EzDownloaderpro,21554,0,0,0,0,0,0,0
Holt Games,20409,8,0,1,9,0.888888889,0,0.111111111
Morgan Stanley & Co. International plc,20416,0,0,0,0,0,0,0
Mademoiselle C Movie,20984,0,0,0,0,0,0,0
Don 2 Movie,21177,0,0,0,0,0,0,0
Mother Parkers Tea & Coffee Inc.,21588,0,0,0,0,0,0,0
Ai Weiwei Never Sorry Movie,21186,0,0,0,0,0,0,0
Casa de mi Padre Movie,21084,0,0,0,0,0,0,0
Union Station Kansas City,21086,0,0,0,0,0,0,0
Kansas Health Foundation,20743,0,0,0,0,0,0,0
Arena District,20752,0,0,0,0,0,0,0
Tecor Technologies Limited,21286,2,0,0,2,1,0,0
Curaçao Tourist Board,20877,0,0,0,0,0,0,0
AB Abro Bryggeri,20777,0,0,0,0,0,0,0
Sun Valley Film Festival,21311,0,0,0,0,0,0,0
Gravity Movie,20884,0,0,0,0,0,0,0
Chateau St. Jean,20782,0,0,0,0,0,0,0
The Film Society of Minneapolis St. Paul,21318,0,0,0,0,0,0,0
Corby Distilleries Limited,20786,0,0,0,0,0,0,0
Die Pro 3 Games GmbH,21543,0,0,0,0,0,0,0
Film World Media,21050,15,0,14,29,0.517241379,0,0.482758621
Ziddu.com,21052,1,0,0,1,1,0,0
Pubdirecte.com,21552,0,0,5,5,0,0,1
Federal Motor Carrier Safety Administration,20418,1,0,0,1,1,0,0
"Standard TV and Appliance Co., Inc.",20977,0,0,0,0,0,0,0
Thanks for Sharing Movie,20986,0,0,0,0,0,0,0
Delivery Man Movie,21586,0,0,0,0,0,0,0
Short Term 112 Movie,21077,0,0,0,0,0,0,0
The Marché du Film,21184,0,0,0,0,0,0,0
Local Corporation,21211,0,0,0,0,0,0,0
"Pioneer Hi-Bred International, Inc.",17801,1,0,1,2,0.5,0,0.5
SW Golf Limited,17808,0,0,0,0,0,0,0
"Hoover's, Inc.",2500,1,0,0,1,1,0,0
The Dallas Morning News,2527,0,0,0,0,0,0,0
Christian Appalachian Project,1723,0,0,0,0,0,0,0
Borgata Hotel Casino & Spa,2193,0,0,1,1,0,0,1
Restaurant.com,2198,0,0,0,0,0,0,0
Outerwall Inc.,21507,4,0,0,4,1,0,0
Trinchero Family Estates,20739,0,0,0,0,0,0,0
Parkland Movie,21022,0,0,0,0,0,0,0
Paquitos Mexican Restaurant,20754,0,0,0,0,0,0,0
Abu Dhabi Film Commission,21290,0,0,0,0,0,0,0
Gravity Defyer Inc.,21037,0,0,0,0,0,0,0
Deceptive Practice Movie,20052,0,0,0,0,0,0,0
First Choice Capital Resources,21539,0,0,0,0,0,0,0
Sweet Water Brewing,20773,0,0,0,0,0,0,0
Trivento Winery,20790,0,0,0,0,0,0,0
Totum Management BV,20973,1,0,0,1,1,0,0
Bulletproof Home,20420,1,1,0,2,0.5,0.5,0
webplayproduct.com,21573,1,0,0,1,1,0,0
"Premium Installer, Inc.",20422,0,0,0,0,0,0,0
H. Wayne Huizenga School of Business and Entrepreneurship,21575,1,0,0,1,1,0,0
iMovies Ltd.,21071,3,0,0,3,1,0,0
"411mania.com, LLC.",21073,0,0,0,0,0,0,0
American Hustle Movie,21590,0,0,0,0,0,0,0
The Polar Bears Movie,21592,0,0,1,1,0,0,1
Meta Movies,21088,0,0,0,0,0,0,0
"Do Something, Inc.",20622,0,0,0,0,0,0,0
Closed Circuit Movie,20639,0,0,0,0,0,0,0
The Great Divide Movie,20654,0,0,0,0,0,0,0
Audience Associates Inc.,20069,0,0,0,0,0,0,0
Sellebrity Movie,20071,0,0,0,0,0,0,0
Intruders Movie,20088,0,0,0,0,0,0,0
"Game Show Network, LLC",2523,12,1,5,18,0.666666667,0.055555556,0.277777778
Dunkin Brands,1719,7,1,0,8,0.875,0.125,0
Bryant & Stratton College,2423,0,0,0,0,0,0,0
Campbell Soup Company,2438,14,1,6,21,0.666666667,0.047619048,0.285714286
CineMark,2189,0,0,1,1,0,0,1
SABMiller plc.,20725,0,0,0,0,0,0,0
Ken Carrell for City Council,20759,0,0,0,0,0,0,0
Betfred Racing,20766,0,0,0,0,0,0,0
"Nature's Way Bird Products, LLC.",21036,0,0,0,0,0,0,0
"United Negro College Fund, Inc.",21536,8,0,0,8,1,0,0
Coast to Coast Driving Schools,20391,0,0,0,0,0,0,0
Flowers Foods,20400,0,0,0,0,0,0,0
Legacy Place,21159,0,0,0,0,0,0,0
Bridgewater Credit Union,11535,0,0,0,0,0,0,0
Paddy Power Holdings Limited,11537,0,0,0,0,0,0,0
The Sunday Mirror Bingo,11536,0,0,0,0,0,0,0
Vetstreet,2443,0,0,0,0,0,0,0
Dynamics Inc.,20858,3,0,0,3,1,0,0
US Interactive Media,20869,0,0,0,0,0,0,0
Imgur,20744,0,0,0,0,0,0,0
Abu Dhabi Film Festival,21287,0,0,0,0,0,0,0
"PhoneDog, LLC.",21033,0,0,0,0,0,0,0
Talking Stick Resort,20769,0,0,0,0,0,0,0
Liquour and Wine of Seattle,20776,0,0,0,0,0,0,0
"Extole, Inc.",20883,0,0,0,0,0,0,0
Sweetwater Movie,21044,0,0,0,0,0,0,0
Tucson International Airport,20958,0,0,0,0,0,0,0
Lockout Movie,21169,0,0,0,0,0,0,0
Phoenix Health Plans,21594,1,0,0,1,1,0,0
Casale Media,21619,1,0,0,1,1,0,0
"Agora Financial, LLC.",21626,1,0,0,1,1,0,0
SunnyLOL,21112,0,0,0,0,0,0,0
WP Technology Inc.,20644,0,0,0,0,0,0,0
A Beautiful Soul Movie,20065,0,0,0,0,0,0,0
Woman In The Fifth Movie,20083,0,0,0,0,0,0,0
"LCA-Vision, Inc.",2492,3,0,0,3,1,0,0
OnlineMeetingNow.com,2499,0,0,0,0,0,0,0
BitDefender,2510,20,5,1,26,0.769230769,0.192307692,0.038461538
Fold3,3260,0,0,0,0,0,0,0
"John B. Sanfilippo & Son, Inc.",18200,0,0,0,0,0,0,0
Casino Rama,20726,0,0,0,0,0,0,0
"Peruvian Pisco USA Partners, LLC",20751,0,0,0,0,0,0,0
Create Film Festival,21276,0,0,0,0,0,0,0
Drambuie Liqueur Company Limited,21526,0,0,0,0,0,0,0
Disposable Film Festival,21294,0,0,0,0,0,0,0
Coolmirage Ltd.,21537,6,0,0,6,1,0,0
"Nurture, Inc",20876,0,0,0,0,0,0,0
Milwaukee Film Festival,21301,0,0,0,0,0,0,0
State and Lake Chicago Tavern,21144,0,0,0,0,0,0,0
Iroko Partners Limited,21151,0,0,0,0,0,0,0
fast-media-downloads.com,21544,0,0,0,0,0,0,0
AdServerPub,21551,0,1,0,1,0,1,0
"Big Water Applications, LLC",20408,0,0,0,0,0,0,0
online-video-accelerator.com,21058,15,2,0,17,0.882352941,0.117647059,0
alldailyhealthtips.com,21562,0,0,2,2,0,0,1
DC Health Link,21576,0,0,0,0,0,0,0
Mary of Nazareth Movie,21176,0,0,0,0,0,0,0
The Investigator Movie,21083,0,0,0,0,0,0,0
film.com,21187,0,0,0,0,0,0,0
Embraer S.A.,21612,0,0,0,0,0,0,0
cinemaden.com,21212,0,0,0,0,0,0,0
Great Expressions Dental Centers,21630,0,0,0,0,0,0,0
ZeroTurnaround OÜ,17800,0,0,0,0,0,0,0
"Mobile Content Venture, LLC",17811,2,0,0,2,1,0,0
Jobs Movie,20626,0,0,0,0,0,0,0
Russian River Valley Winegrowers,20665,0,0,0,0,0,0,0
"Jackrabbit Technologies, Inc.",20676,0,0,0,0,0,0,0
Sushi Girl Movie,20058,0,0,0,0,0,0,0
Hold Your Breath Movie,20072,0,0,0,0,0,0,0
Reuniting The Rubins Movie,20090,0,0,0,0,0,0,0
"Halyard Education Partners, LLC",2524,0,0,0,0,0,0,0
Dallas Arboretum,10580,0,0,0,0,0,0,0
New Jersey Lottery,20749,0,0,0,0,0,0,0
Palm Springs International Film Society,21278,0,0,0,0,0,0,0
launchdownload.com,21535,0,0,0,0,0,0,0
Sugar House Casino,20774,0,0,0,0,0,0,0
Disposable Film Festiva,21310,0,0,0,0,0,0,0
The Institute for Professional Development,20885,0,0,0,0,0,0,0
Alco-Water Beverage Co.,20785,0,0,0,0,0,0,0
The Counselor Movie,21153,0,0,0,0,0,0,0
Alcatel-Lucent,20399,0,0,0,0,0,0,0
Amonetize Ltd,21546,10,1,6,17,0.588235294,0.058823529,0.352941176
Parents Across America,21160,0,0,0,0,0,0,0
SENECA GAMING CORPORATION,20960,0,0,0,0,0,0,0
Cbazaar,20417,0,0,0,0,0,0,0
Wadjda Movie,20985,0,0,0,0,0,0,0
All Is Lost Movie,21178,0,0,0,0,0,0,0
The Fifth Estate Movie,20992,0,0,0,0,0,0,0
Homefront Movie,21585,0,0,0,0,0,0,0
one-time-offer.com,21596,0,0,0,0,0,0,0
"Turner Wellness Media, Inc.",21003,3,0,3,6,0.5,0,0.5
Sweet Anthem,21610,0,0,0,0,0,0,0
inlandsocal.com,21103,0,0,0,0,0,0,0
Last Vegas Movie,21203,0,0,0,0,0,0,0
Bettys & Taylors of Harrogate Ltd.,20642,0,0,0,0,0,0,0
Salinger Movie,20660,0,0,0,0,0,0,0
healthprotege.com,20667,0,0,0,0,0,0,0
Light Rabbit LTD,20674,0,0,0,0,0,0,0
Snowmen Movie,20056,0,0,0,0,0,0,0
Here Comes The Boom Movie,20081,0,0,0,0,0,0,0
Bigg Boss 5,10546,0,0,0,0,0,0,0
"La-Z-Boy, Inc.",2494,8,0,1,9,0.888888889,0,0.111111111
"Lumber Liquidators, Inc.",2526,4,0,2,6,0.666666667,0,0.333333333
Current TV,1708,0,0,0,0,0,0,0
"Pharmavite, LLC.",2433,0,0,2,2,0,0,1
Personal Capital,2576,0,0,0,0,0,0,0
Coast To Coast Exotics,20388,0,0,0,0,0,0,0
"Challenge Dairy Products, Inc.",20737,0,0,0,0,0,0,0
dmoviereview.wordpress.com,21139,0,0,0,0,0,0,0
Noble Wines Ltd.,21524,0,0,0,0,0,0,0
People for Richard Conlin,21541,0,0,0,0,0,0,0
Piaget,21154,0,0,0,0,0,0,0
Nassau County Democratic Committee,20890,0,0,0,0,0,0,0
playerupdater.com,21054,6,0,1,7,0.857142857,0,0.142857143
National CineMedia,2584,0,0,0,0,0,0,0
American Public Media,2585,0,0,0,0,0,0,0
University of Pittsburgh School of Medicine,2586,0,0,2,2,0,0,1
"Gazillion, Inc.",2444,4,0,0,4,1,0,0
SOAP.com,2201,3,0,6,9,0.333333333,0,0.666666667
nourl.com,2583,0,0,0,0,0,0,0
ACTdesign,20865,0,0,2,2,0,0,1
Denver Film Society,21280,0,0,0,0,0,0,0
Macdonald & Muir,20765,0,0,0,0,0,0,0
AB InBev,21534,0,0,0,0,0,0,0
Song for Marion Movie,21298,0,0,0,0,0,0,0
Police Scotland,20780,0,0,0,0,0,0,0
Camden Film Festival,21315,0,0,0,0,0,0,0
Marley Movie,21148,0,0,0,0,0,0,0
Tillamook County Creamery Association,20397,0,0,0,0,0,0,0
Lifestyletrendalerts,20962,0,0,0,0,0,0,0
"ArmorGames, Inc.",20411,1,0,0,1,1,0,0
ArabicTVSeriesMovies,21166,0,0,0,0,0,0,0
FindAnyFilm,21179,0,0,0,0,0,0,0
Cotton Council International,20997,0,0,0,0,0,0,0
Keep the Lights On Movie,21183,0,0,0,0,0,0,0
We Steal Secrets Movie,21080,0,0,0,0,0,0,0
Monsieur Papa Movie,21197,0,0,0,0,0,0,0
Henan Liming Heavy Industry Science and Technology Co. LTD,21615,0,0,0,0,0,0,0
Eureka Forbes,21616,0,0,0,0,0,0,0
SOWIND,17803,0,0,0,0,0,0,0
"J.Crew Group, Inc.",17807,1,0,0,1,1,0,0
Mission Foods Corporation,20630,0,0,0,0,0,0,0
Battle of the Year Movie,20661,0,0,0,0,0,0,0
Retreat Movie,20062,0,0,0,0,0,0,0
The Viral Factor Movie,20076,0,0,0,0,0,0,0
TerraFerma Movie,20079,0,0,0,0,0,0,0
ooVoo LLC,2495,0,0,0,0,0,0,0
Hachette Book Group,2496,0,0,0,0,0,0,0
The Devil's Double Movie,1710,0,0,0,0,0,0,0
Proactiv,1713,13,3,0,16,0.8125,0.1875,0
"Quest Software, Inc",2581,3,0,0,3,1,0,0
NCAA,2202,1,0,3,4,0.25,0,0.75
MultiCare,2204,2,1,0,3,0.666666667,0.333333333,0
Shamrock Foods Company,20961,2,0,2,4,0.5,0,0.5
"Open Market, inc.",21061,0,0,0,0,0,0,0
St. John's University,21563,0,0,1,1,0,0,1
Almond Tree Manor,21568,0,0,0,0,0,0,0
"Gotcha Media Group, Inc.",21068,2,0,0,2,1,0,0
Cherokee Welcome Center,20425,0,0,0,0,0,0,0
weirdlyodd.com,21070,0,0,0,0,0,0,0
Escape Plan Movie,20991,0,0,0,0,0,0,0
I'm in Love With a Church Girl Movie,20993,0,0,0,0,0,0,0
Don Jon Movie,20995,0,0,0,0,0,0,0
Thor The Dark World Movie,21000,0,0,0,0,0,0,0
Lineplot Fed Movie LLC,21593,0,0,1,1,0,0,1
dailydiettrends.com,21602,0,0,0,0,0,0,0
"Frogster America, Inc.",2447,0,0,0,0,0,0,0
Anthropics Technology Ltd.,2448,15,0,1,16,0.9375,0,0.0625
Goodgame Studios,10595,17,2,4,23,0.739130435,0.086956522,0.173913043
State of Indiana,10596,0,0,0,0,0,0,0
Tube2File.com,10603,7,0,6,13,0.538461538,0,0.461538462
Rockcamp.com,10606,0,0,0,0,0,0,0
Plusnet plc,10607,0,0,0,0,0,0,0
Information office of chengdu Municipal People's Government,10589,0,0,0,0,0,0,0
"K Hovnanian Building Company, LLC.",10608,0,0,0,0,0,0,0
Demarco Designer Bridal Engagment Rings Jewelry,10610,0,0,0,0,0,0,0
Greenling.com,10599,0,0,0,0,0,0,0
National Association of Letter Carriers,10600,0,0,0,0,0,0,0
Gerber Products Company (Nestle Infant Nutrition),3554,0,0,0,0,0,0,0
Duke Energy,3555,0,0,0,0,0,0,0
Zenni,3557,2,1,0,3,0.666666667,0.333333333,0
Arden B,3558,0,0,0,0,0,0,0
Specsavers Optical Group,11544,0,0,0,0,0,0,0
SendGrid,3564,1,0,0,1,1,0,0
ByronArts Publishing,11546,0,0,0,0,0,0,0
Armani Exchange,2449,0,0,0,0,0,0,0
Butler County Tourism and Convention Bureau,11542,0,0,1,1,0,0,1
Mont Blanc,3553,10,0,1,11,0.909090909,0,0.090909091
Ghirardelli Chocolate Company,3560,6,1,9,16,0.375,0.0625,0.5625
Dylan Ribkoff Inc.,11541,0,0,0,0,0,0,0
"IMVU, Inc.",2446,27,2,2,31,0.870967742,0.064516129,0.064516129
Sleep Experts,11545,0,0,0,0,0,0,0
ROTOR Bike Components,10587,0,0,0,0,0,0,0
St. Mary's University,10602,0,0,0,0,0,0,0
InsuranceLeads.com,3549,0,0,0,0,0,0,0
ANA,11538,0,0,0,0,0,0,0
usefulappsdownloads.com,21604,0,0,0,0,0,0,0
moviesoftsite.com,21095,0,0,0,0,0,0,0
Iris Johansen,21200,0,0,0,0,0,0,0
Crisis Zero Movie,20625,0,0,0,0,0,0,0
Gambit Movie,20634,0,0,0,0,0,0,0
The Good Life Movie,20657,0,0,0,0,0,0,0
A Better Tomorrow Movie,20057,0,0,0,0,0,0,0
White T Movie,20059,0,0,0,0,0,0,0
The Deep Blue Sea Movie,20089,0,0,0,0,0,0,0
"23andMe, Inc",2507,0,0,0,0,0,0,0
Tory Burch LLC.,2518,1,0,1,2,0.5,0,0.5
PremiumPennyPicks,1707,0,0,0,0,0,0,0
"GameFly, Inc.",2441,12,1,1,14,0.857142857,0.071428571,0.071428571
"Helium, Inc.",11533,0,0,0,0,0,0,0
Valley Forge Casino Resort,10597,0,0,0,0,0,0,0
USA.gov,3552,2,0,1,3,0.666666667,0,0.333333333
"Seattle Weekly, LLC.",11540,0,0,0,0,0,0,0
Creek Casino Montgomery,20748,0,0,0,0,0,0,0
bestallcodecsapp.com,21516,8,0,0,8,1,0,0
Royal Stag Mega Movies,21283,0,0,0,0,0,0,0
Cyprus,20762,0,0,0,0,0,0,0
Illinois Institute of Technology,20879,11,0,0,11,1,0,0
Jackass Presents: Bad Grandpa Movie,21047,0,0,0,0,0,0,0
UCSF Center for Tobacco Control Research and Education,21165,0,0,0,0,0,0,0
Ez Texting,21062,0,0,0,0,0,0,0
Berwyn Development Corporation,20979,0,0,0,0,0,0,0
PowerFreedom.com,21580,11,0,0,11,1,0,0
loanDepot.com LLC,20429,0,0,0,0,0,0,0
"Cotton Babies, Inc.",20998,0,0,0,0,0,0,0
The Collection Movie,21079,0,0,0,0,0,0,0
Imagination Soup by Melissa Taylor,21215,0,0,0,0,0,0,0
Schwab Cycles,20648,0,0,0,0,0,0,0
GrouchyRabbit.com,20679,0,0,0,0,0,0,0
Rabbit TV,20680,0,0,0,0,0,0,0
Hype The Obama Effect Movie,20094,0,0,0,0,0,0,0
American Signature Furniture,2513,1,0,0,1,1,0,0
Godiva Chocolatier Inc,2514,14,0,2,16,0.875,0,0.125
Break Media,2428,6,0,6,12,0.5,0,0.5
"Surfline/Wavetrak, Inc.",2582,0,0,1,1,0,0,1
"Hallmark Cards, Inc.",3250,23,0,9,32,0.71875,0,0.28125
SysAid Technologies Ltd.,2445,0,0,0,0,0,0,0
Argosy Cruises,10601,0,0,1,1,0,0,1
Linfield College,3550,0,0,0,0,0,0,0
uni-suite.com,21056,1,0,0,1,1,0,0
Private Internet Access,21556,0,0,1,1,0,0,1
SilverTorrent,21558,0,0,1,1,0,0,1
Kahaani Movie,21171,0,0,0,0,0,0,0
Eden Movie,21173,0,0,0,0,0,0,0
Machete Kills Movie,20988,0,0,0,0,0,0,0
Romeo & Juliet Movie,20990,0,0,0,0,0,0,0
London River Movie,21188,0,0,0,0,0,0,0
Bro' Movie,21190,0,0,0,0,0,0,0
Entergy Corporation,21622,0,0,4,4,0,0,1
El Camino College,21107,0,0,1,1,0,0,1
Roadshow Entertainment,21207,0,0,0,0,0,0,0
Canada's Walk of Fame,20673,0,0,0,0,0,0,0
The Humane Society of the United States,10545,4,0,0,4,1,0,0
Carrington Colleges Group,2504,10,1,3,14,0.714285714,0.071428571,0.214285714
"Trib Total Media, Inc.",2506,1,0,0,1,1,0,0
"IGN Entertainment, Inc.",2440,1,0,2,3,0.333333333,0,0.666666667
MedJetAssist,3242,0,0,0,0,0,0,0
TiVo Inc.,3255,61,3,9,73,0.835616438,0.04109589,0.123287671
"MECU of Baltimore, Inc.",10592,0,0,0,0,0,0,0
"Byron Udell & Associates, Inc.",10594,0,0,0,0,0,0,0
Solutions with Impact Inc.,11547,0,0,0,0,0,0,0
"Respond, Inc.",21618,1,0,0,1,1,0,0
moviebat.com,21109,0,0,0,0,0,0,0
Dickinson Theatres,21218,0,0,0,0,0,0,0
As I Lay Dying Movie,21220,0,0,0,0,0,0,0
Clairvoyant Beauty,20643,0,0,0,0,0,0,0
"Classes USA, Inc.",20650,58,0,7,65,0.892307692,0,0.107692308
"Reportech, LLC",20652,0,0,0,0,0,0,0
Rabbit Air,20675,0,0,0,0,0,0,0
The Loved Ones Movie,20073,0,0,0,0,0,0,0
The Last Mountain Movie,20075,0,0,0,0,0,0,0
RivalGaming,2491,0,0,0,0,0,0,0
Lafayette 148 New York Inc.,2434,0,0,0,0,0,0,0
Converse,3563,3,0,0,3,1,0,0
KWP STUDIOS INC,10590,1,0,0,1,1,0,0
"PC Connection, Inc.",3561,0,0,0,0,0,0,0
Neotys' Load Testing,10598,0,0,0,0,0,0,0
The Mint LA,3562,0,0,0,0,0,0,0
Dr. Fox Facial Plastic Surgery.com,11543,0,0,0,0,0,0,0
"Ragnar Events, LLC",10604,0,0,0,0,0,0,0
Vikingdom Movie,21040,0,0,0,0,0,0,0
greenbu Software,21540,0,0,0,0,0,0,0
InsuranceQuotesFor1.com,20887,0,0,0,0,0,0,0
Westy Self Storage,20957,0,0,1,1,0,0,1
Upgradeyourlife.co,21555,0,0,0,0,0,0,0
PhoneArena,21557,9,0,3,12,0.75,0,0.25
CoolGiftRewards,21559,0,0,0,0,0,0,0
Minnesota Management and Budget,20970,2,0,0,2,1,0,0
Jared The Galleria Of Jewelry,21572,0,0,0,0,0,0,0
Unstoppable Movie,20987,0,0,0,0,0,0,0
Genius on Hold Movie,21606,0,0,0,0,0,0,0
downloadyourplayer.com,21625,13,0,0,13,1,0,0
playhive.net,21206,0,0,1,1,0,0,1
Sun & Ski Sports,17796,13,0,0,13,1,0,0
Dodge,20621,283,30,44,357,0.792717087,0.084033613,0.1232493
The Good Son Movie,20636,0,0,0,0,0,0,0
In The Hive Movie,20653,0,0,0,0,0,0,0
Getaway Movie,20655,0,0,0,0,0,0,0
DomainSponser.com,20670,0,0,0,0,0,0,0
People Like Us Movie,20053,0,0,0,0,0,0,0
Red Lion Hotels Corporation,10544,0,0,0,0,0,0,0
Funny or Die Inc.,2490,0,0,3,3,0,0,1
"Expedia, Inc.",2503,12,8,2,22,0.545454545,0.363636364,0.090909091
"dealnews.com, Inc",2520,7,0,1,8,0.875,0,0.125
Conquer Cancer Foundation,1701,0,0,0,0,0,0,0
getitfree.net,2422,0,0,0,0,0,0,0
St. Louis Post-Dispatch,2437,0,0,0,0,0,0,0
Progress Energy,2573,1,0,0,1,1,0,0
Gaylord Hotels,2188,0,0,0,0,0,0,0
Neil Kelly,10576,0,0,0,0,0,0,0
PayDayMax Ltd.,2590,0,0,0,0,0,0,0
Myxer Inc.,2605,0,0,0,0,0,0,0
ShopCompare.net,2591,5,0,0,5,1,0,0
Alabama Live LLC.,2606,0,0,1,1,0,0,1
"Joyent, Inc",2592,0,0,0,0,0,0,0
"SuccessFactors, Inc.",2607,5,0,0,5,1,0,0
Bible Gateway,2602,0,0,1,1,0,0,1
The Treatment Center,2598,0,0,0,0,0,0,0
"WhaleShark Media, Inc.",2609,5,4,1,10,0.5,0.4,0.1
Kraft Foods,2594,58,15,15,88,0.659090909,0.170454545,0.170454545
Tribune Company,2611,3,0,3,6,0.5,0,0.5
Syracuse Online LLC,2612,2,0,1,3,0.666666667,0,0.333333333
Aruba Tourism Authority,2616,8,4,2,14,0.571428571,0.285714286,0.142857143
Campmor,2618,0,0,0,0,0,0,0
Orlando Sentinel,2619,0,0,1,1,0,0,1
My Winners,11550,0,0,0,0,0,0,0
The American Sovereignty Campaign,11553,0,0,0,0,0,0,0
Jogonaut LLC,11554,0,0,0,0,0,0,0
Torchmate,11572,0,0,0,0,0,0,0
BabyCenter LLC,11557,1,0,0,1,1,0,0
"DeNA Co.,LTD.",11575,0,0,0,0,0,0,0
Watercourse Way,11562,0,0,0,0,0,0,0
Diabetes Care Club,11576,0,0,0,0,0,0,0
American Kennel Club,11581,0,0,1,1,0,0,1
United Heritage Credit Union,11583,0,0,0,0,0,0,0
New Orleans Wine and Food Experience,11567,0,0,0,0,0,0,0
Manseuto Ventures LLC.,11584,0,0,0,0,0,0,0
variscite.com,11586,0,0,0,0,0,0,0
MyNameNecklace,11574,0,0,0,0,0,0,0
Audio Visions South,11589,0,0,0,0,0,0,0
O'Connor Capital Partners,11590,0,0,0,0,0,0,0
Karin Slaughter,11596,0,0,0,0,0,0,0
Quinault Beach Resort & Casino,11595,0,0,0,0,0,0,0
The Writers' Trust of Canada,10609,0,0,0,0,0,0,0
Santa Fe Convention and Visitors Bureau,10611,0,0,1,1,0,0,1
National Automotive Parts Association (NAPA),3559,0,0,0,0,0,0,0
"Turning Stone Resort Casino, LLC.",2589,0,0,0,0,0,0,0
Puma,2604,7,0,0,7,1,0,0
Americans Elect,2621,0,0,0,0,0,0,0
huz.com,11564,0,0,0,0,0,0,0
"AMERICANA MINT, LLC",11598,0,0,0,0,0,0,0
Delaware Division of Public Health,11549,0,0,0,0,0,0,0
Odwalla Inc.,11558,0,0,0,0,0,0,0
Traders Village,11594,0,0,0,0,0,0,0
Diamond Dee-Lite,11579,0,0,0,0,0,0,0
The J. M. Smucker Company,2610,0,0,0,0,0,0,0
Tourism Yukon,11552,0,0,0,0,0,0,0
Local Search Association,11566,0,0,0,0,0,0,0
Plow & Hearth,11551,0,0,0,0,0,0,0
Smarter Households,11560,0,0,0,0,0,0,0
Dallas Theater Center,11592,1,0,0,1,1,0,0
"Boxee, Inc.",11599,0,0,0,0,0,0,0
MOO Inc.,2596,2,0,0,2,1,0,0
Dan Liljenquist for US Senate,11556,0,0,0,0,0,0,0
Salal Credit Union,11573,1,0,0,1,1,0,0
Olive 8,11588,0,0,0,0,0,0,0
FansEdge,2613,0,0,2,2,0,0,1
vegasmetromarket.com,11587,0,0,0,0,0,0,0
Inside Investing Daily,11591,0,0,0,0,0,0,0
UnitedHealth Military & Veterans Services LLC.,11568,0,0,0,0,0,0,0
Xeround,11593,0,0,0,0,0,0,0
My Candy Love,11531,3,0,0,3,1,0,0
Grocerycouponcart.com,3541,4,0,0,4,1,0,0
BetterDate.com,3543,0,0,0,0,0,0,0
Electronics Payment Coalition,3239,0,0,0,0,0,0,0
"Shutterfly, Inc.",18198,0,0,0,0,0,0,0
Prosynthesis Laboratories,2205,21,0,0,21,1,0,0
"Rich Dad Operating Co., LLC",2588,0,0,0,0,0,0,0
"Neustar, Inc.",11548,0,0,0,0,0,0,0
Dark Shadows the Movie,11565,0,0,0,0,0,0,0
Pediatric Dentistry,11578,0,0,0,0,0,0,0
"Specialty Retailers, Inc.",11580,0,0,0,0,0,0,0
Myrtle Beach Area Convention and Visitors Bureau,2597,6,0,1,7,0.857142857,0,0.142857143
"SCI Management, L.P.",11571,0,0,0,0,0,0,0
